PokerStars Zoom Hand #172104226001:  Hold'em No Limit ($0.01/$0.02) - 2017/06/22 18:06:04 UTC [2017/06/22 14:06:04 ET]
Table 'Halley' 6-max Seat #1 is the button
Seat 1: AAAAAAAGI ($0.61 in chips) 
Seat 2: polunohnik ($1.41 in chips) 
Seat 3: yakka34 ($1.60 in chips) 
Seat 4: zetlife ($2.85 in chips) 
Seat 5: malozemovL11 ($2.60 in chips) 
Seat 6: Squishee-Apu ($2 in chips) 
polunohnik: posts small blind $0.01
yakka34: posts big blind $0.02
*** HOLE CARDS ***
Dealt to yakka34 [4c 5s]
zetlife: folds 
malozemovL11: folds 
Squishee-Apu: folds 
AAAAAAAGI: folds 
polunohnik: calls $0.01
yakka34: checks 
*** FLOP *** [4d 2s Td]
polunohnik: bets $0.02
yakka34: calls $0.02
*** TURN *** [4d 2s Td] [Tc]
polunohnik: checks 
yakka34: bets $0.04
polunohnik: calls $0.04
*** RIVER *** [4d 2s Td Tc] [Ac]
polunohnik: checks 
yakka34: checks 
*** SHOW DOWN ***
polunohnik: shows [7d 2d] (two pair, Tens and Deuces)
yakka34: shows [4c 5s] (two pair, Tens and Fours)
yakka34 collected $0.15 from pot
*** SUMMARY ***
Total pot $0.16 | Rake $0.01 
Board [4d 2s Td Tc Ac]
Seat 1: AAAAAAAGI (button) folded before Flop (didn't bet)
Seat 2: polunohnik (small blind) showed [7d 2d] and lost with two pair, Tens and Deuces
Seat 3: yakka34 (big blind) showed [4c 5s] and won ($0.15) with two pair, Tens and Fours
Seat 4: zetlife folded before Flop (didn't bet)
Seat 5: malozemovL11 folded before Flop (didn't bet)
Seat 6: Squishee-Apu folded before Flop (didn't bet)



PokerStars Zoom Hand #172104246992:  Hold'em No Limit ($0.01/$0.02) - 2017/06/22 18:06:34 UTC [2017/06/22 14:06:34 ET]
Table 'Halley' 6-max Seat #1 is the button
Seat 1: sash120386 ($2.81 in chips) 
Seat 2: yakka34 ($1.67 in chips) 
Seat 3: tanutarou ($2.33 in chips) 
Seat 4: Borzik03 ($2.76 in chips) 
Seat 5: straiki ($3.01 in chips) 
Seat 6: theChosef ($1.40 in chips) 
yakka34: posts small blind $0.01
tanutarou: posts big blind $0.02
*** HOLE CARDS ***
Dealt to yakka34 [Kc 3s]
Borzik03: folds 
straiki: folds 
theChosef: folds 
sash120386: folds 
yakka34: folds 
Uncalled bet ($0.01) returned to tanutarou
tanutarou collected $0.02 from pot
tanutarou: doesn't show hand 
*** SUMMARY ***
Total pot $0.02 | Rake $0 
Seat 1: sash120386 (button) folded before Flop (didn't bet)
Seat 2: yakka34 (small blind) folded before Flop
Seat 3: tanutarou (big blind) collected ($0.02)
Seat 4: Borzik03 folded before Flop (didn't bet)
Seat 5: straiki folded before Flop (didn't bet)
Seat 6: theChosef folded before Flop (didn't bet)



PokerStars Zoom Hand #172104254698:  Hold'em No Limit ($0.01/$0.02) - 2017/06/22 18:06:45 UTC [2017/06/22 14:06:45 ET]
Table 'Halley' 6-max Seat #1 is the button
Seat 1: yakka34 ($1.66 in chips) 
Seat 2: xtddai ($2.07 in chips) 
Seat 3: chessman1997 ($2.49 in chips) 
Seat 4: straiki ($2.97 in chips) 
Seat 5: benizel ($2.77 in chips) 
Seat 6: pubru ($2.40 in chips) 
xtddai: posts small blind $0.01
chessman1997: posts big blind $0.02
*** HOLE CARDS ***
Dealt to yakka34 [7c Tc]
straiki: folds 
benizel: folds 
pubru: folds 
yakka34: calls $0.02
xtddai: folds 
chessman1997: checks 
*** FLOP *** [6c Ac 9c]
chessman1997: checks 
yakka34: checks 
*** TURN *** [6c Ac 9c] [Qs]
chessman1997: checks 
yakka34: bets $0.02
chessman1997: folds 
Uncalled bet ($0.02) returned to yakka34
yakka34 collected $0.05 from pot
yakka34: doesn't show hand 
*** SUMMARY ***
Total pot $0.05 | Rake $0 
Board [6c Ac 9c Qs]
Seat 1: yakka34 (button) collected ($0.05)
Seat 2: xtddai (small blind) folded before Flop
Seat 3: chessman1997 (big blind) folded on the Turn
Seat 4: straiki folded before Flop (didn't bet)
Seat 5: benizel folded before Flop (didn't bet)
Seat 6: pubru folded before Flop (didn't bet)



PokerStars Zoom Hand #172104266637:  Hold'em No Limit ($0.01/$0.02) - 2017/06/22 18:07:02 UTC [2017/06/22 14:07:02 ET]
Table 'Halley' 6-max Seat #1 is the button
Seat 1: ugi-dugi ($2.22 in chips) 
Seat 2: begginner666 ($1.06 in chips) 
Seat 3: AlexandrosJC ($6.36 in chips) 
Seat 4: lucagigi ($3.85 in chips) 
Seat 5: vanomc181994 ($1.15 in chips) 
Seat 6: yakka34 ($1.69 in chips) 
begginner666: posts small blind $0.01
AlexandrosJC: posts big blind $0.02
*** HOLE CARDS ***
Dealt to yakka34 [6c 8s]
lucagigi: folds 
vanomc181994: folds 
yakka34: folds 
ugi-dugi: folds 
begginner666: folds 
Uncalled bet ($0.01) returned to AlexandrosJC
AlexandrosJC collected $0.02 from pot
AlexandrosJC: doesn't show hand 
*** SUMMARY ***
Total pot $0.02 | Rake $0 
Seat 1: ugi-dugi (button) folded before Flop (didn't bet)
Seat 2: begginner666 (small blind) folded before Flop
Seat 3: AlexandrosJC (big blind) collected ($0.02)
Seat 4: lucagigi folded before Flop (didn't bet)
Seat 5: vanomc181994 folded before Flop (didn't bet)
Seat 6: yakka34 folded before Flop (didn't bet)



PokerStars Zoom Hand #172104269461:  Hold'em No Limit ($0.01/$0.02) - 2017/06/22 18:07:06 UTC [2017/06/22 14:07:06 ET]
Table 'Halley' 6-max Seat #1 is the button
Seat 1: TakeAJack ($2.32 in chips) 
Seat 2: yakka34 ($1.69 in chips) 
Seat 3: Navking9 ($2.24 in chips) 
Seat 4: BRAIÑ ($5.13 in chips) 
Seat 5: morning8521 ($1.87 in chips) 
Seat 6: Ayala0216 ($3.41 in chips) 
yakka34: posts small blind $0.01
Navking9: posts big blind $0.02
*** HOLE CARDS ***
Dealt to yakka34 [8d Ac]
BRAIÑ: folds 
morning8521: raises $0.05 to $0.07
Ayala0216: folds 
TakeAJack: folds 
yakka34: folds 
Navking9: folds 
Uncalled bet ($0.05) returned to morning8521
morning8521 collected $0.05 from pot
morning8521: doesn't show hand 
*** SUMMARY ***
Total pot $0.05 | Rake $0 
Seat 1: TakeAJack (button) folded before Flop (didn't bet)
Seat 2: yakka34 (small blind) folded before Flop
Seat 3: Navking9 (big blind) folded before Flop
Seat 4: BRAIÑ folded before Flop (didn't bet)
Seat 5: morning8521 collected ($0.05)
Seat 6: Ayala0216 folded before Flop (didn't bet)



PokerStars Zoom Hand #172104281004:  Hold'em No Limit ($0.01/$0.02) - 2017/06/22 18:07:22 UTC [2017/06/22 14:07:22 ET]
Table 'Halley' 6-max Seat #1 is the button
Seat 1: Sehmet7878 ($3.03 in chips) 
Seat 2: eriunios ($2 in chips) 
Seat 3: yakka34 ($1.68 in chips) 
Seat 4: dimuth ($2.83 in chips) 
Seat 5: InTheDark86 ($2.43 in chips) 
Seat 6: Gold3nLion88 ($3.64 in chips) 
eriunios: posts small blind $0.01
yakka34: posts big blind $0.02
*** HOLE CARDS ***
Dealt to yakka34 [Kh 8c]
dimuth: folds 
InTheDark86: folds 
Gold3nLion88: folds 
Sehmet7878: folds 
eriunios: calls $0.01
yakka34: checks 
*** FLOP *** [4s Js Kc]
eriunios: checks 
yakka34: bets $0.02
eriunios: folds 
Uncalled bet ($0.02) returned to yakka34
yakka34 collected $0.04 from pot
yakka34: doesn't show hand 
*** SUMMARY ***
Total pot $0.04 | Rake $0 
Board [4s Js Kc]
Seat 1: Sehmet7878 (button) folded before Flop (didn't bet)
Seat 2: eriunios (small blind) folded on the Flop
Seat 3: yakka34 (big blind) collected ($0.04)
Seat 4: dimuth folded before Flop (didn't bet)
Seat 5: InTheDark86 folded before Flop (didn't bet)
Seat 6: Gold3nLion88 folded before Flop (didn't bet)



PokerStars Zoom Hand #172104277383:  Hold'em No Limit ($0.01/$0.02) - 2017/06/22 18:07:17 UTC [2017/06/22 14:07:17 ET]
Table 'Halley' 6-max Seat #1 is the button
Seat 1: kolian851211 ($3.76 in chips) 
Seat 2: Scis9 ($5.75 in chips) 
Seat 3: nikonova88 ($2.91 in chips) 
Seat 4: yakka34 ($1.68 in chips) 
Seat 5: straiki ($2.94 in chips) 
Seat 6: Rullatorvåld ($5.66 in chips) 
Scis9: posts small blind $0.01
nikonova88: posts big blind $0.02
*** HOLE CARDS ***
Dealt to yakka34 [5s As]
yakka34: folds 
straiki: folds 
Rullatorvåld: folds 
kolian851211: folds 
Scis9: raises $0.04 to $0.06
nikonova88: calls $0.04
*** FLOP *** [9d Js 6s]
Scis9: checks 
nikonova88: bets $0.08
Scis9: folds 
Uncalled bet ($0.08) returned to nikonova88
nikonova88 collected $0.12 from pot
nikonova88: doesn't show hand 
*** SUMMARY ***
Total pot $0.12 | Rake $0 
Board [9d Js 6s]
Seat 1: kolian851211 (button) folded before Flop (didn't bet)
Seat 2: Scis9 (small blind) folded on the Flop
Seat 3: nikonova88 (big blind) collected ($0.12)
Seat 4: yakka34 folded before Flop (didn't bet)
Seat 5: straiki folded before Flop (didn't bet)
Seat 6: Rullatorvåld folded before Flop (didn't bet)



PokerStars Zoom Hand #172104295189:  Hold'em No Limit ($0.01/$0.02) - 2017/06/22 18:07:42 UTC [2017/06/22 14:07:42 ET]
Table 'Halley' 6-max Seat #1 is the button
Seat 1: RDdurieux ($2.64 in chips) 
Seat 2: mceachran45 ($4.43 in chips) 
Seat 3: qkima ($5.78 in chips) 
Seat 4: _Adamasto_09 ($1.84 in chips) 
Seat 5: yakka34 ($1.70 in chips) 
Seat 6: chessman1997 ($2.44 in chips) 
mceachran45: posts small blind $0.01
qkima: posts big blind $0.02
*** HOLE CARDS ***
Dealt to yakka34 [Ks 7c]
_Adamasto_09: folds 
yakka34: folds 
chessman1997: folds 
RDdurieux: raises $0.04 to $0.06
mceachran45: folds 
qkima: folds 
Uncalled bet ($0.04) returned to RDdurieux
RDdurieux collected $0.05 from pot
RDdurieux: doesn't show hand 
*** SUMMARY ***
Total pot $0.05 | Rake $0 
Seat 1: RDdurieux (button) collected ($0.05)
Seat 2: mceachran45 (small blind) folded before Flop
Seat 3: qkima (big blind) folded before Flop
Seat 4: _Adamasto_09 folded before Flop (didn't bet)
Seat 5: yakka34 folded before Flop (didn't bet)
Seat 6: chessman1997 folded before Flop (didn't bet)



PokerStars Zoom Hand #172104298765:  Hold'em No Limit ($0.01/$0.02) - 2017/06/22 18:07:47 UTC [2017/06/22 14:07:47 ET]
Table 'Halley' 6-max Seat #1 is the button
Seat 1: yakka34 ($1.70 in chips) 
Seat 2: FREE1982555 ($2.90 in chips) 
Seat 3: djwin007 ($2.03 in chips) 
Seat 4: kleen03 ($2.10 in chips) 
Seat 5: Scis9 ($4.60 in chips) 
Seat 6: GyNy1976 ($2.09 in chips) 
FREE1982555: posts small blind $0.01
djwin007: posts big blind $0.02
*** HOLE CARDS ***
Dealt to yakka34 [Qc Kc]
kleen03: folds 
Scis9: raises $0.04 to $0.06
GyNy1976: folds 
yakka34: raises $0.04 to $0.10
FREE1982555: folds 
djwin007: calls $0.08
Scis9: calls $0.04
*** FLOP *** [As 4s 9h]
djwin007: bets $0.20
Scis9: folds 
yakka34: folds 
Uncalled bet ($0.20) returned to djwin007
djwin007 collected $0.30 from pot
djwin007: doesn't show hand 
*** SUMMARY ***
Total pot $0.31 | Rake $0.01 
Board [As 4s 9h]
Seat 1: yakka34 (button) folded on the Flop
Seat 2: FREE1982555 (small blind) folded before Flop
Seat 3: djwin007 (big blind) collected ($0.30)
Seat 4: kleen03 folded before Flop (didn't bet)
Seat 5: Scis9 folded on the Flop
Seat 6: GyNy1976 folded before Flop (didn't bet)



PokerStars Zoom Hand #172104330684:  Hold'em No Limit ($0.01/$0.02) - 2017/06/22 18:08:32 UTC [2017/06/22 14:08:32 ET]
Table 'Halley' 6-max Seat #1 is the button
Seat 1: xtddai ($2.07 in chips) 
Seat 2: Il moustruo ($2.12 in chips) 
Seat 3: Rodrigo_R14M ($2.25 in chips) 
Seat 4: defoe33 ($1.56 in chips) 
Seat 5: yakka34 ($1.60 in chips) 
Seat 6: Angee1962 ($2.09 in chips) 
Il moustruo: posts small blind $0.01
Rodrigo_R14M: posts big blind $0.02
*** HOLE CARDS ***
Dealt to yakka34 [Qh 9s]
defoe33: folds 
yakka34: folds 
Angee1962: folds 
xtddai: folds 
Il moustruo: folds 
Uncalled bet ($0.01) returned to Rodrigo_R14M
Rodrigo_R14M collected $0.02 from pot
Rodrigo_R14M: doesn't show hand 
*** SUMMARY ***
Total pot $0.02 | Rake $0 
Seat 1: xtddai (button) folded before Flop (didn't bet)
Seat 2: Il moustruo (small blind) folded before Flop
Seat 3: Rodrigo_R14M (big blind) collected ($0.02)
Seat 4: defoe33 folded before Flop (didn't bet)
Seat 5: yakka34 folded before Flop (didn't bet)
Seat 6: Angee1962 folded before Flop (didn't bet)



PokerStars Zoom Hand #172104326410:  Hold'em No Limit ($0.01/$0.02) - 2017/06/22 18:08:26 UTC [2017/06/22 14:08:26 ET]
Table 'Halley' 6-max Seat #1 is the button
Seat 1: romario788 ($2 in chips) 
Seat 2: Rullatorvåld ($1.47 in chips) 
Seat 3: sgriglae ($2 in chips) 
Seat 4: Mr.Capone9 ($2.47 in chips) 
Seat 5: Vansun71 ($1.13 in chips) 
Seat 6: yakka34 ($1.60 in chips) 
Rullatorvåld: posts small blind $0.01
sgriglae: posts big blind $0.02
*** HOLE CARDS ***
Dealt to yakka34 [6h Js]
Mr.Capone9: folds 
Vansun71: folds 
yakka34: folds 
romario788: raises $0.04 to $0.06
Rullatorvåld: folds 
sgriglae: raises $0.12 to $0.18
romario788: raises $0.36 to $0.54
sgriglae: raises $1.46 to $2 and is all-in
romario788: folds 
Uncalled bet ($1.46) returned to sgriglae
sgriglae collected $1.09 from pot
sgriglae: doesn't show hand 
*** SUMMARY ***
Total pot $1.09 | Rake $0 
Seat 1: romario788 (button) folded before Flop
Seat 2: Rullatorvåld (small blind) folded before Flop
Seat 3: sgriglae (big blind) collected ($1.09)
Seat 4: Mr.Capone9 folded before Flop (didn't bet)
Seat 5: Vansun71 folded before Flop (didn't bet)
Seat 6: yakka34 folded before Flop (didn't bet)



PokerStars Zoom Hand #172104333462:  Hold'em No Limit ($0.01/$0.02) - 2017/06/22 18:08:36 UTC [2017/06/22 14:08:36 ET]
Table 'Halley' 6-max Seat #1 is the button
Seat 1: marik234 ($3.31 in chips) 
Seat 2: Antej400 ($2.30 in chips) 
Seat 3: ForexUA ($2 in chips) 
Seat 4: yakka34 ($1.60 in chips) 
Seat 5: DIMKARL ($3.99 in chips) 
Seat 6: sash120386 ($2.76 in chips) 
Antej400: posts small blind $0.01
ForexUA: posts big blind $0.02
*** HOLE CARDS ***
Dealt to yakka34 [Ah 6d]
yakka34: folds 
DIMKARL: folds 
sash120386: raises $0.04 to $0.06
marik234: folds 
Antej400: folds 
ForexUA: folds 
Uncalled bet ($0.04) returned to sash120386
sash120386 collected $0.05 from pot
sash120386: doesn't show hand 
*** SUMMARY ***
Total pot $0.05 | Rake $0 
Seat 1: marik234 (button) folded before Flop (didn't bet)
Seat 2: Antej400 (small blind) folded before Flop
Seat 3: ForexUA (big blind) folded before Flop
Seat 4: yakka34 folded before Flop (didn't bet)
Seat 5: DIMKARL folded before Flop (didn't bet)
Seat 6: sash120386 collected ($0.05)



PokerStars Zoom Hand #172104346979:  Hold'em No Limit ($0.01/$0.02) - 2017/06/22 18:08:55 UTC [2017/06/22 14:08:55 ET]
Table 'Halley' 6-max Seat #1 is the button
Seat 1: arsad725 ($2.19 in chips) 
Seat 2: yakka34 ($1.58 in chips) 
Seat 3: Navking9 ($2 in chips) 
Seat 4: BigFish4711 ($3 in chips) 
Seat 5: choque420 ($1.83 in chips) 
Seat 6: Vetaldoss ($2 in chips) 
yakka34: posts small blind $0.01
Navking9: posts big blind $0.02
*** HOLE CARDS ***
Dealt to yakka34 [2d 3h]
BigFish4711: folds 
choque420: folds 
Vetaldoss: raises $0.04 to $0.06
arsad725: folds 
yakka34: folds 
Navking9: folds 
Uncalled bet ($0.04) returned to Vetaldoss
Vetaldoss collected $0.05 from pot
Vetaldoss: doesn't show hand 
*** SUMMARY ***
Total pot $0.05 | Rake $0 
Seat 1: arsad725 (button) folded before Flop (didn't bet)
Seat 2: yakka34 (small blind) folded before Flop
Seat 3: Navking9 (big blind) folded before Flop
Seat 4: BigFish4711 folded before Flop (didn't bet)
Seat 5: choque420 folded before Flop (didn't bet)
Seat 6: Vetaldoss collected ($0.05)



PokerStars Zoom Hand #172104337015:  Hold'em No Limit ($0.01/$0.02) - 2017/06/22 18:08:41 UTC [2017/06/22 14:08:41 ET]
Table 'Halley' 6-max Seat #1 is the button
Seat 1: LaOla67 ($2 in chips) 
Seat 2: Mariner1997 ($2.10 in chips) 
Seat 3: yakka34 ($1.60 in chips) 
Seat 4: MsMurena ($3.16 in chips) 
Seat 5: Xtampede ($2.12 in chips) 
Seat 6: Karsh_1 ($2.33 in chips) 
Mariner1997: posts small blind $0.01
yakka34: posts big blind $0.02
*** HOLE CARDS ***
Dealt to yakka34 [3c Ks]
MsMurena: folds 
Xtampede: folds 
Karsh_1: raises $0.03 to $0.05
LaOla67: calls $0.05
Mariner1997: folds 
yakka34: folds 
*** FLOP *** [2h 7d Kc]
Karsh_1: bets $0.08
LaOla67: calls $0.08
*** TURN *** [2h 7d Kc] [4c]
Karsh_1: bets $0.18
LaOla67: calls $0.18
*** RIVER *** [2h 7d Kc 4c] [7s]
Karsh_1: checks 
LaOla67: checks 
*** SHOW DOWN ***
Karsh_1: shows [Js Kh] (two pair, Kings and Sevens)
LaOla67: shows [Qc Kd] (two pair, Kings and Sevens - Queen kicker)
LaOla67 collected $0.63 from pot
*** SUMMARY ***
Total pot $0.65 | Rake $0.02 
Board [2h 7d Kc 4c 7s]
Seat 1: LaOla67 (button) showed [Qc Kd] and won ($0.63) with two pair, Kings and Sevens
Seat 2: Mariner1997 (small blind) folded before Flop
Seat 3: yakka34 (big blind) folded before Flop
Seat 4: MsMurena folded before Flop (didn't bet)
Seat 5: Xtampede folded before Flop (didn't bet)
Seat 6: Karsh_1 showed [Js Kh] and lost with two pair, Kings and Sevens



PokerStars Zoom Hand #172104351955:  Hold'em No Limit ($0.01/$0.02) - 2017/06/22 18:09:02 UTC [2017/06/22 14:09:02 ET]
Table 'Halley' 6-max Seat #1 is the button
Seat 1: yakka34 ($1.57 in chips) 
Seat 2: elf99level ($2.47 in chips) 
Seat 3: Rullatorvåld ($1.49 in chips) 
Seat 4: hisapon-z ($2.48 in chips) 
Seat 5: Grummbel ($1.86 in chips) 
Seat 6: styxxx55 ($2.01 in chips) 
elf99level: posts small blind $0.01
Rullatorvåld: posts big blind $0.02
*** HOLE CARDS ***
Dealt to yakka34 [7d 5d]
hisapon-z: folds 
Grummbel: folds 
styxxx55: raises $0.04 to $0.06
yakka34: folds 
elf99level: folds 
Rullatorvåld: folds 
Uncalled bet ($0.04) returned to styxxx55
styxxx55 collected $0.05 from pot
styxxx55: doesn't show hand 
*** SUMMARY ***
Total pot $0.05 | Rake $0 
Seat 1: yakka34 (button) folded before Flop (didn't bet)
Seat 2: elf99level (small blind) folded before Flop
Seat 3: Rullatorvåld (big blind) folded before Flop
Seat 4: hisapon-z folded before Flop (didn't bet)
Seat 5: Grummbel folded before Flop (didn't bet)
Seat 6: styxxx55 collected ($0.05)



PokerStars Zoom Hand #172104349793:  Hold'em No Limit ($0.01/$0.02) - 2017/06/22 18:08:59 UTC [2017/06/22 14:08:59 ET]
Table 'Halley' 6-max Seat #1 is the button
Seat 1: Haxren ($2.84 in chips) 
Seat 2: vahit33 ($3.37 in chips) 
Seat 3: sash120386 ($2.79 in chips) 
Seat 4: somi58 ($2.10 in chips) 
Seat 5: yakka34 ($1.57 in chips) 
Seat 6: UZ=ZERO=UZ ($2.05 in chips) 
vahit33: posts small blind $0.01
sash120386: posts big blind $0.02
*** HOLE CARDS ***
Dealt to yakka34 [4h 8c]
somi58: folds 
yakka34: folds 
UZ=ZERO=UZ: folds 
Haxren: folds 
vahit33: raises $0.02 to $0.04
sash120386: calls $0.02
*** FLOP *** [Js Qh 7h]
vahit33: bets $0.04
sash120386: folds 
Uncalled bet ($0.04) returned to vahit33
vahit33 collected $0.08 from pot
vahit33: doesn't show hand 
*** SUMMARY ***
Total pot $0.08 | Rake $0 
Board [Js Qh 7h]
Seat 1: Haxren (button) folded before Flop (didn't bet)
Seat 2: vahit33 (small blind) collected ($0.08)
Seat 3: sash120386 (big blind) folded on the Flop
Seat 4: somi58 folded before Flop (didn't bet)
Seat 5: yakka34 folded before Flop (didn't bet)
Seat 6: UZ=ZERO=UZ folded before Flop (didn't bet)



PokerStars Zoom Hand #172104367499:  Hold'em No Limit ($0.01/$0.02) - 2017/06/22 18:09:24 UTC [2017/06/22 14:09:24 ET]
Table 'Halley' 6-max Seat #1 is the button
Seat 1: FREE1982555 ($2.13 in chips) 
Seat 2: DIXIS999 ($2.67 in chips) 
Seat 3: superM432 ($2.98 in chips) 
Seat 4: AJL97 ($2 in chips) 
Seat 5: dodorino ($0.96 in chips) 
Seat 6: yakka34 ($1.57 in chips) 
DIXIS999: posts small blind $0.01
superM432: posts big blind $0.02
*** HOLE CARDS ***
Dealt to yakka34 [Ac Qd]
AJL97: folds 
dodorino: raises $0.14 to $0.16
yakka34: calls $0.16
FREE1982555: raises $0.42 to $0.58
DIXIS999: folds 
superM432: folds 
dodorino: raises $0.38 to $0.96 and is all-in
yakka34: folds 
FREE1982555: calls $0.38
*** FLOP *** [6h 6s 2s]
*** TURN *** [6h 6s 2s] [6d]
*** RIVER *** [6h 6s 2s 6d] [Qh]
*** SHOW DOWN ***
dodorino: shows [Ah Kh] (three of a kind, Sixes)
FREE1982555: shows [Kd Ks] (a full house, Sixes full of Kings)
FREE1982555 collected $2.04 from pot
*** SUMMARY ***
Total pot $2.11 | Rake $0.07 
Board [6h 6s 2s 6d Qh]
Seat 1: FREE1982555 (button) showed [Kd Ks] and won ($2.04) with a full house, Sixes full of Kings
Seat 2: DIXIS999 (small blind) folded before Flop
Seat 3: superM432 (big blind) folded before Flop
Seat 4: AJL97 folded before Flop (didn't bet)
Seat 5: dodorino showed [Ah Kh] and lost with three of a kind, Sixes
Seat 6: yakka34 folded before Flop



PokerStars Zoom Hand #172104394098:  Hold'em No Limit ($0.01/$0.02) - 2017/06/22 18:10:02 UTC [2017/06/22 14:10:02 ET]
Table 'Halley' 6-max Seat #1 is the button
Seat 1: tomac6 ($2.75 in chips) 
Seat 2: sukromni ($2.32 in chips) 
Seat 3: BRAIÑ ($4.09 in chips) 
Seat 4: yakka34 ($1.41 in chips) 
Seat 5: Vansun71 ($1.27 in chips) 
Seat 6: Kurono1947 ($2.01 in chips) 
sukromni: posts small blind $0.01
BRAIÑ: posts big blind $0.02
*** HOLE CARDS ***
Dealt to yakka34 [7c Kc]
yakka34: folds 
Vansun71: folds 
Kurono1947: raises $0.02 to $0.04
tomac6: folds 
sukromni: folds 
BRAIÑ: folds 
Uncalled bet ($0.02) returned to Kurono1947
Kurono1947 collected $0.05 from pot
Kurono1947: doesn't show hand 
*** SUMMARY ***
Total pot $0.05 | Rake $0 
Seat 1: tomac6 (button) folded before Flop (didn't bet)
Seat 2: sukromni (small blind) folded before Flop
Seat 3: BRAIÑ (big blind) folded before Flop
Seat 4: yakka34 folded before Flop (didn't bet)
Seat 5: Vansun71 folded before Flop (didn't bet)
Seat 6: Kurono1947 collected ($0.05)



PokerStars Zoom Hand #172104401093:  Hold'em No Limit ($0.01/$0.02) - 2017/06/22 18:10:12 UTC [2017/06/22 14:10:12 ET]
Table 'Halley' 6-max Seat #1 is the button
Seat 1: ghost_sk777 ($1.72 in chips) 
Seat 2: yakka34 ($1.41 in chips) 
Seat 3: Mike3stakana ($7.77 in chips) 
Seat 4: benizel ($4.57 in chips) 
Seat 5: Y.Z.#9 ($3.18 in chips) 
Seat 6: trasttr ($2.49 in chips) 
yakka34: posts small blind $0.01
Mike3stakana: posts big blind $0.02
*** HOLE CARDS ***
Dealt to yakka34 [Kc 2s]
benizel: folds 
Y.Z.#9: folds 
trasttr: folds 
ghost_sk777: raises $0.04 to $0.06
yakka34: folds 
Mike3stakana: folds 
Uncalled bet ($0.04) returned to ghost_sk777
ghost_sk777 collected $0.05 from pot
ghost_sk777: doesn't show hand 
*** SUMMARY ***
Total pot $0.05 | Rake $0 
Seat 1: ghost_sk777 (button) collected ($0.05)
Seat 2: yakka34 (small blind) folded before Flop
Seat 3: Mike3stakana (big blind) folded before Flop
Seat 4: benizel folded before Flop (didn't bet)
Seat 5: Y.Z.#9 folded before Flop (didn't bet)
Seat 6: trasttr folded before Flop (didn't bet)



PokerStars Zoom Hand #172104418849:  Hold'em No Limit ($0.01/$0.02) - 2017/06/22 18:10:37 UTC [2017/06/22 14:10:37 ET]
Table 'Halley' 6-max Seat #1 is the button
Seat 1: VerityGuard ($1.95 in chips) 
Seat 2: villi1967 ($2.24 in chips) 
Seat 3: yakka34 ($1.40 in chips) 
Seat 4: andre692 ($2.14 in chips) 
Seat 5: 2232012 ($3.24 in chips) 
Seat 6: diceman0909 ($3.33 in chips) 
villi1967: posts small blind $0.01
yakka34: posts big blind $0.02
*** HOLE CARDS ***
Dealt to yakka34 [Qc Td]
andre692: folds 
2232012: folds 
diceman0909: folds 
VerityGuard: folds 
villi1967: folds 
Uncalled bet ($0.01) returned to yakka34
yakka34 collected $0.02 from pot
yakka34: doesn't show hand 
*** SUMMARY ***
Total pot $0.02 | Rake $0 
Seat 1: VerityGuard (button) folded before Flop (didn't bet)
Seat 2: villi1967 (small blind) folded before Flop
Seat 3: yakka34 (big blind) collected ($0.02)
Seat 4: andre692 folded before Flop (didn't bet)
Seat 5: 2232012 folded before Flop (didn't bet)
Seat 6: diceman0909 folded before Flop (didn't bet)



PokerStars Zoom Hand #172104425189:  Hold'em No Limit ($0.01/$0.02) - 2017/06/22 18:10:46 UTC [2017/06/22 14:10:46 ET]
Table 'Halley' 6-max Seat #1 is the button
Seat 1: yakka34 ($1.41 in chips) 
Seat 2: mark09072010 ($1.97 in chips) 
Seat 3: klounaprb ($2.83 in chips) 
Seat 4: Tanarri134 ($2.96 in chips) 
Seat 5: Mr.Capone9 ($2.02 in chips) 
Seat 6: junior2360 ($1.88 in chips) 
mark09072010: posts small blind $0.01
klounaprb: posts big blind $0.02
*** HOLE CARDS ***
Dealt to yakka34 [Qh 2s]
Tanarri134: folds 
Mr.Capone9: folds 
junior2360: raises $0.02 to $0.04
yakka34: folds 
mark09072010: folds 
klounaprb: folds 
Uncalled bet ($0.02) returned to junior2360
junior2360 collected $0.05 from pot
junior2360: doesn't show hand 
*** SUMMARY ***
Total pot $0.05 | Rake $0 
Seat 1: yakka34 (button) folded before Flop (didn't bet)
Seat 2: mark09072010 (small blind) folded before Flop
Seat 3: klounaprb (big blind) folded before Flop
Seat 4: Tanarri134 folded before Flop (didn't bet)
Seat 5: Mr.Capone9 folded before Flop (didn't bet)
Seat 6: junior2360 collected ($0.05)



PokerStars Zoom Hand #172104428007:  Hold'em No Limit ($0.01/$0.02) - 2017/06/22 18:10:50 UTC [2017/06/22 14:10:50 ET]
Table 'Halley' 6-max Seat #1 is the button
Seat 1: Supstar L ($3.53 in chips) 
Seat 2: K9-KingNine ($1.88 in chips) 
Seat 3: bvbmar09 ($3.46 in chips) 
Seat 4: Gold3nLion88 ($7.21 in chips) 
Seat 5: madsen1973 ($2 in chips) 
Seat 6: yakka34 ($1.41 in chips) 
K9-KingNine: posts small blind $0.01
bvbmar09: posts big blind $0.02
*** HOLE CARDS ***
Dealt to yakka34 [6h 7h]
Gold3nLion88: folds 
madsen1973: folds 
yakka34: calls $0.02
Supstar L: folds 
K9-KingNine: folds 
bvbmar09: checks 
*** FLOP *** [3d 3s 5c]
bvbmar09: bets $0.02
yakka34: raises $0.09 to $0.11
bvbmar09: folds 
Uncalled bet ($0.09) returned to yakka34
yakka34 collected $0.09 from pot
yakka34: doesn't show hand 
*** SUMMARY ***
Total pot $0.09 | Rake $0 
Board [3d 3s 5c]
Seat 1: Supstar L (button) folded before Flop (didn't bet)
Seat 2: K9-KingNine (small blind) folded before Flop
Seat 3: bvbmar09 (big blind) folded on the Flop
Seat 4: Gold3nLion88 folded before Flop (didn't bet)
Seat 5: madsen1973 folded before Flop (didn't bet)
Seat 6: yakka34 collected ($0.09)



PokerStars Zoom Hand #172104440584:  Hold'em No Limit ($0.01/$0.02) - 2017/06/22 18:11:08 UTC [2017/06/22 14:11:08 ET]
Table 'Halley' 6-max Seat #1 is the button
Seat 1: vyaches62 ($2.73 in chips) 
Seat 2: eNroamer ($2 in chips) 
Seat 3: Zenya5949 ($1.78 in chips) 
Seat 4: yakka34 ($1.46 in chips) 
Seat 5: mceachran45 ($2.64 in chips) 
Seat 6: poliars ($2.50 in chips) 
eNroamer: posts small blind $0.01
Zenya5949: posts big blind $0.02
*** HOLE CARDS ***
Dealt to yakka34 [2c Ks]
yakka34: folds 
mceachran45: folds 
poliars: folds 
vyaches62: folds 
eNroamer: folds 
Uncalled bet ($0.01) returned to Zenya5949
Zenya5949 collected $0.02 from pot
Zenya5949: doesn't show hand 
*** SUMMARY ***
Total pot $0.02 | Rake $0 
Seat 1: vyaches62 (button) folded before Flop (didn't bet)
Seat 2: eNroamer (small blind) folded before Flop
Seat 3: Zenya5949 (big blind) collected ($0.02)
Seat 4: yakka34 folded before Flop (didn't bet)
Seat 5: mceachran45 folded before Flop (didn't bet)
Seat 6: poliars folded before Flop (didn't bet)



PokerStars Zoom Hand #172104443355:  Hold'em No Limit ($0.01/$0.02) - 2017/06/22 18:11:12 UTC [2017/06/22 14:11:12 ET]
Table 'Halley' 6-max Seat #1 is the button
Seat 1: sukromni ($2.35 in chips) 
Seat 2: FREE1982555 ($3.30 in chips) 
Seat 3: ZhiznTakaja ($2.98 in chips) 
Seat 4: blutzbrüdazz ($5.86 in chips) 
Seat 5: yakka34 ($1.46 in chips) 
Seat 6: daltonik66 ($4.27 in chips) 
FREE1982555: posts small blind $0.01
ZhiznTakaja: posts big blind $0.02
*** HOLE CARDS ***
Dealt to yakka34 [Qh Ad]
blutzbrüdazz: folds 
yakka34: raises $0.04 to $0.06
daltonik66: folds 
sukromni: folds 
FREE1982555: folds 
ZhiznTakaja: folds 
Uncalled bet ($0.04) returned to yakka34
yakka34 collected $0.05 from pot
yakka34: doesn't show hand 
*** SUMMARY ***
Total pot $0.05 | Rake $0 
Seat 1: sukromni (button) folded before Flop (didn't bet)
Seat 2: FREE1982555 (small blind) folded before Flop
Seat 3: ZhiznTakaja (big blind) folded before Flop
Seat 4: blutzbrüdazz folded before Flop (didn't bet)
Seat 5: yakka34 collected ($0.05)
Seat 6: daltonik66 folded before Flop (didn't bet)



PokerStars Zoom Hand #172104455331:  Hold'em No Limit ($0.01/$0.02) - 2017/06/22 18:11:29 UTC [2017/06/22 14:11:29 ET]
Table 'Halley' 6-max Seat #1 is the button
Seat 1: hapkin777 ($2.31 in chips) 
Seat 2: yakka34 ($1.49 in chips) 
Seat 3: VEEPfake ($2.01 in chips) 
Seat 4: Scouserslfc ($3.02 in chips) 
Seat 5: Waltermanni ($0.97 in chips) 
Seat 6: lucas_ruinas ($2.43 in chips) 
yakka34: posts small blind $0.01
VEEPfake: posts big blind $0.02
*** HOLE CARDS ***
Dealt to yakka34 [9h 9s]
Scouserslfc: folds 
Waltermanni: calls $0.02
lucas_ruinas: folds 
hapkin777: folds 
yakka34: raises $0.04 to $0.06
VEEPfake: folds 
Waltermanni: calls $0.04
*** FLOP *** [3s Kd Qh]
yakka34: bets $0.07
Waltermanni: calls $0.07
*** TURN *** [3s Kd Qh] [Tc]
yakka34: checks 
Waltermanni: checks 
*** RIVER *** [3s Kd Qh Tc] [8s]
yakka34: checks 
Waltermanni: checks 
*** SHOW DOWN ***
yakka34: shows [9h 9s] (a pair of Nines)
Waltermanni: shows [Qs 7s] (a pair of Queens)
Waltermanni collected $0.27 from pot
*** SUMMARY ***
Total pot $0.28 | Rake $0.01 
Board [3s Kd Qh Tc 8s]
Seat 1: hapkin777 (button) folded before Flop (didn't bet)
Seat 2: yakka34 (small blind) showed [9h 9s] and lost with a pair of Nines
Seat 3: VEEPfake (big blind) folded before Flop
Seat 4: Scouserslfc folded before Flop (didn't bet)
Seat 5: Waltermanni showed [Qs 7s] and won ($0.27) with a pair of Queens
Seat 6: lucas_ruinas folded before Flop (didn't bet)



PokerStars Zoom Hand #172104490090:  Hold'em No Limit ($0.01/$0.02) - 2017/06/22 18:12:18 UTC [2017/06/22 14:12:18 ET]
Table 'Halley' 6-max Seat #1 is the button
Seat 1: styxxx55 ($2.90 in chips) 
Seat 2: tomac6 ($2.09 in chips) 
Seat 3: yakka34 ($1.36 in chips) 
Seat 4: AlphaBlitz ($4.77 in chips) 
Seat 5: SHplays ($2.05 in chips) 
Seat 6: straiki ($2.38 in chips) 
tomac6: posts small blind $0.01
yakka34: posts big blind $0.02
*** HOLE CARDS ***
Dealt to yakka34 [Qs 8s]
AlphaBlitz: folds 
SHplays: folds 
straiki: folds 
styxxx55: folds 
tomac6: raises $0.04 to $0.06
yakka34: calls $0.04
*** FLOP *** [8d 3d 5c]
tomac6: checks 
yakka34: bets $0.06
tomac6: folds 
Uncalled bet ($0.06) returned to yakka34
yakka34 collected $0.12 from pot
yakka34: doesn't show hand 
*** SUMMARY ***
Total pot $0.12 | Rake $0 
Board [8d 3d 5c]
Seat 1: styxxx55 (button) folded before Flop (didn't bet)
Seat 2: tomac6 (small blind) folded on the Flop
Seat 3: yakka34 (big blind) collected ($0.12)
Seat 4: AlphaBlitz folded before Flop (didn't bet)
Seat 5: SHplays folded before Flop (didn't bet)
Seat 6: straiki folded before Flop (didn't bet)



PokerStars Zoom Hand #172104514056:  Hold'em No Limit ($0.01/$0.02) - 2017/06/22 18:12:52 UTC [2017/06/22 14:12:52 ET]
Table 'Halley' 6-max Seat #1 is the button
Seat 1: julita2015 ($2 in chips) 
Seat 2: Hobat097 ($1.25 in chips) 
Seat 3: nakam024 ($2.70 in chips) 
Seat 4: chirva007 ($2 in chips) 
Seat 5: yakka34 ($1.42 in chips) 
Seat 6: balbes weva ($1.50 in chips) 
Hobat097: posts small blind $0.01
nakam024: posts big blind $0.02
*** HOLE CARDS ***
Dealt to yakka34 [4h Ts]
chirva007: raises $0.04 to $0.06
yakka34: folds 
balbes weva: folds 
julita2015: folds 
Hobat097: folds 
nakam024: folds 
Uncalled bet ($0.04) returned to chirva007
chirva007 collected $0.05 from pot
chirva007: doesn't show hand 
*** SUMMARY ***
Total pot $0.05 | Rake $0 
Seat 1: julita2015 (button) folded before Flop (didn't bet)
Seat 2: Hobat097 (small blind) folded before Flop
Seat 3: nakam024 (big blind) folded before Flop
Seat 4: chirva007 collected ($0.05)
Seat 5: yakka34 folded before Flop (didn't bet)
Seat 6: balbes weva folded before Flop (didn't bet)



PokerStars Zoom Hand #172104516849:  Hold'em No Limit ($0.01/$0.02) - 2017/06/22 18:12:56 UTC [2017/06/22 14:12:56 ET]
Table 'Halley' 6-max Seat #1 is the button
Seat 1: yakka34 ($1.42 in chips) 
Seat 2: AvelinoAcess ($2.10 in chips) 
Seat 3: inNatura ($2 in chips) 
Seat 4: kylies ($0.94 in chips) 
Seat 5: mceachran45 ($3.84 in chips) 
Seat 6: dk.eu ($2.77 in chips) 
AvelinoAcess: posts small blind $0.01
inNatura: posts big blind $0.02
*** HOLE CARDS ***
Dealt to yakka34 [4c Qc]
kylies: folds 
mceachran45: folds 
dk.eu: folds 
yakka34: folds 
AvelinoAcess: raises $0.04 to $0.06
inNatura: folds 
Uncalled bet ($0.04) returned to AvelinoAcess
AvelinoAcess collected $0.04 from pot
AvelinoAcess: doesn't show hand 
*** SUMMARY ***
Total pot $0.04 | Rake $0 
Seat 1: yakka34 (button) folded before Flop (didn't bet)
Seat 2: AvelinoAcess (small blind) collected ($0.04)
Seat 3: inNatura (big blind) folded before Flop
Seat 4: kylies folded before Flop (didn't bet)
Seat 5: mceachran45 folded before Flop (didn't bet)
Seat 6: dk.eu folded before Flop (didn't bet)



PokerStars Zoom Hand #172104522383:  Hold'em No Limit ($0.01/$0.02) - 2017/06/22 18:13:04 UTC [2017/06/22 14:13:04 ET]
Table 'Halley' 6-max Seat #1 is the button
Seat 1: umchel ($1.95 in chips) 
Seat 2: dk.eu ($7.34 in chips) 
Seat 3: MsMurena ($2.15 in chips) 
Seat 4: yakka34 ($1.42 in chips) 
Seat 5: s0chi161090 ($1.36 in chips) 
Seat 6: gamabynt ($5.24 in chips) 
dk.eu: posts small blind $0.01
MsMurena: posts big blind $0.02
*** HOLE CARDS ***
Dealt to yakka34 [Jd 2d]
yakka34: folds 
s0chi161090: folds 
gamabynt: folds 
umchel: folds 
dk.eu: folds 
Uncalled bet ($0.01) returned to MsMurena
MsMurena collected $0.02 from pot
MsMurena: doesn't show hand 
*** SUMMARY ***
Total pot $0.02 | Rake $0 
Seat 1: umchel (button) folded before Flop (didn't bet)
Seat 2: dk.eu (small blind) folded before Flop
Seat 3: MsMurena (big blind) collected ($0.02)
Seat 4: yakka34 folded before Flop (didn't bet)
Seat 5: s0chi161090 folded before Flop (didn't bet)
Seat 6: gamabynt folded before Flop (didn't bet)



PokerStars Zoom Hand #172104519650:  Hold'em No Limit ($0.01/$0.02) - 2017/06/22 18:13:00 UTC [2017/06/22 14:13:00 ET]
Table 'Halley' 6-max Seat #1 is the button
Seat 1: LanaLight ($3.07 in chips) 
Seat 2: Sehmet7878 ($3.31 in chips) 
Seat 3: phriza1503 ($2 in chips) 
Seat 4: 7twin7 ($1.75 in chips) 
Seat 5: DIMKARL ($2.07 in chips) 
Seat 6: yakka34 ($1.42 in chips) 
Sehmet7878: posts small blind $0.01
phriza1503: posts big blind $0.02
*** HOLE CARDS ***
Dealt to yakka34 [8h Jc]
7twin7: folds 
DIMKARL: raises $0.04 to $0.06
yakka34: folds 
LanaLight: folds 
Sehmet7878: folds 
phriza1503: folds 
Uncalled bet ($0.04) returned to DIMKARL
DIMKARL collected $0.05 from pot
DIMKARL: doesn't show hand 
*** SUMMARY ***
Total pot $0.05 | Rake $0 
Seat 1: LanaLight (button) folded before Flop (didn't bet)
Seat 2: Sehmet7878 (small blind) folded before Flop
Seat 3: phriza1503 (big blind) folded before Flop
Seat 4: 7twin7 folded before Flop (didn't bet)
Seat 5: DIMKARL collected ($0.05)
Seat 6: yakka34 folded before Flop (didn't bet)



PokerStars Zoom Hand #172104526618:  Hold'em No Limit ($0.01/$0.02) - 2017/06/22 18:13:10 UTC [2017/06/22 14:13:10 ET]
Table 'Halley' 6-max Seat #1 is the button
Seat 1: MB/Brazil ($2.70 in chips) 
Seat 2: JuanLevano ($4.09 in chips) 
Seat 3: yakka34 ($1.42 in chips) 
Seat 4: Daleks0512 ($2.08 in chips) 
Seat 5: madsen1973 ($2.03 in chips) 
Seat 6: _Adamasto_09 ($2.10 in chips) 
JuanLevano: posts small blind $0.01
yakka34: posts big blind $0.02
*** HOLE CARDS ***
Dealt to yakka34 [7s Ac]
Daleks0512: folds 
madsen1973: folds 
_Adamasto_09: raises $0.04 to $0.06
MB/Brazil: folds 
JuanLevano: folds 
yakka34: folds 
Uncalled bet ($0.04) returned to _Adamasto_09
_Adamasto_09 collected $0.05 from pot
_Adamasto_09: doesn't show hand 
*** SUMMARY ***
Total pot $0.05 | Rake $0 
Seat 1: MB/Brazil (button) folded before Flop (didn't bet)
Seat 2: JuanLevano (small blind) folded before Flop
Seat 3: yakka34 (big blind) folded before Flop
Seat 4: Daleks0512 folded before Flop (didn't bet)
Seat 5: madsen1973 folded before Flop (didn't bet)
Seat 6: _Adamasto_09 collected ($0.05)



PokerStars Zoom Hand #172104538666:  Hold'em No Limit ($0.01/$0.02) - 2017/06/22 18:13:27 UTC [2017/06/22 14:13:27 ET]
Table 'Halley' 6-max Seat #1 is the button
Seat 1: muitolocoo ($2.44 in chips) 
Seat 2: yakka34 ($1.40 in chips) 
Seat 3: mairia1986 ($1.70 in chips) 
Seat 4: LanaLight ($3.06 in chips) 
Seat 5: George031988 ($2.04 in chips) 
Seat 6: Mariner1997 ($2.36 in chips) 
yakka34: posts small blind $0.01
mairia1986: posts big blind $0.02
*** HOLE CARDS ***
Dealt to yakka34 [7c Kh]
LanaLight: folds 
George031988: folds 
Mariner1997: folds 
muitolocoo: raises $0.04 to $0.06
yakka34: folds 
mairia1986: raises $0.14 to $0.20
muitolocoo: folds 
Uncalled bet ($0.14) returned to mairia1986
mairia1986 collected $0.13 from pot
mairia1986: doesn't show hand 
*** SUMMARY ***
Total pot $0.13 | Rake $0 
Seat 1: muitolocoo (button) folded before Flop
Seat 2: yakka34 (small blind) folded before Flop
Seat 3: mairia1986 (big blind) collected ($0.13)
Seat 4: LanaLight folded before Flop (didn't bet)
Seat 5: George031988 folded before Flop (didn't bet)
Seat 6: Mariner1997 folded before Flop (didn't bet)



PokerStars Zoom Hand #172104545800:  Hold'em No Limit ($0.01/$0.02) - 2017/06/22 18:13:37 UTC [2017/06/22 14:13:37 ET]
Table 'Halley' 6-max Seat #1 is the button
Seat 1: marcosamx17 ($2.02 in chips) 
Seat 2: VerityGuard ($2.19 in chips) 
Seat 3: satudarah4 ($1.38 in chips) 
Seat 4: Alfie Bear ($2.89 in chips) 
Seat 5: Xtampede ($2.24 in chips) 
Seat 6: yakka34 ($1.39 in chips) 
VerityGuard: posts small blind $0.01
satudarah4: posts big blind $0.02
*** HOLE CARDS ***
Dealt to yakka34 [8c Kc]
Alfie Bear: folds 
Xtampede: folds 
yakka34: calls $0.02
marcosamx17: folds 
VerityGuard: folds 
satudarah4: checks 
*** FLOP *** [6c Kh Qh]
satudarah4: checks 
yakka34: bets $0.03
satudarah4: folds 
Uncalled bet ($0.03) returned to yakka34
yakka34 collected $0.05 from pot
yakka34: doesn't show hand 
*** SUMMARY ***
Total pot $0.05 | Rake $0 
Board [6c Kh Qh]
Seat 1: marcosamx17 (button) folded before Flop (didn't bet)
Seat 2: VerityGuard (small blind) folded before Flop
Seat 3: satudarah4 (big blind) folded on the Flop
Seat 4: Alfie Bear folded before Flop (didn't bet)
Seat 5: Xtampede folded before Flop (didn't bet)
Seat 6: yakka34 collected ($0.05)



PokerStars Zoom Hand #172104542909:  Hold'em No Limit ($0.01/$0.02) - 2017/06/22 18:13:33 UTC [2017/06/22 14:13:33 ET]
Table 'Halley' 6-max Seat #1 is the button
Seat 1: yakka34 ($1.39 in chips) 
Seat 2: Dr. Scalpel ($3.54 in chips) 
Seat 3: Spartacus818 ($2.18 in chips) 
Seat 4: madsen1973 ($2.01 in chips) 
Seat 5: AlexandrosJC ($3.40 in chips) 
Seat 6: tanutarou ($2 in chips) 
Dr. Scalpel: posts small blind $0.01
Spartacus818: posts big blind $0.02
*** HOLE CARDS ***
Dealt to yakka34 [5c Jd]
madsen1973: folds 
AlexandrosJC: raises $0.04 to $0.06
tanutarou: folds 
yakka34: folds 
Dr. Scalpel: calls $0.05
Spartacus818: calls $0.04
*** FLOP *** [3s 3c Ts]
Dr. Scalpel: checks 
Spartacus818: checks 
AlexandrosJC: checks 
*** TURN *** [3s 3c Ts] [Td]
Dr. Scalpel: checks 
Spartacus818: checks 
AlexandrosJC: checks 
*** RIVER *** [3s 3c Ts Td] [Ad]
Dr. Scalpel: checks 
Spartacus818: checks 
AlexandrosJC: checks 
*** SHOW DOWN ***
Dr. Scalpel: shows [Ks Qs] (two pair, Tens and Threes)
Spartacus818: shows [Jh Qc] (two pair, Tens and Threes)
AlexandrosJC: shows [6d 8d] (two pair, Tens and Threes)
Dr. Scalpel collected $0.06 from pot
Spartacus818 collected $0.06 from pot
AlexandrosJC collected $0.05 from pot
*** SUMMARY ***
Total pot $0.18 | Rake $0.01 
Board [3s 3c Ts Td Ad]
Seat 1: yakka34 (button) folded before Flop (didn't bet)
Seat 2: Dr. Scalpel (small blind) showed [Ks Qs] and won ($0.06) with two pair, Tens and Threes
Seat 3: Spartacus818 (big blind) showed [Jh Qc] and won ($0.06) with two pair, Tens and Threes
Seat 4: madsen1973 folded before Flop (didn't bet)
Seat 5: AlexandrosJC showed [6d 8d] and won ($0.05) with two pair, Tens and Threes
Seat 6: tanutarou folded before Flop (didn't bet)



PokerStars Zoom Hand #172104562673:  Hold'em No Limit ($0.01/$0.02) - 2017/06/22 18:14:01 UTC [2017/06/22 14:14:01 ET]
Table 'Halley' 6-max Seat #1 is the button
Seat 1: flaviozaca ($2.64 in chips) 
Seat 2: yakka34 ($1.42 in chips) 
Seat 3: klounaprb ($2.67 in chips) 
Seat 4: Gold3nLion88 ($6.89 in chips) 
Seat 5: rec1890 ($10.11 in chips) 
Seat 6: cidgeo1993 ($2 in chips) 
yakka34: posts small blind $0.01
klounaprb: posts big blind $0.02
*** HOLE CARDS ***
Dealt to yakka34 [Ad 6d]
Gold3nLion88: folds 
rec1890: raises $0.03 to $0.05
cidgeo1993: folds 
flaviozaca: folds 
yakka34: calls $0.04
klounaprb: folds 
*** FLOP *** [6h Kc As]
yakka34: bets $0.12
rec1890: calls $0.12
*** TURN *** [6h Kc As] [4d]
yakka34: bets $1.25 and is all-in
rec1890: folds 
Uncalled bet ($1.25) returned to yakka34
yakka34 collected $0.35 from pot
yakka34: doesn't show hand 
*** SUMMARY ***
Total pot $0.36 | Rake $0.01 
Board [6h Kc As 4d]
Seat 1: flaviozaca (button) folded before Flop (didn't bet)
Seat 2: yakka34 (small blind) collected ($0.35)
Seat 3: klounaprb (big blind) folded before Flop
Seat 4: Gold3nLion88 folded before Flop (didn't bet)
Seat 5: rec1890 folded on the Turn
Seat 6: cidgeo1993 folded before Flop (didn't bet)



PokerStars Zoom Hand #172104578069:  Hold'em No Limit ($0.01/$0.02) - 2017/06/22 18:14:23 UTC [2017/06/22 14:14:23 ET]
Table 'Halley' 6-max Seat #1 is the button
Seat 1: yakka34 ($1.60 in chips) 
Seat 2: PALASH15 ($2.16 in chips) 
Seat 3: cmashinho ($2 in chips) 
Seat 4: nkfustgp6bp6 ($2 in chips) 
Seat 5: ZUCZ3K ($2.11 in chips) 
Seat 6: YoyoY0000 ($2.11 in chips) 
PALASH15: posts small blind $0.01
cmashinho: posts big blind $0.02
*** HOLE CARDS ***
Dealt to yakka34 [3s Jd]
nkfustgp6bp6: folds 
ZUCZ3K: folds 
YoyoY0000: folds 
yakka34: folds 
PALASH15: folds 
Uncalled bet ($0.01) returned to cmashinho
cmashinho collected $0.02 from pot
cmashinho: doesn't show hand 
*** SUMMARY ***
Total pot $0.02 | Rake $0 
Seat 1: yakka34 (button) folded before Flop (didn't bet)
Seat 2: PALASH15 (small blind) folded before Flop
Seat 3: cmashinho (big blind) collected ($0.02)
Seat 4: nkfustgp6bp6 folded before Flop (didn't bet)
Seat 5: ZUCZ3K folded before Flop (didn't bet)
Seat 6: YoyoY0000 folded before Flop (didn't bet)



PokerStars Zoom Hand #172104585777:  Hold'em No Limit ($0.01/$0.02) - 2017/06/22 18:14:34 UTC [2017/06/22 14:14:34 ET]
Table 'Halley' 6-max Seat #1 is the button
Seat 1: athtour ($2.87 in chips) 
Seat 2: Dinarbank ($1.66 in chips) 
Seat 3: yakka34 ($1.60 in chips) 
Seat 4: kylies ($0.97 in chips) 
Seat 5: Kazzachok ($3.86 in chips) 
Seat 6: teamtemples ($6.82 in chips) 
Dinarbank: posts small blind $0.01
yakka34: posts big blind $0.02
*** HOLE CARDS ***
Dealt to yakka34 [Ts 6c]
kylies: folds 
Kazzachok: folds 
teamtemples: folds 
athtour: raises $0.02 to $0.04
Dinarbank: folds 
yakka34: folds 
Uncalled bet ($0.02) returned to athtour
athtour collected $0.05 from pot
athtour: doesn't show hand 
*** SUMMARY ***
Total pot $0.05 | Rake $0 
Seat 1: athtour (button) collected ($0.05)
Seat 2: Dinarbank (small blind) folded before Flop
Seat 3: yakka34 (big blind) folded before Flop
Seat 4: kylies folded before Flop (didn't bet)
Seat 5: Kazzachok folded before Flop (didn't bet)
Seat 6: teamtemples folded before Flop (didn't bet)



PokerStars Zoom Hand #172104559860:  Hold'em No Limit ($0.01/$0.02) - 2017/06/22 18:13:57 UTC [2017/06/22 14:13:57 ET]
Table 'Halley' 6-max Seat #1 is the button
Seat 1: Lousno.1 ($3.77 in chips) 
Seat 2: SadamHusn ($1.87 in chips) 
Seat 3: Y.Z.#9 ($2.97 in chips) 
Seat 4: sukromni ($2.12 in chips) 
Seat 5: yakka34 ($1.42 in chips) 
Seat 6: AlphaBlitz ($5.16 in chips) 
SadamHusn: posts small blind $0.01
Y.Z.#9: posts big blind $0.02
*** HOLE CARDS ***
Dealt to yakka34 [3h 5s]
sukromni: folds 
yakka34: folds 
AlphaBlitz: folds 
Lousno.1: folds 
SadamHusn: calls $0.01
Y.Z.#9: checks 
*** FLOP *** [2d Th Kd]
SadamHusn: checks 
Y.Z.#9: checks 
*** TURN *** [2d Th Kd] [5h]
SadamHusn: checks 
Y.Z.#9: bets $0.03
SadamHusn: calls $0.03
*** RIVER *** [2d Th Kd 5h] [2s]
SadamHusn: bets $0.10
Y.Z.#9: folds 
Uncalled bet ($0.10) returned to SadamHusn
SadamHusn collected $0.10 from pot
SadamHusn: doesn't show hand 
*** SUMMARY ***
Total pot $0.10 | Rake $0 
Board [2d Th Kd 5h 2s]
Seat 1: Lousno.1 (button) folded before Flop (didn't bet)
Seat 2: SadamHusn (small blind) collected ($0.10)
Seat 3: Y.Z.#9 (big blind) folded on the River
Seat 4: sukromni folded before Flop (didn't bet)
Seat 5: yakka34 folded before Flop (didn't bet)
Seat 6: AlphaBlitz folded before Flop (didn't bet)



PokerStars Zoom Hand #172104580853:  Hold'em No Limit ($0.01/$0.02) - 2017/06/22 18:14:27 UTC [2017/06/22 14:14:27 ET]
Table 'Halley' 6-max Seat #1 is the button
Seat 1: Scouserslfc ($2.50 in chips) 
Seat 2: iSolating ($3.42 in chips) 
Seat 3: Andrej_23rus ($2 in chips) 
Seat 4: ZUCZ3K ($2.11 in chips) 
Seat 5: kser27 ($2.05 in chips) 
Seat 6: yakka34 ($1.60 in chips) 
iSolating: posts small blind $0.01
Andrej_23rus: posts big blind $0.02
*** HOLE CARDS ***
Dealt to yakka34 [5h Qc]
ZUCZ3K: folds 
kser27: folds 
yakka34: folds 
Scouserslfc has timed out
Scouserslfc: folds 
iSolating: folds 
Uncalled bet ($0.01) returned to Andrej_23rus
Andrej_23rus collected $0.02 from pot
Andrej_23rus: doesn't show hand 
*** SUMMARY ***
Total pot $0.02 | Rake $0 
Seat 1: Scouserslfc (button) folded before Flop (didn't bet)
Seat 2: iSolating (small blind) folded before Flop
Seat 3: Andrej_23rus (big blind) collected ($0.02)
Seat 4: ZUCZ3K folded before Flop (didn't bet)
Seat 5: kser27 folded before Flop (didn't bet)
Seat 6: yakka34 folded before Flop (didn't bet)



PokerStars Zoom Hand #172104594220:  Hold'em No Limit ($0.01/$0.02) - 2017/06/22 18:14:46 UTC [2017/06/22 14:14:46 ET]
Table 'Halley' 6-max Seat #1 is the button
Seat 1: koufodinas32 ($2 in chips) 
Seat 2: styxxx55 ($2 in chips) 
Seat 3: George031988 ($2 in chips) 
Seat 4: wolnyjac ($2.03 in chips) 
Seat 5: yakka34 ($1.58 in chips) 
Seat 6: Callewier ($3.72 in chips) 
styxxx55: posts small blind $0.01
George031988: posts big blind $0.02
*** HOLE CARDS ***
Dealt to yakka34 [5h 4s]
wolnyjac: folds 
yakka34: folds 
Callewier: folds 
koufodinas32: folds 
styxxx55: folds 
Uncalled bet ($0.01) returned to George031988
George031988 collected $0.02 from pot
George031988: doesn't show hand 
*** SUMMARY ***
Total pot $0.02 | Rake $0 
Seat 1: koufodinas32 (button) folded before Flop (didn't bet)
Seat 2: styxxx55 (small blind) folded before Flop
Seat 3: George031988 (big blind) collected ($0.02)
Seat 4: wolnyjac folded before Flop (didn't bet)
Seat 5: yakka34 folded before Flop (didn't bet)
Seat 6: Callewier folded before Flop (didn't bet)



PokerStars Zoom Hand #172104599823:  Hold'em No Limit ($0.01/$0.02) - 2017/06/22 18:14:54 UTC [2017/06/22 14:14:54 ET]
Table 'Halley' 6-max Seat #1 is the button
Seat 1: Gold3nLion88 ($6.91 in chips) 
Seat 2: yakka34 ($1.58 in chips) 
Seat 3: Ayala0216 ($5.33 in chips) 
Seat 4: Scouserslfc ($2.50 in chips) 
Seat 5: Daleks0512 ($2.25 in chips) 
Seat 6: 5557890 ($1.98 in chips) 
yakka34: posts small blind $0.01
Ayala0216: posts big blind $0.02
*** HOLE CARDS ***
Dealt to yakka34 [4s 8c]
Scouserslfc: folds 
Daleks0512: folds 
5557890: folds 
Gold3nLion88: raises $0.05 to $0.07
yakka34: folds 
Ayala0216: folds 
Uncalled bet ($0.05) returned to Gold3nLion88
Gold3nLion88 collected $0.05 from pot
Gold3nLion88: doesn't show hand 
*** SUMMARY ***
Total pot $0.05 | Rake $0 
Seat 1: Gold3nLion88 (button) collected ($0.05)
Seat 2: yakka34 (small blind) folded before Flop
Seat 3: Ayala0216 (big blind) folded before Flop
Seat 4: Scouserslfc folded before Flop (didn't bet)
Seat 5: Daleks0512 folded before Flop (didn't bet)
Seat 6: 5557890 folded before Flop (didn't bet)



PokerStars Zoom Hand #172104597676:  Hold'em No Limit ($0.01/$0.02) - 2017/06/22 18:14:51 UTC [2017/06/22 14:14:51 ET]
Table 'Halley' 6-max Seat #1 is the button
Seat 1: teamtemples ($2.08 in chips) 
Seat 2: blutzbrüdazz ($5.91 in chips) 
Seat 3: .ReverTT ($2.67 in chips) 
Seat 4: yakka34 ($1.58 in chips) 
Seat 5: koufodinas32 ($2 in chips) 
Seat 6: ElectricBurrito ($7.24 in chips) 
blutzbrüdazz: posts small blind $0.01
.ReverTT: posts big blind $0.02
*** HOLE CARDS ***
Dealt to yakka34 [3s 8c]
yakka34: folds 
koufodinas32: folds 
ElectricBurrito: raises $0.02 to $0.04
teamtemples: folds 
blutzbrüdazz: folds 
.ReverTT: raises $0.12 to $0.16
ElectricBurrito: calls $0.12
*** FLOP *** [Ad Ac 5s]
.ReverTT: checks 
ElectricBurrito: bets $0.15
.ReverTT: folds 
Uncalled bet ($0.15) returned to ElectricBurrito
ElectricBurrito collected $0.32 from pot
ElectricBurrito: doesn't show hand 
*** SUMMARY ***
Total pot $0.33 | Rake $0.01 
Board [Ad Ac 5s]
Seat 1: teamtemples (button) folded before Flop (didn't bet)
Seat 2: blutzbrüdazz (small blind) folded before Flop
Seat 3: .ReverTT (big blind) folded on the Flop
Seat 4: yakka34 folded before Flop (didn't bet)
Seat 5: koufodinas32 folded before Flop (didn't bet)
Seat 6: ElectricBurrito collected ($0.32)



PokerStars Zoom Hand #172104605353:  Hold'em No Limit ($0.01/$0.02) - 2017/06/22 18:15:02 UTC [2017/06/22 14:15:02 ET]
Table 'Halley' 6-max Seat #1 is the button
Seat 1: yakka34 ($1.57 in chips) 
Seat 2: delgadolisto ($7.56 in chips) 
Seat 3: Just_Million ($2 in chips) 
Seat 4: snowcucumber ($1.99 in chips) 
Seat 5: Atamansha966 ($4.04 in chips) 
Seat 6: Alex_0212_52 ($2.55 in chips) 
delgadolisto: posts small blind $0.01
Just_Million: posts big blind $0.02
*** HOLE CARDS ***
Dealt to yakka34 [5c 6s]
snowcucumber: folds 
Atamansha966: calls $0.02
Alex_0212_52: raises $0.02 to $0.04
yakka34: folds 
delgadolisto: folds 
Just_Million: folds 
Atamansha966: calls $0.02
*** FLOP *** [Kc 9d 4d]
Atamansha966: checks 
Alex_0212_52: bets $0.02
Atamansha966: folds 
Uncalled bet ($0.02) returned to Alex_0212_52
Alex_0212_52 collected $0.11 from pot
Alex_0212_52: doesn't show hand 
*** SUMMARY ***
Total pot $0.11 | Rake $0 
Board [Kc 9d 4d]
Seat 1: yakka34 (button) folded before Flop (didn't bet)
Seat 2: delgadolisto (small blind) folded before Flop
Seat 3: Just_Million (big blind) folded before Flop
Seat 4: snowcucumber folded before Flop (didn't bet)
Seat 5: Atamansha966 folded on the Flop
Seat 6: Alex_0212_52 collected ($0.11)



PokerStars Zoom Hand #172104601931:  Hold'em No Limit ($0.01/$0.02) - 2017/06/22 18:14:57 UTC [2017/06/22 14:14:57 ET]
Table 'Halley' 6-max Seat #1 is the button
Seat 1: leozzeo ($3.02 in chips) 
Seat 2: ell_ninho ($2.16 in chips) 
Seat 3: m_dionel ($2 in chips) 
Seat 4: AJL97 ($2 in chips) 
Seat 5: pjsgalvao ($2.77 in chips) 
Seat 6: yakka34 ($1.57 in chips) 
ell_ninho: posts small blind $0.01
m_dionel: posts big blind $0.02
*** HOLE CARDS ***
Dealt to yakka34 [Jc 7h]
AJL97: raises $0.04 to $0.06
pjsgalvao: folds 
yakka34: folds 
leozzeo: folds 
ell_ninho: calls $0.05
m_dionel: folds 
*** FLOP *** [3s 3d 8d]
ell_ninho: checks 
AJL97: checks 
*** TURN *** [3s 3d 8d] [8s]
ell_ninho: bets $0.04
AJL97: calls $0.04
*** RIVER *** [3s 3d 8d 8s] [Qs]
ell_ninho: bets $0.10
AJL97: calls $0.10
*** SHOW DOWN ***
ell_ninho: shows [Ac 8c] (a full house, Eights full of Threes)
AJL97: mucks hand 
ell_ninho collected $0.41 from pot
*** SUMMARY ***
Total pot $0.42 | Rake $0.01 
Board [3s 3d 8d 8s Qs]
Seat 1: leozzeo (button) folded before Flop (didn't bet)
Seat 2: ell_ninho (small blind) showed [Ac 8c] and won ($0.41) with a full house, Eights full of Threes
Seat 3: m_dionel (big blind) folded before Flop
Seat 4: AJL97 mucked [Kc As]
Seat 5: pjsgalvao folded before Flop (didn't bet)
Seat 6: yakka34 folded before Flop (didn't bet)



PokerStars Zoom Hand #172104610294:  Hold'em No Limit ($0.01/$0.02) - 2017/06/22 18:15:09 UTC [2017/06/22 14:15:09 ET]
Table 'Halley' 6-max Seat #1 is the button
Seat 1: nikonova88 ($2.16 in chips) 
Seat 2: cahalfish ($2.09 in chips) 
Seat 3: yakka34 ($1.57 in chips) 
Seat 4: Bom001 ($2.28 in chips) 
Seat 5: InTheDark86 ($2.05 in chips) 
Seat 6: trasttr ($1.97 in chips) 
cahalfish: posts small blind $0.01
yakka34: posts big blind $0.02
*** HOLE CARDS ***
Dealt to yakka34 [9c Ad]
Bom001: folds 
InTheDark86: folds 
trasttr: raises $0.04 to $0.06
nikonova88: folds 
cahalfish: folds 
yakka34: calls $0.04
*** FLOP *** [5h 9s 2d]
yakka34: bets $0.04
trasttr: raises $0.20 to $0.24
yakka34: folds 
Uncalled bet ($0.20) returned to trasttr
trasttr collected $0.20 from pot
trasttr: doesn't show hand 
*** SUMMARY ***
Total pot $0.21 | Rake $0.01 
Board [5h 9s 2d]
Seat 1: nikonova88 (button) folded before Flop (didn't bet)
Seat 2: cahalfish (small blind) folded before Flop
Seat 3: yakka34 (big blind) folded on the Flop
Seat 4: Bom001 folded before Flop (didn't bet)
Seat 5: InTheDark86 folded before Flop (didn't bet)
Seat 6: trasttr collected ($0.20)



PokerStars Zoom Hand #172104637186:  Hold'em No Limit ($0.01/$0.02) - 2017/06/22 18:15:47 UTC [2017/06/22 14:15:47 ET]
Table 'Halley' 6-max Seat #1 is the button
Seat 1: djwin007 ($2 in chips) 
Seat 2: Scis9 ($5.67 in chips) 
Seat 3: xtddai ($3.72 in chips) 
Seat 4: y8826 ($1.94 in chips) 
Seat 5: yakka34 ($1.47 in chips) 
Seat 6: lucastav206 ($2 in chips) 
Scis9: posts small blind $0.01
xtddai: posts big blind $0.02
*** HOLE CARDS ***
Dealt to yakka34 [Ad Jd]
y8826: calls $0.02
yakka34: raises $0.04 to $0.06
lucastav206: folds 
djwin007: folds 
Scis9: folds 
xtddai: folds 
y8826: calls $0.04
*** FLOP *** [Th Tc 8s]
y8826: checks 
yakka34: bets $0.07
y8826: folds 
Uncalled bet ($0.07) returned to yakka34
yakka34 collected $0.14 from pot
yakka34: doesn't show hand 
*** SUMMARY ***
Total pot $0.15 | Rake $0.01 
Board [Th Tc 8s]
Seat 1: djwin007 (button) folded before Flop (didn't bet)
Seat 2: Scis9 (small blind) folded before Flop
Seat 3: xtddai (big blind) folded before Flop
Seat 4: y8826 folded on the Flop
Seat 5: yakka34 collected ($0.14)
Seat 6: lucastav206 folded before Flop (didn't bet)



PokerStars Zoom Hand #172104668288:  Hold'em No Limit ($0.01/$0.02) - 2017/06/22 18:16:31 UTC [2017/06/22 14:16:31 ET]
Table 'Halley' 6-max Seat #1 is the button
Seat 1: zetlife ($0.84 in chips) 
Seat 2: AceJeffKing ($2.12 in chips) 
Seat 3: petronell66 ($1.08 in chips) 
Seat 4: yakka34 ($1.55 in chips) 
Seat 5: nakam024 ($4.78 in chips) 
Seat 6: SHplays ($2.02 in chips) 
AceJeffKing: posts small blind $0.01
petronell66: posts big blind $0.02
*** HOLE CARDS ***
Dealt to yakka34 [Js 5s]
yakka34: folds 
nakam024: folds 
SHplays: folds 
zetlife: folds 
AceJeffKing: folds 
Uncalled bet ($0.01) returned to petronell66
petronell66 collected $0.02 from pot
petronell66: doesn't show hand 
*** SUMMARY ***
Total pot $0.02 | Rake $0 
Seat 1: zetlife (button) folded before Flop (didn't bet)
Seat 2: AceJeffKing (small blind) folded before Flop
Seat 3: petronell66 (big blind) collected ($0.02)
Seat 4: yakka34 folded before Flop (didn't bet)
Seat 5: nakam024 folded before Flop (didn't bet)
Seat 6: SHplays folded before Flop (didn't bet)



PokerStars Zoom Hand #172104678176:  Hold'em No Limit ($0.01/$0.02) - 2017/06/22 18:16:45 UTC [2017/06/22 14:16:45 ET]
Table 'Halley' 6-max Seat #1 is the button
Seat 1: Angee1962 ($1.89 in chips) 
Seat 2: yakka34 ($1.55 in chips) 
Seat 3: luxio giovan ($2.69 in chips) 
Seat 4: psychopathko ($2.80 in chips) 
Seat 5: InTheDark86 ($2.37 in chips) 
Seat 6: Vetaldoss ($2.92 in chips) 
yakka34: posts small blind $0.01
luxio giovan: posts big blind $0.02
*** HOLE CARDS ***
Dealt to yakka34 [8s 5h]
psychopathko: raises $0.04 to $0.06
InTheDark86: folds 
Vetaldoss: folds 
Angee1962: folds 
yakka34: folds 
luxio giovan: folds 
Uncalled bet ($0.04) returned to psychopathko
psychopathko collected $0.05 from pot
psychopathko: doesn't show hand 
*** SUMMARY ***
Total pot $0.05 | Rake $0 
Seat 1: Angee1962 (button) folded before Flop (didn't bet)
Seat 2: yakka34 (small blind) folded before Flop
Seat 3: luxio giovan (big blind) folded before Flop
Seat 4: psychopathko collected ($0.05)
Seat 5: InTheDark86 folded before Flop (didn't bet)
Seat 6: Vetaldoss folded before Flop (didn't bet)



PokerStars Zoom Hand #172104675296:  Hold'em No Limit ($0.01/$0.02) - 2017/06/22 18:16:41 UTC [2017/06/22 14:16:41 ET]
Table 'Halley' 6-max Seat #1 is the button
Seat 1: Unique.by ($4.47 in chips) 
Seat 2: Nfokin ($2.20 in chips) 
Seat 3: flaviozaca ($1.97 in chips) 
Seat 4: yakka34 ($1.55 in chips) 
Seat 5: VivaLaBee ($2.28 in chips) 
Seat 6: Haxren ($3.31 in chips) 
Nfokin: posts small blind $0.01
flaviozaca: posts big blind $0.02
*** HOLE CARDS ***
Dealt to yakka34 [2c 6d]
yakka34: folds 
VivaLaBee: folds 
Haxren: raises $0.04 to $0.06
Unique.by: raises $0.12 to $0.18
Nfokin: folds 
flaviozaca: folds 
Haxren: calls $0.12
*** FLOP *** [9c 8c 4d]
Haxren: bets $0.19
Unique.by: folds 
Uncalled bet ($0.19) returned to Haxren
Haxren collected $0.38 from pot
Haxren: doesn't show hand 
*** SUMMARY ***
Total pot $0.39 | Rake $0.01 
Board [9c 8c 4d]
Seat 1: Unique.by (button) folded on the Flop
Seat 2: Nfokin (small blind) folded before Flop
Seat 3: flaviozaca (big blind) folded before Flop
Seat 4: yakka34 folded before Flop (didn't bet)
Seat 5: VivaLaBee folded before Flop (didn't bet)
Seat 6: Haxren collected ($0.38)



PokerStars Zoom Hand #172104680967:  Hold'em No Limit ($0.01/$0.02) - 2017/06/22 18:16:49 UTC [2017/06/22 14:16:49 ET]
Table 'Halley' 6-max Seat #1 is the button
Seat 1: March of Cat ($2.36 in chips) 
Seat 2: VivaLaBee ($2.06 in chips) 
Seat 3: yakka34 ($1.54 in chips) 
Seat 4: BetaDelirium ($2.14 in chips) 
Seat 5: Ne1tx ($2.45 in chips) 
Seat 6: LanaLight ($3.04 in chips) 
VivaLaBee: posts small blind $0.01
yakka34: posts big blind $0.02
*** HOLE CARDS ***
Dealt to yakka34 [Ks Jc]
BetaDelirium: folds 
Ne1tx: folds 
LanaLight: raises $0.06 to $0.08
March of Cat: folds 
VivaLaBee: folds 
yakka34: calls $0.06
*** FLOP *** [6h 3h 9d]
yakka34: checks 
LanaLight: bets $0.14
yakka34: folds 
Uncalled bet ($0.14) returned to LanaLight
LanaLight collected $0.16 from pot
LanaLight: doesn't show hand 
*** SUMMARY ***
Total pot $0.17 | Rake $0.01 
Board [6h 3h 9d]
Seat 1: March of Cat (button) folded before Flop (didn't bet)
Seat 2: VivaLaBee (small blind) folded before Flop
Seat 3: yakka34 (big blind) folded on the Flop
Seat 4: BetaDelirium folded before Flop (didn't bet)
Seat 5: Ne1tx folded before Flop (didn't bet)
Seat 6: LanaLight collected ($0.16)



PokerStars Zoom Hand #172104671133:  Hold'em No Limit ($0.01/$0.02) - 2017/06/22 18:16:35 UTC [2017/06/22 14:16:35 ET]
Table 'Halley' 6-max Seat #1 is the button
Seat 1: epikouros93 ($2.06 in chips) 
Seat 2: Scis9 ($2 in chips) 
Seat 3: Schwabe02 ($2.18 in chips) 
Seat 4: Reluger ($1.91 in chips) 
Seat 5: yakka34 ($1.55 in chips) 
Seat 6: Bom001 ($2.17 in chips) 
Scis9: posts small blind $0.01
Schwabe02: posts big blind $0.02
*** HOLE CARDS ***
Dealt to yakka34 [6c Kd]
Reluger: folds 
yakka34: folds 
Bom001: folds 
epikouros93: raises $0.03 to $0.05
Scis9: folds 
Schwabe02: raises $0.11 to $0.16
epikouros93: calls $0.11
*** FLOP *** [Ah 4c 5h]
Schwabe02: bets $0.24
epikouros93: calls $0.24
*** TURN *** [Ah 4c 5h] [5d]
Schwabe02: bets $0.59
epikouros93: calls $0.59
*** RIVER *** [Ah 4c 5h 5d] [3s]
Schwabe02: bets $1.19 and is all-in
epikouros93: folds 
Uncalled bet ($1.19) returned to Schwabe02
Schwabe02 collected $1.92 from pot
Schwabe02: doesn't show hand 
*** SUMMARY ***
Total pot $1.99 | Rake $0.07 
Board [Ah 4c 5h 5d 3s]
Seat 1: epikouros93 (button) folded on the River
Seat 2: Scis9 (small blind) folded before Flop
Seat 3: Schwabe02 (big blind) collected ($1.92)
Seat 4: Reluger folded before Flop (didn't bet)
Seat 5: yakka34 folded before Flop (didn't bet)
Seat 6: Bom001 folded before Flop (didn't bet)



PokerStars Zoom Hand #172104703655:  Hold'em No Limit ($0.01/$0.02) - 2017/06/22 18:17:21 UTC [2017/06/22 14:17:21 ET]
Table 'Halley' 6-max Seat #1 is the button
Seat 1: Sharkiep99 ($2 in chips) 
Seat 2: cantor1987 ($4.86 in chips) 
Seat 3: diceman0909 ($2 in chips) 
Seat 4: procenko777 ($1.06 in chips) 
Seat 5: nîkos-mrds ($4.04 in chips) 
Seat 6: yakka34 ($1.46 in chips) 
cantor1987: posts small blind $0.01
diceman0909: posts big blind $0.02
*** HOLE CARDS ***
Dealt to yakka34 [As 5c]
procenko777: folds 
nîkos-mrds: folds 
yakka34: calls $0.02
Sharkiep99: folds 
cantor1987: folds 
diceman0909: checks 
*** FLOP *** [Kh Jc 3s]
diceman0909: checks 
yakka34: bets $0.05
diceman0909: folds 
Uncalled bet ($0.05) returned to yakka34
yakka34 collected $0.05 from pot
yakka34: doesn't show hand 
*** SUMMARY ***
Total pot $0.05 | Rake $0 
Board [Kh Jc 3s]
Seat 1: Sharkiep99 (button) folded before Flop (didn't bet)
Seat 2: cantor1987 (small blind) folded before Flop
Seat 3: diceman0909 (big blind) folded on the Flop
Seat 4: procenko777 folded before Flop (didn't bet)
Seat 5: nîkos-mrds folded before Flop (didn't bet)
Seat 6: yakka34 collected ($0.05)



PokerStars Zoom Hand #172104716606:  Hold'em No Limit ($0.01/$0.02) - 2017/06/22 18:17:39 UTC [2017/06/22 14:17:39 ET]
Table 'Halley' 6-max Seat #1 is the button
Seat 1: vovo4kapooh ($2.15 in chips) 
Seat 2: firstandsole ($2 in chips) 
Seat 3: balbes weva ($1.46 in chips) 
Seat 4: aftermath214 ($2.37 in chips) 
Seat 5: yakka34 ($1.49 in chips) 
Seat 6: Diane0818 ($4.78 in chips) 
firstandsole: posts small blind $0.01
balbes weva: posts big blind $0.02
*** HOLE CARDS ***
Dealt to yakka34 [Js 4s]
aftermath214: folds 
yakka34: folds 
Diane0818: folds 
vovo4kapooh: folds 
firstandsole: folds 
Uncalled bet ($0.01) returned to balbes weva
balbes weva collected $0.02 from pot
balbes weva: doesn't show hand 
*** SUMMARY ***
Total pot $0.02 | Rake $0 
Seat 1: vovo4kapooh (button) folded before Flop (didn't bet)
Seat 2: firstandsole (small blind) folded before Flop
Seat 3: balbes weva (big blind) collected ($0.02)
Seat 4: aftermath214 folded before Flop (didn't bet)
Seat 5: yakka34 folded before Flop (didn't bet)
Seat 6: Diane0818 folded before Flop (didn't bet)



PokerStars Zoom Hand #172104700089:  Hold'em No Limit ($0.01/$0.02) - 2017/06/22 18:17:16 UTC [2017/06/22 14:17:16 ET]
Table 'Halley' 6-max Seat #1 is the button
Seat 1: yakka34 ($1.46 in chips) 
Seat 2: evgen1917 ($1.01 in chips) 
Seat 3: Aknada777 ($2 in chips) 
Seat 4: NIVEKii.be ($2 in chips) 
Seat 5: copetin11 ($2.54 in chips) 
Seat 6: Da84d ($2.14 in chips) 
evgen1917: posts small blind $0.01
Aknada777: posts big blind $0.02
*** HOLE CARDS ***
Dealt to yakka34 [6d Kc]
NIVEKii.be: folds 
copetin11: raises $0.04 to $0.06
Da84d: calls $0.06
yakka34: folds 
evgen1917: folds 
Aknada777: calls $0.04
*** FLOP *** [7h 9h Ad]
Aknada777: checks 
copetin11: checks 
Da84d: bets $0.10
Aknada777: calls $0.10
copetin11: calls $0.10
*** TURN *** [7h 9h Ad] [Qh]
Aknada777: checks 
copetin11: checks 
Da84d: checks 
*** RIVER *** [7h 9h Ad Qh] [4s]
Aknada777: checks 
copetin11: checks 
Da84d: checks 
*** SHOW DOWN ***
Aknada777: shows [5d As] (a pair of Aces)
copetin11: mucks hand 
Da84d: mucks hand 
Aknada777 collected $0.47 from pot
*** SUMMARY ***
Total pot $0.49 | Rake $0.02 
Board [7h 9h Ad Qh 4s]
Seat 1: yakka34 (button) folded before Flop (didn't bet)
Seat 2: evgen1917 (small blind) folded before Flop
Seat 3: Aknada777 (big blind) showed [5d As] and won ($0.47) with a pair of Aces
Seat 4: NIVEKii.be folded before Flop (didn't bet)
Seat 5: copetin11 mucked [Ks Kh]
Seat 6: Da84d mucked [9s Js]



PokerStars Zoom Hand #172104719451:  Hold'em No Limit ($0.01/$0.02) - 2017/06/22 18:17:43 UTC [2017/06/22 14:17:43 ET]
Table 'Halley' 6-max Seat #1 is the button
Seat 1: villi1967 ($2.01 in chips) 
Seat 2: MB/Brazil ($2 in chips) 
Seat 3: ZUCZ3K ($2.32 in chips) 
Seat 4: qkima ($4.01 in chips) 
Seat 5: DMCHMB ($2.23 in chips) 
Seat 6: yakka34 ($1.49 in chips) 
MB/Brazil: posts small blind $0.01
ZUCZ3K: posts big blind $0.02
*** HOLE CARDS ***
Dealt to yakka34 [Ad 7d]
qkima: folds 
DMCHMB: folds 
yakka34: calls $0.02
villi1967: folds 
MB/Brazil: folds 
ZUCZ3K: checks 
*** FLOP *** [3s 8s 2s]
ZUCZ3K: checks 
yakka34: bets $0.05
ZUCZ3K: folds 
Uncalled bet ($0.05) returned to yakka34
yakka34 collected $0.05 from pot
yakka34: doesn't show hand 
*** SUMMARY ***
Total pot $0.05 | Rake $0 
Board [3s 8s 2s]
Seat 1: villi1967 (button) folded before Flop (didn't bet)
Seat 2: MB/Brazil (small blind) folded before Flop
Seat 3: ZUCZ3K (big blind) folded on the Flop
Seat 4: qkima folded before Flop (didn't bet)
Seat 5: DMCHMB folded before Flop (didn't bet)
Seat 6: yakka34 collected ($0.05)



PokerStars Zoom Hand #172104746670:  Hold'em No Limit ($0.01/$0.02) - 2017/06/22 18:18:21 UTC [2017/06/22 14:18:21 ET]
Table 'Halley' 6-max Seat #1 is the button
Seat 1: yakka34 ($1.52 in chips) 
Seat 2: AleksSiri ($1.55 in chips) 
Seat 3: sukromni ($2.03 in chips) 
Seat 4: teamtemples ($6.81 in chips) 
Seat 5: tobse89222 ($0.76 in chips) 
Seat 6: flaviozaca ($3.06 in chips) 
AleksSiri: posts small blind $0.01
sukromni: posts big blind $0.02
*** HOLE CARDS ***
Dealt to yakka34 [Kd 6d]
teamtemples: folds 
tobse89222: raises $0.04 to $0.06
flaviozaca: folds 
yakka34: folds 
AleksSiri: calls $0.05
sukromni: folds 
*** FLOP *** [8h 3h Tc]
AleksSiri: checks 
tobse89222: bets $0.08
AleksSiri: calls $0.08
*** TURN *** [8h 3h Tc] [2d]
AleksSiri: checks 
tobse89222: bets $0.06
AleksSiri: folds 
Uncalled bet ($0.06) returned to tobse89222
tobse89222 collected $0.29 from pot
tobse89222: doesn't show hand 
*** SUMMARY ***
Total pot $0.30 | Rake $0.01 
Board [8h 3h Tc 2d]
Seat 1: yakka34 (button) folded before Flop (didn't bet)
Seat 2: AleksSiri (small blind) folded on the Turn
Seat 3: sukromni (big blind) folded before Flop
Seat 4: teamtemples folded before Flop (didn't bet)
Seat 5: tobse89222 collected ($0.29)
Seat 6: flaviozaca folded before Flop (didn't bet)



PokerStars Zoom Hand #172104766066:  Hold'em No Limit ($0.01/$0.02) - 2017/06/22 18:18:48 UTC [2017/06/22 14:18:48 ET]
Table 'Halley' 6-max Seat #1 is the button
Seat 1: andre692 ($2.43 in chips) 
Seat 2: Tigrashka ($6.90 in chips) 
Seat 3: yakka34 ($1.51 in chips) 
Seat 4: Callewier ($3.84 in chips) 
Seat 5: Gotia39 ($1.04 in chips) 
Seat 6: zetlife ($1.49 in chips) 
Tigrashka: posts small blind $0.01
yakka34: posts big blind $0.02
*** HOLE CARDS ***
Dealt to yakka34 [5d 5h]
Callewier: folds 
Gotia39: folds 
zetlife: raises $0.04 to $0.06
andre692: folds 
Tigrashka: calls $0.05
yakka34: calls $0.04
*** FLOP *** [7s Qd 4d]
Tigrashka: checks 
yakka34: checks 
zetlife: bets $0.13
Tigrashka: folds 
yakka34: folds 
Uncalled bet ($0.13) returned to zetlife
zetlife collected $0.17 from pot
zetlife: doesn't show hand 
*** SUMMARY ***
Total pot $0.18 | Rake $0.01 
Board [7s Qd 4d]
Seat 1: andre692 (button) folded before Flop (didn't bet)
Seat 2: Tigrashka (small blind) folded on the Flop
Seat 3: yakka34 (big blind) folded on the Flop
Seat 4: Callewier folded before Flop (didn't bet)
Seat 5: Gotia39 folded before Flop (didn't bet)
Seat 6: zetlife collected ($0.17)



PokerStars Zoom Hand #172104751560:  Hold'em No Limit ($0.01/$0.02) - 2017/06/22 18:18:28 UTC [2017/06/22 14:18:28 ET]
Table 'Halley' 6-max Seat #1 is the button
Seat 1: GeorgePanai ($2.04 in chips) 
Seat 2: yakka34 ($1.52 in chips) 
Seat 3: firelex1 ($2.02 in chips) 
Seat 4: ungiwar ($2 in chips) 
Seat 5: lucagigi ($2.22 in chips) 
Seat 6: Karsh_1 ($2 in chips) 
yakka34: posts small blind $0.01
firelex1: posts big blind $0.02
*** HOLE CARDS ***
Dealt to yakka34 [3d 2d]
ungiwar: folds 
lucagigi: calls $0.02
Karsh_1: folds 
GeorgePanai: raises $0.06 to $0.08
yakka34: folds 
firelex1: calls $0.06
lucagigi: calls $0.06
*** FLOP *** [2s 5d Ts]
firelex1: checks 
lucagigi: checks 
GeorgePanai: bets $0.12
firelex1: folds 
lucagigi: folds 
Uncalled bet ($0.12) returned to GeorgePanai
GeorgePanai collected $0.24 from pot
GeorgePanai: doesn't show hand 
*** SUMMARY ***
Total pot $0.25 | Rake $0.01 
Board [2s 5d Ts]
Seat 1: GeorgePanai (button) collected ($0.24)
Seat 2: yakka34 (small blind) folded before Flop
Seat 3: firelex1 (big blind) folded on the Flop
Seat 4: ungiwar folded before Flop (didn't bet)
Seat 5: lucagigi folded on the Flop
Seat 6: Karsh_1 folded before Flop (didn't bet)



PokerStars Zoom Hand #172104787611:  Hold'em No Limit ($0.01/$0.02) - 2017/06/22 18:19:18 UTC [2017/06/22 14:19:18 ET]
Table 'Halley' 6-max Seat #1 is the button
Seat 1: NeandersonL ($1.68 in chips) 
Seat 2: yakka34 ($1.45 in chips) 
Seat 3: George031988 ($2 in chips) 
Seat 4: Sharkiep99 ($3.11 in chips) 
Seat 5: Olejka2068 ($0.74 in chips) 
Seat 6: Verm323 ($2.23 in chips) 
yakka34: posts small blind $0.01
George031988: posts big blind $0.02
*** HOLE CARDS ***
Dealt to yakka34 [6c Qc]
Sharkiep99: folds 
Olejka2068: folds 
Verm323: raises $0.03 to $0.05
NeandersonL: folds 
yakka34: folds 
George031988: folds 
Uncalled bet ($0.03) returned to Verm323
Verm323 collected $0.05 from pot
Verm323: doesn't show hand 
*** SUMMARY ***
Total pot $0.05 | Rake $0 
Seat 1: NeandersonL (button) folded before Flop (didn't bet)
Seat 2: yakka34 (small blind) folded before Flop
Seat 3: George031988 (big blind) folded before Flop
Seat 4: Sharkiep99 folded before Flop (didn't bet)
Seat 5: Olejka2068 folded before Flop (didn't bet)
Seat 6: Verm323 collected ($0.05)



PokerStars Zoom Hand #172104784880:  Hold'em No Limit ($0.01/$0.02) - 2017/06/22 18:19:14 UTC [2017/06/22 14:19:14 ET]
Table 'Halley' 6-max Seat #1 is the button
Seat 1: Repairman27 ($2.46 in chips) 
Seat 2: sparky585 ($2 in chips) 
Seat 3: KajsarOFF ($3.42 in chips) 
Seat 4: yakka34 ($1.45 in chips) 
Seat 5: firstandsole ($2.69 in chips) 
Seat 6: 5557890 ($4.71 in chips) 
sparky585: posts small blind $0.01
KajsarOFF: posts big blind $0.02
*** HOLE CARDS ***
Dealt to yakka34 [2s 7c]
yakka34: folds 
firstandsole: folds 
5557890: folds 
Repairman27: folds 
sparky585: raises $0.02 to $0.04
KajsarOFF: calls $0.02
*** FLOP *** [3d Kh 4h]
sparky585: checks 
KajsarOFF: checks 
*** TURN *** [3d Kh 4h] [6s]
sparky585: checks 
KajsarOFF: checks 
*** RIVER *** [3d Kh 4h 6s] [Ts]
sparky585: bets $0.06
KajsarOFF: folds 
Uncalled bet ($0.06) returned to sparky585
sparky585 collected $0.08 from pot
sparky585: doesn't show hand 
*** SUMMARY ***
Total pot $0.08 | Rake $0 
Board [3d Kh 4h 6s Ts]
Seat 1: Repairman27 (button) folded before Flop (didn't bet)
Seat 2: sparky585 (small blind) collected ($0.08)
Seat 3: KajsarOFF (big blind) folded on the River
Seat 4: yakka34 folded before Flop (didn't bet)
Seat 5: firstandsole folded before Flop (didn't bet)
Seat 6: 5557890 folded before Flop (didn't bet)



PokerStars Zoom Hand #172104793320:  Hold'em No Limit ($0.01/$0.02) - 2017/06/22 18:19:26 UTC [2017/06/22 14:19:26 ET]
Table 'Halley' 6-max Seat #1 is the button
Seat 1: turbo nees ($1.75 in chips) 
Seat 2: JuanLevano ($3.75 in chips) 
Seat 3: MooKoR ($2.01 in chips) 
Seat 4: yakka34 ($1.44 in chips) 
Seat 5: crowsen ($2.07 in chips) 
Seat 6: Olegik555 ($2.05 in chips) 
JuanLevano: posts small blind $0.01
MooKoR: posts big blind $0.02
*** HOLE CARDS ***
Dealt to yakka34 [Qh Ks]
yakka34: raises $0.04 to $0.06
crowsen: folds 
Olegik555: folds 
turbo nees: folds 
JuanLevano: folds 
MooKoR: folds 
Uncalled bet ($0.04) returned to yakka34
yakka34 collected $0.05 from pot
yakka34: doesn't show hand 
*** SUMMARY ***
Total pot $0.05 | Rake $0 
Seat 1: turbo nees (button) folded before Flop (didn't bet)
Seat 2: JuanLevano (small blind) folded before Flop
Seat 3: MooKoR (big blind) folded before Flop
Seat 4: yakka34 collected ($0.05)
Seat 5: crowsen folded before Flop (didn't bet)
Seat 6: Olegik555 folded before Flop (didn't bet)



PokerStars Zoom Hand #172104813082:  Hold'em No Limit ($0.01/$0.02) - 2017/06/22 18:19:54 UTC [2017/06/22 14:19:54 ET]
Table 'Halley' 6-max Seat #1 is the button
Seat 1: crowsen ($2.06 in chips) 
Seat 2: DmitryGI7 ($2.21 in chips) 
Seat 3: Aknada777 ($2.22 in chips) 
Seat 4: virus359 ($3.35 in chips) 
Seat 5: ollszi ($2.07 in chips) 
Seat 6: yakka34 ($1.47 in chips) 
DmitryGI7: posts small blind $0.01
Aknada777: posts big blind $0.02
*** HOLE CARDS ***
Dealt to yakka34 [4d 7h]
virus359: folds 
ollszi: folds 
yakka34: folds 
crowsen: raises $0.06 to $0.08
DmitryGI7: folds 
Aknada777: folds 
Uncalled bet ($0.06) returned to crowsen
crowsen collected $0.05 from pot
crowsen: doesn't show hand 
*** SUMMARY ***
Total pot $0.05 | Rake $0 
Seat 1: crowsen (button) collected ($0.05)
Seat 2: DmitryGI7 (small blind) folded before Flop
Seat 3: Aknada777 (big blind) folded before Flop
Seat 4: virus359 folded before Flop (didn't bet)
Seat 5: ollszi folded before Flop (didn't bet)
Seat 6: yakka34 folded before Flop (didn't bet)



PokerStars Zoom Hand #172104816711:  Hold'em No Limit ($0.01/$0.02) - 2017/06/22 18:19:59 UTC [2017/06/22 14:19:59 ET]
Table 'Halley' 6-max Seat #1 is the button
Seat 1: yakka34 ($1.47 in chips) 
Seat 2: George031988 ($2.26 in chips) 
Seat 3: Aleksei Leo ($2 in chips) 
Seat 4: Valsatel ($1.34 in chips) 
Seat 5: lucagigi ($2 in chips) 
Seat 6: vernii579 ($2.43 in chips) 
George031988: posts small blind $0.01
Aleksei Leo: posts big blind $0.02
*** HOLE CARDS ***
Dealt to yakka34 [8d 8s]
Valsatel: folds 
lucagigi: calls $0.02
vernii579: raises $0.04 to $0.06
yakka34: calls $0.06
George031988: folds 
Aleksei Leo: calls $0.04
lucagigi: calls $0.04
*** FLOP *** [2h Ts Jh]
Aleksei Leo: checks 
lucagigi: checks 
vernii579: checks 
yakka34: bets $0.12
Aleksei Leo: folds 
lucagigi: folds 
vernii579: folds 
Uncalled bet ($0.12) returned to yakka34
yakka34 collected $0.24 from pot
yakka34: doesn't show hand 
*** SUMMARY ***
Total pot $0.25 | Rake $0.01 
Board [2h Ts Jh]
Seat 1: yakka34 (button) collected ($0.24)
Seat 2: George031988 (small blind) folded before Flop
Seat 3: Aleksei Leo (big blind) folded on the Flop
Seat 4: Valsatel folded before Flop (didn't bet)
Seat 5: lucagigi folded on the Flop
Seat 6: vernii579 folded on the Flop



PokerStars Zoom Hand #172104863832:  Hold'em No Limit ($0.01/$0.02) - 2017/06/22 18:21:05 UTC [2017/06/22 14:21:05 ET]
Table 'Halley' 6-max Seat #1 is the button
Seat 1: rec1890 ($4.33 in chips) 
Seat 2: m_dionel ($2 in chips) 
Seat 3: yakka34 ($1.65 in chips) 
Seat 4: diceman0909 ($1.89 in chips) 
Seat 5: bcbossman ($3.25 in chips) 
Seat 6: r3v3r ($2.01 in chips) 
m_dionel: posts small blind $0.01
yakka34: posts big blind $0.02
*** HOLE CARDS ***
Dealt to yakka34 [6c 6s]
diceman0909: folds 
bcbossman: folds 
r3v3r: folds 
rec1890: raises $0.02 to $0.04
m_dionel: folds 
yakka34: calls $0.02
*** FLOP *** [7h Ac 5h]
yakka34: bets $0.05
rec1890: folds 
Uncalled bet ($0.05) returned to yakka34
yakka34 collected $0.09 from pot
yakka34: doesn't show hand 
*** SUMMARY ***
Total pot $0.09 | Rake $0 
Board [7h Ac 5h]
Seat 1: rec1890 (button) folded on the Flop
Seat 2: m_dionel (small blind) folded before Flop
Seat 3: yakka34 (big blind) collected ($0.09)
Seat 4: diceman0909 folded before Flop (didn't bet)
Seat 5: bcbossman folded before Flop (didn't bet)
Seat 6: r3v3r folded before Flop (didn't bet)



PokerStars Zoom Hand #172104882447:  Hold'em No Limit ($0.01/$0.02) - 2017/06/22 18:21:31 UTC [2017/06/22 14:21:31 ET]
Table 'Halley' 6-max Seat #1 is the button
Seat 1: yakka34 ($1.70 in chips) 
Seat 2: Karsh_1 ($2.08 in chips) 
Seat 3: evgenij717 ($1.16 in chips) 
Seat 4: MadMaxBG1 ($2.12 in chips) 
Seat 5: Ilya "rc" T ($3.70 in chips) 
Seat 6: AAs only ($2.20 in chips) 
Karsh_1: posts small blind $0.01
evgenij717: posts big blind $0.02
*** HOLE CARDS ***
Dealt to yakka34 [Jc 3h]
MadMaxBG1: raises $0.04 to $0.06
Ilya "rc" T: folds 
AAs only: folds 
yakka34: folds 
Karsh_1: folds 
evgenij717: folds 
Uncalled bet ($0.04) returned to MadMaxBG1
MadMaxBG1 collected $0.05 from pot
MadMaxBG1: doesn't show hand 
*** SUMMARY ***
Total pot $0.05 | Rake $0 
Seat 1: yakka34 (button) folded before Flop (didn't bet)
Seat 2: Karsh_1 (small blind) folded before Flop
Seat 3: evgenij717 (big blind) folded before Flop
Seat 4: MadMaxBG1 collected ($0.05)
Seat 5: Ilya "rc" T folded before Flop (didn't bet)
Seat 6: AAs only folded before Flop (didn't bet)



PokerStars Zoom Hand #172104887523:  Hold'em No Limit ($0.01/$0.02) - 2017/06/22 18:21:38 UTC [2017/06/22 14:21:38 ET]
Table 'Halley' 6-max Seat #1 is the button
Seat 1: mangiopesce ($2.03 in chips) 
Seat 2: r3v3r ($2.57 in chips) 
Seat 3: yakka34 ($1.69 in chips) 
Seat 4: swwedv05 ($1.89 in chips) 
Seat 5: SHALFEISHIK ($1.88 in chips) 
Seat 6: mich125 ($5.28 in chips) 
r3v3r: posts small blind $0.01
yakka34: posts big blind $0.02
*** HOLE CARDS ***
Dealt to yakka34 [6c Ts]
swwedv05: folds 
SHALFEISHIK: folds 
mich125: folds 
mangiopesce: folds 
r3v3r: folds 
Uncalled bet ($0.01) returned to yakka34
yakka34 collected $0.02 from pot
yakka34: doesn't show hand 
*** SUMMARY ***
Total pot $0.02 | Rake $0 
Seat 1: mangiopesce (button) folded before Flop (didn't bet)
Seat 2: r3v3r (small blind) folded before Flop
Seat 3: yakka34 (big blind) collected ($0.02)
Seat 4: swwedv05 folded before Flop (didn't bet)
Seat 5: SHALFEISHIK folded before Flop (didn't bet)
Seat 6: mich125 folded before Flop (didn't bet)



PokerStars Zoom Hand #172104885381:  Hold'em No Limit ($0.01/$0.02) - 2017/06/22 18:21:35 UTC [2017/06/22 14:21:35 ET]
Table 'Halley' 6-max Seat #1 is the button
Seat 1: ufujkz ($0.82 in chips) 
Seat 2: yakka34 ($1.70 in chips) 
Seat 3: jankekek ($2.71 in chips) 
Seat 4: devilchn ($2.55 in chips) 
Seat 5: JBeckerr ($2 in chips) 
Seat 6: ddiego1492 ($1.19 in chips) 
yakka34: posts small blind $0.01
jankekek: posts big blind $0.02
*** HOLE CARDS ***
Dealt to yakka34 [Qc 6d]
devilchn: folds 
JBeckerr: raises $0.04 to $0.06
ddiego1492: folds 
ufujkz: folds 
yakka34: folds 
jankekek: folds 
Uncalled bet ($0.04) returned to JBeckerr
JBeckerr collected $0.05 from pot
JBeckerr: doesn't show hand 
*** SUMMARY ***
Total pot $0.05 | Rake $0 
Seat 1: ufujkz (button) folded before Flop (didn't bet)
Seat 2: yakka34 (small blind) folded before Flop
Seat 3: jankekek (big blind) folded before Flop
Seat 4: devilchn folded before Flop (didn't bet)
Seat 5: JBeckerr collected ($0.05)
Seat 6: ddiego1492 folded before Flop (didn't bet)



PokerStars Zoom Hand #172104878953:  Hold'em No Limit ($0.01/$0.02) - 2017/06/22 18:21:26 UTC [2017/06/22 14:21:26 ET]
Table 'Halley' 6-max Seat #1 is the button
Seat 1: sarge egras ($1.35 in chips) 
Seat 2: lucagigi ($2 in chips) 
Seat 3: LKPony ($2 in chips) 
Seat 4: makwos ($2.13 in chips) 
Seat 5: yakka34 ($1.70 in chips) 
Seat 6: FriskyBear ($2 in chips) 
lucagigi: posts small blind $0.01
LKPony: posts big blind $0.02
*** HOLE CARDS ***
Dealt to yakka34 [7s 5h]
makwos: folds 
yakka34: folds 
FriskyBear: folds 
sarge egras: folds 
lucagigi: calls $0.01
LKPony: checks 
*** FLOP *** [8d Kh 4d]
lucagigi: checks 
LKPony: checks 
*** TURN *** [8d Kh 4d] [Td]
lucagigi: bets $0.04
LKPony: folds 
Uncalled bet ($0.04) returned to lucagigi
lucagigi collected $0.04 from pot
lucagigi: doesn't show hand 
*** SUMMARY ***
Total pot $0.04 | Rake $0 
Board [8d Kh 4d Td]
Seat 1: sarge egras (button) folded before Flop (didn't bet)
Seat 2: lucagigi (small blind) collected ($0.04)
Seat 3: LKPony (big blind) folded on the Turn
Seat 4: makwos folded before Flop (didn't bet)
Seat 5: yakka34 folded before Flop (didn't bet)
Seat 6: FriskyBear folded before Flop (didn't bet)



PokerStars Zoom Hand #172104894684:  Hold'em No Limit ($0.01/$0.02) - 2017/06/22 18:21:48 UTC [2017/06/22 14:21:48 ET]
Table 'Halley' 6-max Seat #1 is the button
Seat 1: PotapskihA.A ($3.90 in chips) 
Seat 2: jax2024 ($4.87 in chips) 
Seat 3: AlexandrosJC ($6.38 in chips) 
Seat 4: yakka34 ($1.70 in chips) 
Seat 5: styxxx55 ($2.06 in chips) 
Seat 6: AceJeffKing ($4.49 in chips) 
jax2024: posts small blind $0.01
AlexandrosJC: posts big blind $0.02
*** HOLE CARDS ***
Dealt to yakka34 [4h 7s]
yakka34: folds 
styxxx55: raises $0.04 to $0.06
AceJeffKing: folds 
PotapskihA.A: folds 
jax2024: folds 
AlexandrosJC: calls $0.04
*** FLOP *** [Kc Th 7c]
AlexandrosJC: checks 
styxxx55: bets $0.09
AlexandrosJC: folds 
Uncalled bet ($0.09) returned to styxxx55
styxxx55 collected $0.13 from pot
styxxx55: doesn't show hand 
*** SUMMARY ***
Total pot $0.13 | Rake $0 
Board [Kc Th 7c]
Seat 1: PotapskihA.A (button) folded before Flop (didn't bet)
Seat 2: jax2024 (small blind) folded before Flop
Seat 3: AlexandrosJC (big blind) folded on the Flop
Seat 4: yakka34 folded before Flop (didn't bet)
Seat 5: styxxx55 collected ($0.13)
Seat 6: AceJeffKing folded before Flop (didn't bet)



PokerStars Zoom Hand #172104897500:  Hold'em No Limit ($0.01/$0.02) - 2017/06/22 18:21:52 UTC [2017/06/22 14:21:52 ET]
Table 'Halley' 6-max Seat #1 is the button
Seat 1: 2232012 ($3.27 in chips) 
Seat 2: AlphaBlitz ($4.49 in chips) 
Seat 3: yurka778 ($2.05 in chips) 
Seat 4: Samirka1994. ($1 in chips) 
Seat 5: TakeAJack ($2 in chips) 
Seat 6: yakka34 ($1.70 in chips) 
AlphaBlitz: posts small blind $0.01
yurka778: posts big blind $0.02
*** HOLE CARDS ***
Dealt to yakka34 [Js Qh]
Samirka1994.: folds 
TakeAJack: folds 
yakka34: raises $0.04 to $0.06
2232012: raises $0.15 to $0.21
AlphaBlitz: folds 
yurka778: folds 
yakka34: calls $0.15
*** FLOP *** [Jd 7c Jc]
yakka34: checks 
2232012: checks 
*** TURN *** [Jd 7c Jc] [Qc]
yakka34: bets $0.20
2232012: calls $0.20
*** RIVER *** [Jd 7c Jc Qc] [5h]
yakka34: bets $1.29 and is all-in
2232012: folds 
Uncalled bet ($1.29) returned to yakka34
yakka34 collected $0.82 from pot
yakka34: doesn't show hand 
*** SUMMARY ***
Total pot $0.85 | Rake $0.03 
Board [Jd 7c Jc Qc 5h]
Seat 1: 2232012 (button) folded on the River
Seat 2: AlphaBlitz (small blind) folded before Flop
Seat 3: yurka778 (big blind) folded before Flop
Seat 4: Samirka1994. folded before Flop (didn't bet)
Seat 5: TakeAJack folded before Flop (didn't bet)
Seat 6: yakka34 collected ($0.82)



PokerStars Zoom Hand #172104949957:  Hold'em No Limit ($0.01/$0.02) - 2017/06/22 18:23:05 UTC [2017/06/22 14:23:05 ET]
Table 'Halley' 6-max Seat #1 is the button
Seat 1: sash120386 ($3 in chips) 
Seat 2: yakka34 ($2.11 in chips) 
Seat 3: bata_emts ($2.14 in chips) 
Seat 4: xbod7722 ($1.84 in chips) 
Seat 5: xtddai ($2.21 in chips) 
Seat 6: ugi-dugi ($2.39 in chips) 
yakka34: posts small blind $0.01
bata_emts: posts big blind $0.02
*** HOLE CARDS ***
Dealt to yakka34 [9s Ks]
xbod7722: folds 
xtddai: folds 
ugi-dugi: folds 
sash120386: folds 
yakka34: raises $0.02 to $0.04
bata_emts: raises $0.02 to $0.06
yakka34: calls $0.02
*** FLOP *** [4s 3d 3c]
yakka34: checks 
bata_emts: bets $0.06
yakka34: folds 
Uncalled bet ($0.06) returned to bata_emts
bata_emts collected $0.12 from pot
bata_emts: doesn't show hand 
*** SUMMARY ***
Total pot $0.12 | Rake $0 
Board [4s 3d 3c]
Seat 1: sash120386 (button) folded before Flop (didn't bet)
Seat 2: yakka34 (small blind) folded on the Flop
Seat 3: bata_emts (big blind) collected ($0.12)
Seat 4: xbod7722 folded before Flop (didn't bet)
Seat 5: xtddai folded before Flop (didn't bet)
Seat 6: ugi-dugi folded before Flop (didn't bet)



PokerStars Zoom Hand #172104965209:  Hold'em No Limit ($0.01/$0.02) - 2017/06/22 18:23:26 UTC [2017/06/22 14:23:26 ET]
Table 'Halley' 6-max Seat #1 is the button
Seat 1: EcsmoBerlin ($2 in chips) 
Seat 2: owengigi8888 ($2.71 in chips) 
Seat 3: Valsatel ($1.65 in chips) 
Seat 4: marik1001 ($5.34 in chips) 
Seat 5: yakka34 ($2.05 in chips) 
Seat 6: MsMurena ($2.03 in chips) 
owengigi8888: posts small blind $0.01
Valsatel: posts big blind $0.02
*** HOLE CARDS ***
Dealt to yakka34 [2c 3c]
marik1001: folds 
yakka34: folds 
MsMurena: raises $0.04 to $0.06
EcsmoBerlin: folds 
owengigi8888: folds 
Valsatel: folds 
Uncalled bet ($0.04) returned to MsMurena
MsMurena collected $0.05 from pot
MsMurena: doesn't show hand 
*** SUMMARY ***
Total pot $0.05 | Rake $0 
Seat 1: EcsmoBerlin (button) folded before Flop (didn't bet)
Seat 2: owengigi8888 (small blind) folded before Flop
Seat 3: Valsatel (big blind) folded before Flop
Seat 4: marik1001 folded before Flop (didn't bet)
Seat 5: yakka34 folded before Flop (didn't bet)
Seat 6: MsMurena collected ($0.05)



PokerStars Zoom Hand #172104968769:  Hold'em No Limit ($0.01/$0.02) - 2017/06/22 18:23:31 UTC [2017/06/22 14:23:31 ET]
Table 'Halley' 6-max Seat #1 is the button
Seat 1: yakka34 ($2.05 in chips) 
Seat 2: vldxa ($3.12 in chips) 
Seat 3: lucastav206 ($2.44 in chips) 
Seat 4: MULGESEAL ($2 in chips) 
Seat 5: sash120386 ($3 in chips) 
Seat 6: AlphaBlitz ($5.09 in chips) 
vldxa: posts small blind $0.01
lucastav206: posts big blind $0.02
*** HOLE CARDS ***
Dealt to yakka34 [Ac 5c]
MULGESEAL: raises $0.03 to $0.05
sash120386: folds 
AlphaBlitz: folds 
yakka34: calls $0.05
vldxa: folds 
lucastav206: folds 
*** FLOP *** [7c Kc Ad]
MULGESEAL: checks 
yakka34: bets $0.07
MULGESEAL: folds 
Uncalled bet ($0.07) returned to yakka34
yakka34 collected $0.13 from pot
yakka34: doesn't show hand 
*** SUMMARY ***
Total pot $0.13 | Rake $0 
Board [7c Kc Ad]
Seat 1: yakka34 (button) collected ($0.13)
Seat 2: vldxa (small blind) folded before Flop
Seat 3: lucastav206 (big blind) folded before Flop
Seat 4: MULGESEAL folded on the Flop
Seat 5: sash120386 folded before Flop (didn't bet)
Seat 6: AlphaBlitz folded before Flop (didn't bet)



PokerStars Zoom Hand #172104981924:  Hold'em No Limit ($0.01/$0.02) - 2017/06/22 18:23:49 UTC [2017/06/22 14:23:49 ET]
Table 'Halley' 6-max Seat #1 is the button
Seat 1: DryBoard ($2.92 in chips) 
Seat 2: ASENNA76 ($2.12 in chips) 
Seat 3: Igorshtef ($2.02 in chips) 
Seat 4: and1isgod92 ($3.78 in chips) 
Seat 5: yakka34 ($2.13 in chips) 
Seat 6: DonRazVan18 ($1.62 in chips) 
ASENNA76: posts small blind $0.01
Igorshtef: posts big blind $0.02
*** HOLE CARDS ***
Dealt to yakka34 [Th Jd]
and1isgod92: folds 
yakka34: calls $0.02
DonRazVan18: folds 
DryBoard: folds 
ASENNA76: raises $0.08 to $0.10
Igorshtef: folds 
yakka34: folds 
Uncalled bet ($0.08) returned to ASENNA76
ASENNA76 collected $0.06 from pot
ASENNA76: doesn't show hand 
*** SUMMARY ***
Total pot $0.06 | Rake $0 
Seat 1: DryBoard (button) folded before Flop (didn't bet)
Seat 2: ASENNA76 (small blind) collected ($0.06)
Seat 3: Igorshtef (big blind) folded before Flop
Seat 4: and1isgod92 folded before Flop (didn't bet)
Seat 5: yakka34 folded before Flop
Seat 6: DonRazVan18 folded before Flop (didn't bet)



PokerStars Zoom Hand #172104990634:  Hold'em No Limit ($0.01/$0.02) - 2017/06/22 18:24:01 UTC [2017/06/22 14:24:01 ET]
Table 'Halley' 6-max Seat #1 is the button
Seat 1: amri2000 ($2.01 in chips) 
Seat 2: copetin11 ($6.28 in chips) 
Seat 3: Greg3184 ($2 in chips) 
Seat 4: yakka34 ($2.11 in chips) 
Seat 5: DMCHMB ($4.46 in chips) 
Seat 6: athtour ($2.96 in chips) 
copetin11: posts small blind $0.01
Greg3184: posts big blind $0.02
*** HOLE CARDS ***
Dealt to yakka34 [5d Kc]
yakka34: folds 
DMCHMB: folds 
athtour: raises $0.03 to $0.05
amri2000: folds 
copetin11: folds 
Greg3184: folds 
Uncalled bet ($0.03) returned to athtour
athtour collected $0.05 from pot
athtour: doesn't show hand 
*** SUMMARY ***
Total pot $0.05 | Rake $0 
Seat 1: amri2000 (button) folded before Flop (didn't bet)
Seat 2: copetin11 (small blind) folded before Flop
Seat 3: Greg3184 (big blind) folded before Flop
Seat 4: yakka34 folded before Flop (didn't bet)
Seat 5: DMCHMB folded before Flop (didn't bet)
Seat 6: athtour collected ($0.05)



PokerStars Zoom Hand #172104993578:  Hold'em No Limit ($0.01/$0.02) - 2017/06/22 18:24:05 UTC [2017/06/22 14:24:05 ET]
Table 'Halley' 6-max Seat #1 is the button
Seat 1: usek-huysek ($2.19 in chips) 
Seat 2: wyttrom ($2 in chips) 
Seat 3: yakka34 ($2.11 in chips) 
Seat 4: unique1012 ($2.60 in chips) 
Seat 5: Dantelot ($1.57 in chips) 
Seat 6: fkmaivan ($4.45 in chips) 
wyttrom: posts small blind $0.01
yakka34: posts big blind $0.02
*** HOLE CARDS ***
Dealt to yakka34 [Ts Kd]
unique1012: folds 
Dantelot: folds 
fkmaivan: raises $0.04 to $0.06
usek-huysek: folds 
wyttrom: folds 
yakka34: folds 
Uncalled bet ($0.04) returned to fkmaivan
fkmaivan collected $0.05 from pot
fkmaivan: doesn't show hand 
*** SUMMARY ***
Total pot $0.05 | Rake $0 
Seat 1: usek-huysek (button) folded before Flop (didn't bet)
Seat 2: wyttrom (small blind) folded before Flop
Seat 3: yakka34 (big blind) folded before Flop
Seat 4: unique1012 folded before Flop (didn't bet)
Seat 5: Dantelot folded before Flop (didn't bet)
Seat 6: fkmaivan collected ($0.05)



PokerStars Zoom Hand #172105004502:  Hold'em No Limit ($0.01/$0.02) - 2017/06/22 18:24:20 UTC [2017/06/22 14:24:20 ET]
Table 'Halley' 6-max Seat #1 is the button
Seat 1: GeorgePanai ($2.01 in chips) 
Seat 2: ufujkz ($0.70 in chips) 
Seat 3: ugo_59_59 ($16.28 in chips) 
Seat 4: Saranagati ($1.20 in chips) 
Seat 5: yakka34 ($2.09 in chips) 
Seat 6: AceJeffKing ($5.73 in chips) 
ufujkz: posts small blind $0.01
ugo_59_59: posts big blind $0.02
*** HOLE CARDS ***
Dealt to yakka34 [Qc Qd]
Saranagati: folds 
yakka34: raises $0.04 to $0.06
AceJeffKing: folds 
GeorgePanai: folds 
ufujkz: folds 
ugo_59_59: folds 
Uncalled bet ($0.04) returned to yakka34
yakka34 collected $0.05 from pot
yakka34: doesn't show hand 
*** SUMMARY ***
Total pot $0.05 | Rake $0 
Seat 1: GeorgePanai (button) folded before Flop (didn't bet)
Seat 2: ufujkz (small blind) folded before Flop
Seat 3: ugo_59_59 (big blind) folded before Flop
Seat 4: Saranagati folded before Flop (didn't bet)
Seat 5: yakka34 collected ($0.05)
Seat 6: AceJeffKing folded before Flop (didn't bet)



PokerStars Zoom Hand #172105001582:  Hold'em No Limit ($0.01/$0.02) - 2017/06/22 18:24:16 UTC [2017/06/22 14:24:16 ET]
Table 'Halley' 6-max Seat #1 is the button
Seat 1: styxxx55 ($2.21 in chips) 
Seat 2: and1isgod92 ($3.79 in chips) 
Seat 3: Scouserslfc ($2.55 in chips) 
Seat 4: flaviozaca ($2.93 in chips) 
Seat 5: MadMaxBG1 ($2.09 in chips) 
Seat 6: yakka34 ($2.09 in chips) 
and1isgod92: posts small blind $0.01
Scouserslfc: posts big blind $0.02
*** HOLE CARDS ***
Dealt to yakka34 [Jh 8c]
flaviozaca: folds 
MadMaxBG1: raises $0.04 to $0.06
yakka34: folds 
styxxx55: folds 
and1isgod92: folds 
Scouserslfc: calls $0.04
*** FLOP *** [Ad Qd Ks]
Scouserslfc: bets $0.07
MadMaxBG1: calls $0.07
*** TURN *** [Ad Qd Ks] [5d]
Scouserslfc: bets $0.13
MadMaxBG1: calls $0.13
*** RIVER *** [Ad Qd Ks 5d] [Js]
Scouserslfc: bets $0.17
MadMaxBG1: raises $0.43 to $0.60
Scouserslfc: folds 
Uncalled bet ($0.43) returned to MadMaxBG1
MadMaxBG1 collected $0.84 from pot
MadMaxBG1: doesn't show hand 
*** SUMMARY ***
Total pot $0.87 | Rake $0.03 
Board [Ad Qd Ks 5d Js]
Seat 1: styxxx55 (button) folded before Flop (didn't bet)
Seat 2: and1isgod92 (small blind) folded before Flop
Seat 3: Scouserslfc (big blind) folded on the River
Seat 4: flaviozaca folded before Flop (didn't bet)
Seat 5: MadMaxBG1 collected ($0.84)
Seat 6: yakka34 folded before Flop (didn't bet)



PokerStars Zoom Hand #172105012483:  Hold'em No Limit ($0.01/$0.02) - 2017/06/22 18:24:31 UTC [2017/06/22 14:24:31 ET]
Table 'Halley' 6-max Seat #1 is the button
Seat 1: Willy222444 ($3.90 in chips) 
Seat 2: ugo_59_59 ($16.26 in chips) 
Seat 3: w0kep ($3.18 in chips) 
Seat 4: yakka34 ($2.12 in chips) 
Seat 5: firelex1 ($2.86 in chips) 
Seat 6: CleberMS10 ($4.19 in chips) 
ugo_59_59: posts small blind $0.01
w0kep: posts big blind $0.02
*** HOLE CARDS ***
Dealt to yakka34 [7s 7d]
yakka34: raises $0.04 to $0.06
firelex1: folds 
CleberMS10: folds 
Willy222444: calls $0.06
ugo_59_59: folds 
w0kep: folds 
*** FLOP *** [6c 4c 9d]
yakka34: bets $0.14
Willy222444: calls $0.14
*** TURN *** [6c 4c 9d] [Qc]
yakka34: checks 
Willy222444: checks 
*** RIVER *** [6c 4c 9d Qc] [6d]
yakka34: checks 
Willy222444: checks 
*** SHOW DOWN ***
yakka34: shows [7s 7d] (two pair, Sevens and Sixes)
Willy222444: mucks hand 
yakka34 collected $0.41 from pot
*** SUMMARY ***
Total pot $0.43 | Rake $0.02 
Board [6c 4c 9d Qc 6d]
Seat 1: Willy222444 (button) mucked [8c 7h]
Seat 2: ugo_59_59 (small blind) folded before Flop
Seat 3: w0kep (big blind) folded before Flop
Seat 4: yakka34 showed [7s 7d] and won ($0.41) with two pair, Sevens and Sixes
Seat 5: firelex1 folded before Flop (didn't bet)
Seat 6: CleberMS10 folded before Flop (didn't bet)



PokerStars Zoom Hand #172105049514:  Hold'em No Limit ($0.01/$0.02) - 2017/06/22 18:25:22 UTC [2017/06/22 14:25:22 ET]
Table 'Halley' 6-max Seat #1 is the button
Seat 1: FriskyBear ($2.02 in chips) 
Seat 2: yakka34 ($2.33 in chips) 
Seat 3: Willy222444 ($2 in chips) 
Seat 4: wyttrom ($2.43 in chips) 
Seat 5: luxio giovan ($2.73 in chips) 
Seat 6: TellsSohn ($1.89 in chips) 
yakka34: posts small blind $0.01
Willy222444: posts big blind $0.02
*** HOLE CARDS ***
Dealt to yakka34 [2h 2s]
wyttrom: folds 
luxio giovan: folds 
TellsSohn: folds 
FriskyBear: folds 
yakka34: raises $0.02 to $0.04
Willy222444: calls $0.02
*** FLOP *** [Jd 6d 5c]
yakka34: bets $0.04
Willy222444: folds 
Uncalled bet ($0.04) returned to yakka34
yakka34 collected $0.08 from pot
yakka34: doesn't show hand 
*** SUMMARY ***
Total pot $0.08 | Rake $0 
Board [Jd 6d 5c]
Seat 1: FriskyBear (button) folded before Flop (didn't bet)
Seat 2: yakka34 (small blind) collected ($0.08)
Seat 3: Willy222444 (big blind) folded on the Flop
Seat 4: wyttrom folded before Flop (didn't bet)
Seat 5: luxio giovan folded before Flop (didn't bet)
Seat 6: TellsSohn folded before Flop (didn't bet)



PokerStars Zoom Hand #172105063257:  Hold'em No Limit ($0.01/$0.02) - 2017/06/22 18:25:41 UTC [2017/06/22 14:25:41 ET]
Table 'Halley' 6-max Seat #1 is the button
Seat 1: vavan12354 ($3.32 in chips) 
Seat 2: zerohorabr ($1.95 in chips) 
Seat 3: Valsatel ($1.58 in chips) 
Seat 4: yakka34 ($2.37 in chips) 
Seat 5: unique1012 ($2.62 in chips) 
Seat 6: Il moustruo ($1.97 in chips) 
zerohorabr: posts small blind $0.01
Valsatel: posts big blind $0.02
*** HOLE CARDS ***
Dealt to yakka34 [6h Js]
yakka34: folds 
unique1012: folds 
Il moustruo: raises $0.05 to $0.07
vavan12354: folds 
zerohorabr: folds 
Valsatel: folds 
Uncalled bet ($0.05) returned to Il moustruo
Il moustruo collected $0.05 from pot
Il moustruo: doesn't show hand 
*** SUMMARY ***
Total pot $0.05 | Rake $0 
Seat 1: vavan12354 (button) folded before Flop (didn't bet)
Seat 2: zerohorabr (small blind) folded before Flop
Seat 3: Valsatel (big blind) folded before Flop
Seat 4: yakka34 folded before Flop (didn't bet)
Seat 5: unique1012 folded before Flop (didn't bet)
Seat 6: Il moustruo collected ($0.05)



PokerStars Zoom Hand #172105066122:  Hold'em No Limit ($0.01/$0.02) - 2017/06/22 18:25:45 UTC [2017/06/22 14:25:45 ET]
Table 'Halley' 6-max Seat #1 is the button
Seat 1: lyahoffff ($2.26 in chips) 
Seat 2: violoncelle ($3.32 in chips) 
Seat 3: yakka34 ($2.37 in chips) 
Seat 4: Xtampede ($5.06 in chips) 
Seat 5: pedroaberger ($2.79 in chips) 
Seat 6: Willy222444 ($3.68 in chips) 
violoncelle: posts small blind $0.01
yakka34: posts big blind $0.02
*** HOLE CARDS ***
Dealt to yakka34 [Td Th]
Xtampede: folds 
pedroaberger: folds 
Willy222444: raises $0.03 to $0.05
lyahoffff: folds 
violoncelle: folds 
yakka34: raises $0.03 to $0.08
Willy222444: calls $0.03
*** FLOP *** [Tc Ts Jc]
yakka34: bets $0.02
Willy222444: folds 
Uncalled bet ($0.02) returned to yakka34
yakka34 collected $0.16 from pot
yakka34: doesn't show hand 
*** SUMMARY ***
Total pot $0.17 | Rake $0.01 
Board [Tc Ts Jc]
Seat 1: lyahoffff (button) folded before Flop (didn't bet)
Seat 2: violoncelle (small blind) folded before Flop
Seat 3: yakka34 (big blind) collected ($0.16)
Seat 4: Xtampede folded before Flop (didn't bet)
Seat 5: pedroaberger folded before Flop (didn't bet)
Seat 6: Willy222444 folded on the Flop



PokerStars Zoom Hand #172105088545:  Hold'em No Limit ($0.01/$0.02) - 2017/06/22 18:26:16 UTC [2017/06/22 14:26:16 ET]
Table 'Halley' 6-max Seat #1 is the button
Seat 1: yakka34 ($2.45 in chips) 
Seat 2: theChosef ($3.92 in chips) 
Seat 3: korda17 ($2.96 in chips) 
Seat 4: zerohorabr ($1.92 in chips) 
Seat 5: MB/Brazil ($1.77 in chips) 
Seat 6: Gri6Nik ($4.99 in chips) 
theChosef: posts small blind $0.01
korda17: posts big blind $0.02
*** HOLE CARDS ***
Dealt to yakka34 [4d Kc]
zerohorabr: folds 
MB/Brazil: folds 
Gri6Nik: folds 
yakka34: folds 
theChosef: folds 
Uncalled bet ($0.01) returned to korda17
korda17 collected $0.02 from pot
korda17: doesn't show hand 
*** SUMMARY ***
Total pot $0.02 | Rake $0 
Seat 1: yakka34 (button) folded before Flop (didn't bet)
Seat 2: theChosef (small blind) folded before Flop
Seat 3: korda17 (big blind) collected ($0.02)
Seat 4: zerohorabr folded before Flop (didn't bet)
Seat 5: MB/Brazil folded before Flop (didn't bet)
Seat 6: Gri6Nik folded before Flop (didn't bet)



PokerStars Zoom Hand #172105093476:  Hold'em No Limit ($0.01/$0.02) - 2017/06/22 18:26:23 UTC [2017/06/22 14:26:23 ET]
Table 'Halley' 6-max Seat #1 is the button
Seat 1: Da84d ($2.37 in chips) 
Seat 2: yakka34 ($2.45 in chips) 
Seat 3: styxxx55 ($2.21 in chips) 
Seat 4: MarioAlan ($7.21 in chips) 
Seat 5: voldemar800 ($1.96 in chips) 
Seat 6: crush1982 ($4.30 in chips) 
yakka34: posts small blind $0.01
styxxx55: posts big blind $0.02
*** HOLE CARDS ***
Dealt to yakka34 [Jc 9s]
MarioAlan: folds 
voldemar800: raises $0.03 to $0.05
crush1982: folds 
Da84d: folds 
yakka34: folds 
styxxx55: folds 
Uncalled bet ($0.03) returned to voldemar800
voldemar800 collected $0.05 from pot
voldemar800: doesn't show hand 
*** SUMMARY ***
Total pot $0.05 | Rake $0 
Seat 1: Da84d (button) folded before Flop (didn't bet)
Seat 2: yakka34 (small blind) folded before Flop
Seat 3: styxxx55 (big blind) folded before Flop
Seat 4: MarioAlan folded before Flop (didn't bet)
Seat 5: voldemar800 collected ($0.05)
Seat 6: crush1982 folded before Flop (didn't bet)



PokerStars Zoom Hand #172105099907:  Hold'em No Limit ($0.01/$0.02) - 2017/06/22 18:26:32 UTC [2017/06/22 14:26:32 ET]
Table 'Halley' 6-max Seat #1 is the button
Seat 1: Verm323 ($2.15 in chips) 
Seat 2: gamabynt ($4.08 in chips) 
Seat 3: guigmr ($1.52 in chips) 
Seat 4: Shogasin ($3.03 in chips) 
Seat 5: AlexandrosJC ($6.53 in chips) 
Seat 6: yakka34 ($2.44 in chips) 
gamabynt: posts small blind $0.01
guigmr: posts big blind $0.02
*** HOLE CARDS ***
Dealt to yakka34 [8d Qs]
Shogasin: folds 
AlexandrosJC: folds 
yakka34: raises $0.04 to $0.06
Verm323: folds 
gamabynt: folds 
guigmr: folds 
Uncalled bet ($0.04) returned to yakka34
yakka34 collected $0.05 from pot
yakka34: doesn't show hand 
*** SUMMARY ***
Total pot $0.05 | Rake $0 
Seat 1: Verm323 (button) folded before Flop (didn't bet)
Seat 2: gamabynt (small blind) folded before Flop
Seat 3: guigmr (big blind) folded before Flop
Seat 4: Shogasin folded before Flop (didn't bet)
Seat 5: AlexandrosJC folded before Flop (didn't bet)
Seat 6: yakka34 collected ($0.05)



PokerStars Zoom Hand #172105110637:  Hold'em No Limit ($0.01/$0.02) - 2017/06/22 18:26:47 UTC [2017/06/22 14:26:47 ET]
Table 'Halley' 6-max Seat #1 is the button
Seat 1: epikouros93 ($3.82 in chips) 
Seat 2: gena60 ($2 in chips) 
Seat 3: ANDREYPEN58 ($3.10 in chips) 
Seat 4: s0chi161090 ($1.10 in chips) 
Seat 5: yakka34 ($2.47 in chips) 
Seat 6: _Adamasto_09 ($2.52 in chips) 
gena60: posts small blind $0.01
ANDREYPEN58: posts big blind $0.02
*** HOLE CARDS ***
Dealt to yakka34 [Qd 5c]
s0chi161090: raises $0.04 to $0.06
yakka34: folds 
_Adamasto_09: raises $0.12 to $0.18
epikouros93: folds 
gena60: folds 
ANDREYPEN58: folds 
s0chi161090: folds 
Uncalled bet ($0.12) returned to _Adamasto_09
_Adamasto_09 collected $0.15 from pot
_Adamasto_09: doesn't show hand 
*** SUMMARY ***
Total pot $0.15 | Rake $0 
Seat 1: epikouros93 (button) folded before Flop (didn't bet)
Seat 2: gena60 (small blind) folded before Flop
Seat 3: ANDREYPEN58 (big blind) folded before Flop
Seat 4: s0chi161090 folded before Flop
Seat 5: yakka34 folded before Flop (didn't bet)
Seat 6: _Adamasto_09 collected ($0.15)



PokerStars Zoom Hand #172105113507:  Hold'em No Limit ($0.01/$0.02) - 2017/06/22 18:26:51 UTC [2017/06/22 14:26:51 ET]
Table 'Halley' 6-max Seat #1 is the button
Seat 1: Goldjepwnt ($2.80 in chips) 
Seat 2: VivaLaBee ($2.24 in chips) 
Seat 3: pjsgalvao ($3.97 in chips) 
Seat 4: yakka34 ($2.47 in chips) 
Seat 5: AleksSiri ($1 in chips) 
Seat 6: skortep ($2.21 in chips) 
VivaLaBee: posts small blind $0.01
pjsgalvao: posts big blind $0.02
*** HOLE CARDS ***
Dealt to yakka34 [2s 8h]
yakka34: folds 
AleksSiri: raises $0.04 to $0.06
skortep: folds 
Goldjepwnt: folds 
VivaLaBee: folds 
pjsgalvao: folds 
Uncalled bet ($0.04) returned to AleksSiri
AleksSiri collected $0.05 from pot
AleksSiri: doesn't show hand 
*** SUMMARY ***
Total pot $0.05 | Rake $0 
Seat 1: Goldjepwnt (button) folded before Flop (didn't bet)
Seat 2: VivaLaBee (small blind) folded before Flop
Seat 3: pjsgalvao (big blind) folded before Flop
Seat 4: yakka34 folded before Flop (didn't bet)
Seat 5: AleksSiri collected ($0.05)
Seat 6: skortep folded before Flop (didn't bet)



PokerStars Zoom Hand #172105119975:  Hold'em No Limit ($0.01/$0.02) - 2017/06/22 18:27:00 UTC [2017/06/22 14:27:00 ET]
Table 'Halley' 6-max Seat #1 is the button
Seat 1: Nomoney099 ($2 in chips) 
Seat 2: koksEX ($2.31 in chips) 
Seat 3: yakka34 ($2.47 in chips) 
Seat 4: evgen1917 ($1.15 in chips) 
Seat 5: Piwos ($1.95 in chips) 
Seat 6: Mastermuzzz ($2.35 in chips) 
koksEX: posts small blind $0.01
yakka34: posts big blind $0.02
*** HOLE CARDS ***
Dealt to yakka34 [Ts Qh]
evgen1917: folds 
Piwos: folds 
Mastermuzzz: folds 
Nomoney099: raises $0.04 to $0.06
koksEX: folds 
yakka34: folds 
Uncalled bet ($0.04) returned to Nomoney099
Nomoney099 collected $0.05 from pot
Nomoney099: doesn't show hand 
*** SUMMARY ***
Total pot $0.05 | Rake $0 
Seat 1: Nomoney099 (button) collected ($0.05)
Seat 2: koksEX (small blind) folded before Flop
Seat 3: yakka34 (big blind) folded before Flop
Seat 4: evgen1917 folded before Flop (didn't bet)
Seat 5: Piwos folded before Flop (didn't bet)
Seat 6: Mastermuzzz folded before Flop (didn't bet)



PokerStars Zoom Hand #172105130703:  Hold'em No Limit ($0.01/$0.02) - 2017/06/22 18:27:15 UTC [2017/06/22 14:27:15 ET]
Table 'Halley' 6-max Seat #1 is the button
Seat 1: yakka34 ($2.45 in chips) 
Seat 2: cristikiti ($2 in chips) 
Seat 3: onlyfoolsguy ($2 in chips) 
Seat 4: Greg3184 ($2.33 in chips) 
Seat 5: vlad.dan84 ($2.12 in chips) 
Seat 6: mich125 ($6.75 in chips) 
cristikiti: posts small blind $0.01
onlyfoolsguy: posts big blind $0.02
*** HOLE CARDS ***
Dealt to yakka34 [6h 5h]
Greg3184: folds 
vlad.dan84: folds 
mich125: folds 
yakka34: raises $0.02 to $0.04
cristikiti: folds 
onlyfoolsguy: folds 
Uncalled bet ($0.02) returned to yakka34
yakka34 collected $0.05 from pot
yakka34: doesn't show hand 
*** SUMMARY ***
Total pot $0.05 | Rake $0 
Seat 1: yakka34 (button) collected ($0.05)
Seat 2: cristikiti (small blind) folded before Flop
Seat 3: onlyfoolsguy (big blind) folded before Flop
Seat 4: Greg3184 folded before Flop (didn't bet)
Seat 5: vlad.dan84 folded before Flop (didn't bet)
Seat 6: mich125 folded before Flop (didn't bet)



PokerStars Zoom Hand #172105117129:  Hold'em No Limit ($0.01/$0.02) - 2017/06/22 18:26:56 UTC [2017/06/22 14:26:56 ET]
Table 'Halley' 6-max Seat #1 is the button
Seat 1: 7rocket ($2 in chips) 
Seat 2: jcjvr ($3.73 in chips) 
Seat 3: Verm323 ($2.03 in chips) 
Seat 4: clint hollier ($1.22 in chips) 
Seat 5: DieRenate ($1.06 in chips) 
Seat 6: yakka34 ($2.47 in chips) 
jcjvr: posts small blind $0.01
Verm323: posts big blind $0.02
*** HOLE CARDS ***
Dealt to yakka34 [3s 7c]
clint hollier: calls $0.02
DieRenate: calls $0.02
yakka34: folds 
7rocket: folds 
jcjvr: folds 
Verm323: checks 
*** FLOP *** [5d 9c Td]
Verm323: checks 
clint hollier: bets $0.02
DieRenate: calls $0.02
Verm323: folds 
*** TURN *** [5d 9c Td] [2s]
clint hollier: checks 
DieRenate: checks 
*** RIVER *** [5d 9c Td 2s] [3d]
clint hollier: checks 
DieRenate: checks 
*** SHOW DOWN ***
clint hollier: shows [Ks Js] (high card King)
DieRenate: shows [Ad 5h] (a pair of Fives)
DieRenate collected $0.11 from pot
*** SUMMARY ***
Total pot $0.11 | Rake $0 
Board [5d 9c Td 2s 3d]
Seat 1: 7rocket (button) folded before Flop (didn't bet)
Seat 2: jcjvr (small blind) folded before Flop
Seat 3: Verm323 (big blind) folded on the Flop
Seat 4: clint hollier showed [Ks Js] and lost with high card King
Seat 5: DieRenate showed [Ad 5h] and won ($0.11) with a pair of Fives
Seat 6: yakka34 folded before Flop (didn't bet)



PokerStars Zoom Hand #172105150009:  Hold'em No Limit ($0.01/$0.02) - 2017/06/22 18:27:42 UTC [2017/06/22 14:27:42 ET]
Table 'Halley' 6-max Seat #1 is the button
Seat 1: cristikiti ($2.13 in chips) 
Seat 2: yakka34 ($2.48 in chips) 
Seat 3: dk.eu ($3.01 in chips) 
Seat 4: Troyan555 ($4.09 in chips) 
Seat 5: polunohnik ($1.43 in chips) 
Seat 6: KOCTEHbKA193 ($2.03 in chips) 
yakka34: posts small blind $0.01
dk.eu: posts big blind $0.02
*** HOLE CARDS ***
Dealt to yakka34 [9s 3d]
Troyan555: folds 
polunohnik: folds 
KOCTEHbKA193: folds 
cristikiti: folds 
yakka34: folds 
Uncalled bet ($0.01) returned to dk.eu
dk.eu collected $0.02 from pot
dk.eu: doesn't show hand 
*** SUMMARY ***
Total pot $0.02 | Rake $0 
Seat 1: cristikiti (button) folded before Flop (didn't bet)
Seat 2: yakka34 (small blind) folded before Flop
Seat 3: dk.eu (big blind) collected ($0.02)
Seat 4: Troyan555 folded before Flop (didn't bet)
Seat 5: polunohnik folded before Flop (didn't bet)
Seat 6: KOCTEHbKA193 folded before Flop (didn't bet)



PokerStars Zoom Hand #172105152912:  Hold'em No Limit ($0.01/$0.02) - 2017/06/22 18:27:46 UTC [2017/06/22 14:27:46 ET]
Table 'Halley' 6-max Seat #1 is the button
Seat 1: yakka34 ($2.47 in chips) 
Seat 2: AlphaBlitz ($6.47 in chips) 
Seat 3: AlexSun63 ($2 in chips) 
Seat 4: mich125 ($5.01 in chips) 
Seat 5: $amyrai ($2.46 in chips) 
Seat 6: Diane0818 ($4.83 in chips) 
AlphaBlitz: posts small blind $0.01
AlexSun63: posts big blind $0.02
*** HOLE CARDS ***
Dealt to yakka34 [3h Jh]
mich125: folds 
$amyrai: folds 
Diane0818: folds 
yakka34: raises $0.04 to $0.06
AlphaBlitz: folds 
AlexSun63: folds 
Uncalled bet ($0.04) returned to yakka34
yakka34 collected $0.05 from pot
yakka34: doesn't show hand 
*** SUMMARY ***
Total pot $0.05 | Rake $0 
Seat 1: yakka34 (button) collected ($0.05)
Seat 2: AlphaBlitz (small blind) folded before Flop
Seat 3: AlexSun63 (big blind) folded before Flop
Seat 4: mich125 folded before Flop (didn't bet)
Seat 5: $amyrai folded before Flop (didn't bet)
Seat 6: Diane0818 folded before Flop (didn't bet)



PokerStars Zoom Hand #172105144921:  Hold'em No Limit ($0.01/$0.02) - 2017/06/22 18:27:35 UTC [2017/06/22 14:27:35 ET]
Table 'Halley' 6-max Seat #1 is the button
Seat 1: CleberMS10 ($4.05 in chips) 
Seat 2: GabrielTho1 ($2.86 in chips) 
Seat 3: streynger ($2 in chips) 
Seat 4: buffoo1 ($1.50 in chips) 
Seat 5: yakka34 ($2.48 in chips) 
Seat 6: Dinarbank ($0.97 in chips) 
GabrielTho1: posts small blind $0.01
streynger: posts big blind $0.02
*** HOLE CARDS ***
Dealt to yakka34 [4d Th]
buffoo1: folds 
yakka34: folds 
Dinarbank: folds 
CleberMS10: raises $0.02 to $0.04
GabrielTho1: folds 
streynger: raises $0.14 to $0.18
CleberMS10: raises $0.28 to $0.46
streynger: calls $0.28
*** FLOP *** [Ad 6s Ts]
streynger: checks 
CleberMS10: bets $3.59 and is all-in
streynger: calls $1.54 and is all-in
Uncalled bet ($2.05) returned to CleberMS10
*** TURN *** [Ad 6s Ts] [Kc]
*** RIVER *** [Ad 6s Ts Kc] [2d]
*** SHOW DOWN ***
streynger: shows [Ah Qd] (a pair of Aces)
CleberMS10: shows [As 3s] (a pair of Aces - lower kicker)
streynger collected $3.87 from pot
*** SUMMARY ***
Total pot $4.01 | Rake $0.14 
Board [Ad 6s Ts Kc 2d]
Seat 1: CleberMS10 (button) showed [As 3s] and lost with a pair of Aces
Seat 2: GabrielTho1 (small blind) folded before Flop
Seat 3: streynger (big blind) showed [Ah Qd] and won ($3.87) with a pair of Aces
Seat 4: buffoo1 folded before Flop (didn't bet)
Seat 5: yakka34 folded before Flop (didn't bet)
Seat 6: Dinarbank folded before Flop (didn't bet)



PokerStars Zoom Hand #172105163672:  Hold'em No Limit ($0.01/$0.02) - 2017/06/22 18:28:01 UTC [2017/06/22 14:28:01 ET]
Table 'Halley' 6-max Seat #1 is the button
Seat 1: virus359 ($3.71 in chips) 
Seat 2: evgenij717 ($1.01 in chips) 
Seat 3: yakka34 ($2.50 in chips) 
Seat 4: BoomBats87 ($2 in chips) 
Seat 5: Ede1wei$$ ($2.08 in chips) 
Seat 6: 2232012 ($3.13 in chips) 
evgenij717: posts small blind $0.01
yakka34: posts big blind $0.02
*** HOLE CARDS ***
Dealt to yakka34 [Ad Qs]
BoomBats87: folds 
Ede1wei$$: folds 
2232012: folds 
virus359: raises $0.04 to $0.06
evgenij717: folds 
yakka34: raises $0.06 to $0.12
virus359: calls $0.06
*** FLOP *** [Js Ac 7d]
yakka34: bets $0.12
virus359: folds 
Uncalled bet ($0.12) returned to yakka34
yakka34 collected $0.24 from pot
yakka34: doesn't show hand 
*** SUMMARY ***
Total pot $0.25 | Rake $0.01 
Board [Js Ac 7d]
Seat 1: virus359 (button) folded on the Flop
Seat 2: evgenij717 (small blind) folded before Flop
Seat 3: yakka34 (big blind) collected ($0.24)
Seat 4: BoomBats87 folded before Flop (didn't bet)
Seat 5: Ede1wei$$ folded before Flop (didn't bet)
Seat 6: 2232012 folded before Flop (didn't bet)



PokerStars Zoom Hand #172105181363:  Hold'em No Limit ($0.01/$0.02) - 2017/06/22 18:28:26 UTC [2017/06/22 14:28:26 ET]
Table 'Halley' 6-max Seat #1 is the button
Seat 1: answis ($0.97 in chips) 
Seat 2: n3wb1ee ($1.13 in chips) 
Seat 3: mairia1986 ($2 in chips) 
Seat 4: 7rocket ($2.33 in chips) 
Seat 5: Cenzuura13 ($1.90 in chips) 
Seat 6: yakka34 ($2.62 in chips) 
n3wb1ee: posts small blind $0.01
mairia1986: posts big blind $0.02
*** HOLE CARDS ***
Dealt to yakka34 [As Jd]
7rocket: raises $0.04 to $0.06
Cenzuura13: folds 
yakka34: calls $0.06
answis: folds 
n3wb1ee: calls $0.05
mairia1986: folds 
*** FLOP *** [9h Ah Js]
n3wb1ee: checks 
7rocket: bets $0.10
yakka34: raises $0.10 to $0.20
n3wb1ee: calls $0.20
7rocket: folds 
*** TURN *** [9h Ah Js] [8d]
n3wb1ee: checks 
yakka34: bets $0.68
n3wb1ee: folds 
Uncalled bet ($0.68) returned to yakka34
yakka34 collected $0.68 from pot
yakka34: doesn't show hand 
*** SUMMARY ***
Total pot $0.70 | Rake $0.02 
Board [9h Ah Js 8d]
Seat 1: answis (button) folded before Flop (didn't bet)
Seat 2: n3wb1ee (small blind) folded on the Turn
Seat 3: mairia1986 (big blind) folded before Flop
Seat 4: 7rocket folded on the Flop
Seat 5: Cenzuura13 folded before Flop (didn't bet)
Seat 6: yakka34 collected ($0.68)



PokerStars Zoom Hand #172105217030:  Hold'em No Limit ($0.01/$0.02) - 2017/06/22 18:29:16 UTC [2017/06/22 14:29:16 ET]
Table 'Halley' 6-max Seat #1 is the button
Seat 1: Navking9 ($4.77 in chips) 
Seat 2: vasilich488 ($1.62 in chips) 
Seat 3: Dorogoi57 ($3.53 in chips) 
Seat 4: nkfustgp6bp6 ($2.03 in chips) 
Seat 5: yakka34 ($3.04 in chips) 
Seat 6: Mizowa ($2.06 in chips) 
vasilich488: posts small blind $0.01
Dorogoi57: posts big blind $0.02
*** HOLE CARDS ***
Dealt to yakka34 [Ks 9s]
nkfustgp6bp6: raises $0.04 to $0.06
yakka34: folds 
Mizowa: folds 
Navking9: folds 
vasilich488: folds 
Dorogoi57: folds 
Uncalled bet ($0.04) returned to nkfustgp6bp6
nkfustgp6bp6 collected $0.05 from pot
nkfustgp6bp6: doesn't show hand 
*** SUMMARY ***
Total pot $0.05 | Rake $0 
Seat 1: Navking9 (button) folded before Flop (didn't bet)
Seat 2: vasilich488 (small blind) folded before Flop
Seat 3: Dorogoi57 (big blind) folded before Flop
Seat 4: nkfustgp6bp6 collected ($0.05)
Seat 5: yakka34 folded before Flop (didn't bet)
Seat 6: Mizowa folded before Flop (didn't bet)



PokerStars Zoom Hand #172105223565:  Hold'em No Limit ($0.01/$0.02) - 2017/06/22 18:29:25 UTC [2017/06/22 14:29:25 ET]
Table 'Halley' 6-max Seat #1 is the button
Seat 1: mikrid ($2.13 in chips) 
Seat 2: yakka34 ($3.04 in chips) 
Seat 3: BakytTheWolf ($2.60 in chips) 
Seat 4: onlyfoolsguy ($2.75 in chips) 
Seat 5: Palmeiras671 ($1.96 in chips) 
Seat 6: Crowned SULA ($2.14 in chips) 
yakka34: posts small blind $0.01
BakytTheWolf: posts big blind $0.02
*** HOLE CARDS ***
Dealt to yakka34 [Ac 7s]
onlyfoolsguy: folds 
Palmeiras671: raises $0.04 to $0.06
Crowned SULA: folds 
mikrid: folds 
yakka34: folds 
BakytTheWolf: folds 
Uncalled bet ($0.04) returned to Palmeiras671
Palmeiras671 collected $0.05 from pot
Palmeiras671: doesn't show hand 
*** SUMMARY ***
Total pot $0.05 | Rake $0 
Seat 1: mikrid (button) folded before Flop (didn't bet)
Seat 2: yakka34 (small blind) folded before Flop
Seat 3: BakytTheWolf (big blind) folded before Flop
Seat 4: onlyfoolsguy folded before Flop (didn't bet)
Seat 5: Palmeiras671 collected ($0.05)
Seat 6: Crowned SULA folded before Flop (didn't bet)



PokerStars Zoom Hand #172105236456:  Hold'em No Limit ($0.01/$0.02) - 2017/06/22 18:29:43 UTC [2017/06/22 14:29:43 ET]
Table 'Halley' 6-max Seat #1 is the button
Seat 1: SirRoseDuFoy ($5.11 in chips) 
Seat 2: sooted777s ($2.41 in chips) 
Seat 3: WhatYourHand ($3.53 in chips) 
Seat 4: Sehmet7878 ($6.90 in chips) 
Seat 5: Zeleo82 ($2.41 in chips) 
Seat 6: yakka34 ($3.03 in chips) 
sooted777s: posts small blind $0.01
WhatYourHand: posts big blind $0.02
*** HOLE CARDS ***
Dealt to yakka34 [5c 4c]
Sehmet7878: raises $0.04 to $0.06
Zeleo82: folds 
yakka34: folds 
SirRoseDuFoy: folds 
sooted777s: folds 
WhatYourHand: folds 
Uncalled bet ($0.04) returned to Sehmet7878
Sehmet7878 collected $0.05 from pot
Sehmet7878: doesn't show hand 
*** SUMMARY ***
Total pot $0.05 | Rake $0 
Seat 1: SirRoseDuFoy (button) folded before Flop (didn't bet)
Seat 2: sooted777s (small blind) folded before Flop
Seat 3: WhatYourHand (big blind) folded before Flop
Seat 4: Sehmet7878 collected ($0.05)
Seat 5: Zeleo82 folded before Flop (didn't bet)
Seat 6: yakka34 folded before Flop (didn't bet)



PokerStars Zoom Hand #172105242862:  Hold'em No Limit ($0.01/$0.02) - 2017/06/22 18:29:52 UTC [2017/06/22 14:29:52 ET]
Table 'Halley' 6-max Seat #1 is the button
Seat 1: GuinhoAK ($2 in chips) 
Seat 2: skortep ($1.06 in chips) 
Seat 3: skokmen87 ($3.39 in chips) 
Seat 4: Cäse27 ($8.81 in chips) 
Seat 5: yakka34 ($3.03 in chips) 
Seat 6: lucagigi ($3.07 in chips) 
skortep: posts small blind $0.01
skokmen87: posts big blind $0.02
*** HOLE CARDS ***
Dealt to yakka34 [4d Ah]
Cäse27: folds 
yakka34: folds 
lucagigi: folds 
GuinhoAK: raises $0.05 to $0.07
skortep: folds 
skokmen87: folds 
Uncalled bet ($0.05) returned to GuinhoAK
GuinhoAK collected $0.05 from pot
GuinhoAK: doesn't show hand 
*** SUMMARY ***
Total pot $0.05 | Rake $0 
Seat 1: GuinhoAK (button) collected ($0.05)
Seat 2: skortep (small blind) folded before Flop
Seat 3: skokmen87 (big blind) folded before Flop
Seat 4: Cäse27 folded before Flop (didn't bet)
Seat 5: yakka34 folded before Flop (didn't bet)
Seat 6: lucagigi folded before Flop (didn't bet)



PokerStars Zoom Hand #172105240020:  Hold'em No Limit ($0.01/$0.02) - 2017/06/22 18:29:48 UTC [2017/06/22 14:29:48 ET]
Table 'Halley' 6-max Seat #1 is the button
Seat 1: yakka34 ($3.03 in chips) 
Seat 2: TristanWPA ($2.50 in chips) 
Seat 3: hanom_ss ($1.95 in chips) 
Seat 4: phriza1503 ($2.30 in chips) 
Seat 5: MIHA37641 ($1.34 in chips) 
Seat 6: TaTyCb ($2 in chips) 
TristanWPA: posts small blind $0.01
hanom_ss: posts big blind $0.02
*** HOLE CARDS ***
Dealt to yakka34 [5s 2s]
phriza1503: folds 
MIHA37641: calls $0.02
TaTyCb: folds 
yakka34: folds 
TristanWPA: folds 
hanom_ss: checks 
*** FLOP *** [Ac 6s 6h]
hanom_ss: checks 
MIHA37641: checks 
*** TURN *** [Ac 6s 6h] [3d]
hanom_ss: checks 
MIHA37641: checks 
*** RIVER *** [Ac 6s 6h 3d] [5h]
hanom_ss: checks 
MIHA37641: bets $0.02
hanom_ss: folds 
Uncalled bet ($0.02) returned to MIHA37641
MIHA37641 collected $0.05 from pot
MIHA37641: doesn't show hand 
*** SUMMARY ***
Total pot $0.05 | Rake $0 
Board [Ac 6s 6h 3d 5h]
Seat 1: yakka34 (button) folded before Flop (didn't bet)
Seat 2: TristanWPA (small blind) folded before Flop
Seat 3: hanom_ss (big blind) folded on the River
Seat 4: phriza1503 folded before Flop (didn't bet)
Seat 5: MIHA37641 collected ($0.05)
Seat 6: TaTyCb folded before Flop (didn't bet)



PokerStars Zoom Hand #172105214178:  Hold'em No Limit ($0.01/$0.02) - 2017/06/22 18:29:12 UTC [2017/06/22 14:29:12 ET]
Table 'Halley' 6-max Seat #1 is the button
Seat 1: phriza1503 ($2.31 in chips) 
Seat 2: cantor1987 ($2.01 in chips) 
Seat 3: Kolpinets ($1.85 in chips) 
Seat 4: yakka34 ($3.04 in chips) 
Seat 5: Schumaak ($2.37 in chips) 
Seat 6: DonRazVan18 ($1.86 in chips) 
cantor1987: posts small blind $0.01
Kolpinets: posts big blind $0.02
*** HOLE CARDS ***
Dealt to yakka34 [9c Ts]
yakka34: folds 
Schumaak: raises $0.04 to $0.06
DonRazVan18: raises $0.12 to $0.18
phriza1503 has timed out
phriza1503: folds 
cantor1987: folds 
Kolpinets: calls $0.16
Schumaak: calls $0.12
*** FLOP *** [5c Js 6d]
Kolpinets: checks 
Schumaak: checks 
DonRazVan18: bets $0.26
Kolpinets: calls $0.26
Schumaak: folds 
*** TURN *** [5c Js 6d] [Kc]
Kolpinets: checks 
DonRazVan18: checks 
*** RIVER *** [5c Js 6d Kc] [Jh]
Kolpinets: bets $1.28
DonRazVan18: calls $1.28
*** SHOW DOWN ***
Kolpinets: shows [5h 5d] (a full house, Fives full of Jacks)
DonRazVan18: mucks hand 
Kolpinets collected $3.50 from pot
*** SUMMARY ***
Total pot $3.63 | Rake $0.13 
Board [5c Js 6d Kc Jh]
Seat 1: phriza1503 (button) folded before Flop (didn't bet)
Seat 2: cantor1987 (small blind) folded before Flop
Seat 3: Kolpinets (big blind) showed [5h 5d] and won ($3.50) with a full house, Fives full of Jacks
Seat 4: yakka34 folded before Flop (didn't bet)
Seat 5: Schumaak folded on the Flop
Seat 6: DonRazVan18 mucked [Jd Ad]



PokerStars Zoom Hand #172105246573:  Hold'em No Limit ($0.01/$0.02) - 2017/06/22 18:29:57 UTC [2017/06/22 14:29:57 ET]
Table 'Halley' 6-max Seat #1 is the button
Seat 1: umchel ($1.88 in chips) 
Seat 2: idrun1260 ($2.64 in chips) 
Seat 3: yakka34 ($3.03 in chips) 
Seat 4: KajsarOFF ($2.17 in chips) 
Seat 5: Mastermuzzz ($2.15 in chips) 
Seat 6: gadraul ($3.92 in chips) 
idrun1260: posts small blind $0.01
yakka34: posts big blind $0.02
*** HOLE CARDS ***
Dealt to yakka34 [Th Td]
KajsarOFF: folds 
Mastermuzzz: folds 
gadraul: raises $0.03 to $0.05
umchel: folds 
idrun1260: calls $0.04
yakka34: raises $0.03 to $0.08
gadraul: folds 
idrun1260: calls $0.03
*** FLOP *** [3h Js 3c]
idrun1260: checks 
yakka34: bets $0.10
idrun1260: calls $0.10
*** TURN *** [3h Js 3c] [9d]
idrun1260: checks 
yakka34: bets $0.20
idrun1260: folds 
Uncalled bet ($0.20) returned to yakka34
yakka34 collected $0.40 from pot
yakka34: doesn't show hand 
*** SUMMARY ***
Total pot $0.41 | Rake $0.01 
Board [3h Js 3c 9d]
Seat 1: umchel (button) folded before Flop (didn't bet)
Seat 2: idrun1260 (small blind) folded on the Turn
Seat 3: yakka34 (big blind) collected ($0.40)
Seat 4: KajsarOFF folded before Flop (didn't bet)
Seat 5: Mastermuzzz folded before Flop (didn't bet)
Seat 6: gadraul folded before Flop



PokerStars Zoom Hand #172105286198:  Hold'em No Limit ($0.01/$0.02) - 2017/06/22 18:30:52 UTC [2017/06/22 14:30:52 ET]
Table 'Halley' 6-max Seat #1 is the button
Seat 1: BRAIÑ ($2.17 in chips) 
Seat 2: Shogasin ($2.63 in chips) 
Seat 3: AAAAAAAGI ($3.01 in chips) 
Seat 4: MULGESEAL ($2.42 in chips) 
Seat 5: yakka34 ($3.25 in chips) 
Seat 6: AlphaBlitz ($4.88 in chips) 
Shogasin: posts small blind $0.01
AAAAAAAGI: posts big blind $0.02
*** HOLE CARDS ***
Dealt to yakka34 [3s 7c]
MULGESEAL: raises $0.03 to $0.05
yakka34: folds 
AlphaBlitz: folds 
BRAIÑ: folds 
Shogasin: folds 
AAAAAAAGI: calls $0.03
*** FLOP *** [6h 2c Qs]
AAAAAAAGI: bets $0.06
MULGESEAL: raises $0.10 to $0.16
AAAAAAAGI: folds 
Uncalled bet ($0.10) returned to MULGESEAL
MULGESEAL collected $0.22 from pot
MULGESEAL: doesn't show hand 
*** SUMMARY ***
Total pot $0.23 | Rake $0.01 
Board [6h 2c Qs]
Seat 1: BRAIÑ (button) folded before Flop (didn't bet)
Seat 2: Shogasin (small blind) folded before Flop
Seat 3: AAAAAAAGI (big blind) folded on the Flop
Seat 4: MULGESEAL collected ($0.22)
Seat 5: yakka34 folded before Flop (didn't bet)
Seat 6: AlphaBlitz folded before Flop (didn't bet)



PokerStars Zoom Hand #172105289720:  Hold'em No Limit ($0.01/$0.02) - 2017/06/22 18:30:57 UTC [2017/06/22 14:30:57 ET]
Table 'Halley' 6-max Seat #1 is the button
Seat 1: korda17 ($3.19 in chips) 
Seat 2: yakka34 ($3.25 in chips) 
Seat 3: swwedv05 ($1.69 in chips) 
Seat 4: ffev78 ($1.99 in chips) 
Seat 5: Tanarri134 ($3.29 in chips) 
Seat 6: Mastermuzzz ($3.55 in chips) 
yakka34: posts small blind $0.01
swwedv05: posts big blind $0.02
*** HOLE CARDS ***
Dealt to yakka34 [9d Ac]
ffev78: folds 
Tanarri134: folds 
Mastermuzzz: folds 
korda17: folds 
yakka34: calls $0.01
swwedv05: checks 
*** FLOP *** [6c Qh As]
yakka34: bets $0.02
swwedv05: folds 
Uncalled bet ($0.02) returned to yakka34
yakka34 collected $0.04 from pot
yakka34: doesn't show hand 
*** SUMMARY ***
Total pot $0.04 | Rake $0 
Board [6c Qh As]
Seat 1: korda17 (button) folded before Flop (didn't bet)
Seat 2: yakka34 (small blind) collected ($0.04)
Seat 3: swwedv05 (big blind) folded on the Flop
Seat 4: ffev78 folded before Flop (didn't bet)
Seat 5: Tanarri134 folded before Flop (didn't bet)
Seat 6: Mastermuzzz folded before Flop (didn't bet)



PokerStars Zoom Hand #172105305522:  Hold'em No Limit ($0.01/$0.02) - 2017/06/22 18:31:19 UTC [2017/06/22 14:31:19 ET]
Table 'Halley' 6-max Seat #1 is the button
Seat 1: TellsSohn ($3.54 in chips) 
Seat 2: shwnmnstr ($2.09 in chips) 
Seat 3: Il moustruo ($2.39 in chips) 
Seat 4: yakka34 ($3.27 in chips) 
Seat 5: cantor1987 ($2.17 in chips) 
Seat 6: GyNy1976 ($2.06 in chips) 
shwnmnstr: posts small blind $0.01
Il moustruo: posts big blind $0.02
*** HOLE CARDS ***
Dealt to yakka34 [2h 7c]
yakka34: folds 
cantor1987: folds 
GyNy1976: folds 
TellsSohn: folds 
shwnmnstr: raises $0.04 to $0.06
Il moustruo: folds 
Uncalled bet ($0.04) returned to shwnmnstr
shwnmnstr collected $0.04 from pot
shwnmnstr: doesn't show hand 
*** SUMMARY ***
Total pot $0.04 | Rake $0 
Seat 1: TellsSohn (button) folded before Flop (didn't bet)
Seat 2: shwnmnstr (small blind) collected ($0.04)
Seat 3: Il moustruo (big blind) folded before Flop
Seat 4: yakka34 folded before Flop (didn't bet)
Seat 5: cantor1987 folded before Flop (didn't bet)
Seat 6: GyNy1976 folded before Flop (didn't bet)



PokerStars Zoom Hand #172105301937:  Hold'em No Limit ($0.01/$0.02) - 2017/06/22 18:31:14 UTC [2017/06/22 14:31:14 ET]
Table 'Halley' 6-max Seat #1 is the button
Seat 1: yakka34 ($3.27 in chips) 
Seat 2: tymbood ($2 in chips) 
Seat 3: MadMaxBG1 ($2.08 in chips) 
Seat 4: dragos1357 ($1 in chips) 
Seat 5: Arrie813 ($1.10 in chips) 
Seat 6: Tanarri134 ($2.54 in chips) 
tymbood: posts small blind $0.01
MadMaxBG1: posts big blind $0.02
*** HOLE CARDS ***
Dealt to yakka34 [5s 3d]
dragos1357: raises $0.04 to $0.06
Arrie813: folds 
Tanarri134: folds 
yakka34: folds 
tymbood: folds 
MadMaxBG1: calls $0.04
*** FLOP *** [4d Th 2d]
MadMaxBG1: bets $0.07
dragos1357: calls $0.07
*** TURN *** [4d Th 2d] [6h]
MadMaxBG1: bets $0.26
dragos1357: raises $0.61 to $0.87 and is all-in
MadMaxBG1: calls $0.61
*** RIVER *** [4d Th 2d 6h] [Qc]
*** SHOW DOWN ***
MadMaxBG1: shows [4c 4s] (three of a kind, Fours)
dragos1357: shows [6c 6s] (three of a kind, Sixes)
dragos1357 collected $1.94 from pot
*** SUMMARY ***
Total pot $2.01 | Rake $0.07 
Board [4d Th 2d 6h Qc]
Seat 1: yakka34 (button) folded before Flop (didn't bet)
Seat 2: tymbood (small blind) folded before Flop
Seat 3: MadMaxBG1 (big blind) showed [4c 4s] and lost with three of a kind, Fours
Seat 4: dragos1357 showed [6c 6s] and won ($1.94) with three of a kind, Sixes
Seat 5: Arrie813 folded before Flop (didn't bet)
Seat 6: Tanarri134 folded before Flop (didn't bet)



PokerStars Zoom Hand #172105307580:  Hold'em No Limit ($0.01/$0.02) - 2017/06/22 18:31:22 UTC [2017/06/22 14:31:22 ET]
Table 'Halley' 6-max Seat #1 is the button
Seat 1: AlfredUST19 ($5.24 in chips) 
Seat 2: BRAIÑ ($2.03 in chips) 
Seat 3: taypan101 ($2.34 in chips) 
Seat 4: tymbood ($2.35 in chips) 
Seat 5: Gri6Nik ($7.19 in chips) 
Seat 6: yakka34 ($3.27 in chips) 
BRAIÑ: posts small blind $0.01
taypan101: posts big blind $0.02
*** HOLE CARDS ***
Dealt to yakka34 [Kc Ks]
tymbood: folds 
Gri6Nik: folds 
yakka34: raises $0.04 to $0.06
AlfredUST19: calls $0.06
BRAIÑ: folds 
taypan101: folds 
*** FLOP *** [Tc Jc Kd]
yakka34: bets $0.07
AlfredUST19: calls $0.07
*** TURN *** [Tc Jc Kd] [5d]
yakka34: checks 
AlfredUST19: bets $0.28
yakka34: calls $0.28
*** RIVER *** [Tc Jc Kd 5d] [4d]
yakka34: checks 
AlfredUST19: checks 
*** SHOW DOWN ***
yakka34: shows [Kc Ks] (three of a kind, Kings)
AlfredUST19: mucks hand 
yakka34 collected $0.82 from pot
*** SUMMARY ***
Total pot $0.85 | Rake $0.03 
Board [Tc Jc Kd 5d 4d]
Seat 1: AlfredUST19 (button) mucked [9c 8s]
Seat 2: BRAIÑ (small blind) folded before Flop
Seat 3: taypan101 (big blind) folded before Flop
Seat 4: tymbood folded before Flop (didn't bet)
Seat 5: Gri6Nik folded before Flop (didn't bet)
Seat 6: yakka34 showed [Kc Ks] and won ($0.82) with three of a kind, Kings



PokerStars Zoom Hand #172105341516:  Hold'em No Limit ($0.01/$0.02) - 2017/06/22 18:32:09 UTC [2017/06/22 14:32:09 ET]
Table 'Halley' 6-max Seat #1 is the button
Seat 1: begginner666 ($1.94 in chips) 
Seat 2: 2232012 ($2.09 in chips) 
Seat 3: yakka34 ($3.68 in chips) 
Seat 4: yurka778 ($2.42 in chips) 
Seat 5: sgriglae ($2.12 in chips) 
Seat 6: Eduard.MEG ($0.91 in chips) 
2232012: posts small blind $0.01
yakka34: posts big blind $0.02
*** HOLE CARDS ***
Dealt to yakka34 [3d Qc]
yurka778: raises $0.04 to $0.06
sgriglae: folds 
Eduard.MEG: folds 
begginner666: folds 
2232012: folds 
yakka34: folds 
Uncalled bet ($0.04) returned to yurka778
yurka778 collected $0.05 from pot
yurka778: doesn't show hand 
*** SUMMARY ***
Total pot $0.05 | Rake $0 
Seat 1: begginner666 (button) folded before Flop (didn't bet)
Seat 2: 2232012 (small blind) folded before Flop
Seat 3: yakka34 (big blind) folded before Flop
Seat 4: yurka778 collected ($0.05)
Seat 5: sgriglae folded before Flop (didn't bet)
Seat 6: Eduard.MEG folded before Flop (didn't bet)



PokerStars Zoom Hand #172105352675:  Hold'em No Limit ($0.01/$0.02) - 2017/06/22 18:32:25 UTC [2017/06/22 14:32:25 ET]
Table 'Halley' 6-max Seat #1 is the button
Seat 1: Zaub9rfuchs ($2.22 in chips) 
Seat 2: lekser4 ($2.63 in chips) 
Seat 3: mannequino ($2 in chips) 
Seat 4: yakka34 ($3.66 in chips) 
Seat 5: koksEX ($4.26 in chips) 
Seat 6: dodorino ($0.88 in chips) 
lekser4: posts small blind $0.01
mannequino: posts big blind $0.02
*** HOLE CARDS ***
Dealt to yakka34 [Th 7h]
yakka34: folds 
koksEX: folds 
dodorino: folds 
Zaub9rfuchs: folds 
lekser4: raises $0.04 to $0.06
mannequino: folds 
Uncalled bet ($0.04) returned to lekser4
lekser4 collected $0.04 from pot
lekser4: doesn't show hand 
*** SUMMARY ***
Total pot $0.04 | Rake $0 
Seat 1: Zaub9rfuchs (button) folded before Flop (didn't bet)
Seat 2: lekser4 (small blind) collected ($0.04)
Seat 3: mannequino (big blind) folded before Flop
Seat 4: yakka34 folded before Flop (didn't bet)
Seat 5: koksEX folded before Flop (didn't bet)
Seat 6: dodorino folded before Flop (didn't bet)



PokerStars Zoom Hand #172105348415:  Hold'em No Limit ($0.01/$0.02) - 2017/06/22 18:32:19 UTC [2017/06/22 14:32:19 ET]
Table 'Halley' 6-max Seat #1 is the button
Seat 1: RUZKA663 ($0.64 in chips) 
Seat 2: n3wb1ee ($1.04 in chips) 
Seat 3: marik1001 ($7.82 in chips) 
Seat 4: sukromni ($2.70 in chips) 
Seat 5: yakka34 ($3.66 in chips) 
Seat 6: 77BREAKER77 ($2 in chips) 
n3wb1ee: posts small blind $0.01
marik1001: posts big blind $0.02
*** HOLE CARDS ***
Dealt to yakka34 [5h Tc]
sukromni: folds 
yakka34: folds 
77BREAKER77: folds 
RUZKA663: raises $0.08 to $0.10
n3wb1ee: folds 
marik1001: folds 
Uncalled bet ($0.08) returned to RUZKA663
RUZKA663 collected $0.05 from pot
RUZKA663: doesn't show hand 
*** SUMMARY ***
Total pot $0.05 | Rake $0 
Seat 1: RUZKA663 (button) collected ($0.05)
Seat 2: n3wb1ee (small blind) folded before Flop
Seat 3: marik1001 (big blind) folded before Flop
Seat 4: sukromni folded before Flop (didn't bet)
Seat 5: yakka34 folded before Flop (didn't bet)
Seat 6: 77BREAKER77 folded before Flop (didn't bet)



PokerStars Zoom Hand #172105356884:  Hold'em No Limit ($0.01/$0.02) - 2017/06/22 18:32:31 UTC [2017/06/22 14:32:31 ET]
Table 'Halley' 6-max Seat #1 is the button
Seat 1: tymbood ($2 in chips) 
Seat 2: yakka34 ($3.66 in chips) 
Seat 3: Squishee-Apu ($2.38 in chips) 
Seat 4: hapkin777 ($2.24 in chips) 
Seat 5: Il moustruo ($1.99 in chips) 
Seat 6: baters_rus ($3.49 in chips) 
yakka34: posts small blind $0.01
Squishee-Apu: posts big blind $0.02
*** HOLE CARDS ***
Dealt to yakka34 [Ac 3h]
hapkin777: folds 
Il moustruo: folds 
baters_rus: folds 
tymbood: raises $0.02 to $0.04
yakka34: calls $0.03
Squishee-Apu: folds 
*** FLOP *** [3d Ah 8c]
yakka34: checks 
tymbood: bets $0.07
yakka34: raises $0.07 to $0.14
tymbood: folds 
Uncalled bet ($0.07) returned to yakka34
yakka34 collected $0.23 from pot
yakka34: doesn't show hand 
*** SUMMARY ***
Total pot $0.24 | Rake $0.01 
Board [3d Ah 8c]
Seat 1: tymbood (button) folded on the Flop
Seat 2: yakka34 (small blind) collected ($0.23)
Seat 3: Squishee-Apu (big blind) folded before Flop
Seat 4: hapkin777 folded before Flop (didn't bet)
Seat 5: Il moustruo folded before Flop (didn't bet)
Seat 6: baters_rus folded before Flop (didn't bet)



PokerStars Zoom Hand #172105402869:  Hold'em No Limit ($0.01/$0.02) - 2017/06/22 18:33:35 UTC [2017/06/22 14:33:35 ET]
Table 'Halley' 6-max Seat #1 is the button
Seat 1: yakka34 ($3.78 in chips) 
Seat 2: KY Cygni 81 ($2.01 in chips) 
Seat 3: msu.fedos ($4.35 in chips) 
Seat 4: Luck-Roma64 ($2 in chips) 
Seat 5: LKPony ($2.11 in chips) 
Seat 6: chirva007 ($2.33 in chips) 
KY Cygni 81: posts small blind $0.01
msu.fedos: posts big blind $0.02
*** HOLE CARDS ***
Dealt to yakka34 [Ad Kh]
Luck-Roma64: folds 
LKPony: folds 
chirva007: raises $0.03 to $0.05
yakka34: raises $0.03 to $0.08
KY Cygni 81: folds 
msu.fedos: folds 
chirva007: calls $0.03
*** FLOP *** [4c 4d Td]
chirva007: bets $0.12
yakka34: raises $0.12 to $0.24
chirva007: calls $0.12
*** TURN *** [4c 4d Td] [Js]
chirva007: checks 
yakka34: checks 
*** RIVER *** [4c 4d Td Js] [2s]
chirva007: checks 
yakka34: checks 
*** SHOW DOWN ***
chirva007: shows [Th Jh] (two pair, Jacks and Tens)
yakka34: mucks hand 
chirva007 collected $0.65 from pot
*** SUMMARY ***
Total pot $0.67 | Rake $0.02 
Board [4c 4d Td Js 2s]
Seat 1: yakka34 (button) mucked [Ad Kh]
Seat 2: KY Cygni 81 (small blind) folded before Flop
Seat 3: msu.fedos (big blind) folded before Flop
Seat 4: Luck-Roma64 folded before Flop (didn't bet)
Seat 5: LKPony folded before Flop (didn't bet)
Seat 6: chirva007 showed [Th Jh] and won ($0.65) with two pair, Jacks and Tens



PokerStars Zoom Hand #172105427918:  Hold'em No Limit ($0.01/$0.02) - 2017/06/22 18:34:10 UTC [2017/06/22 14:34:10 ET]
Table 'Halley' 6-max Seat #1 is the button
Seat 1: AdamCrowe ($2.08 in chips) 
Seat 2: UNDACOVA86 ($0.92 in chips) 
Seat 3: yakka34 ($3.46 in chips) 
Seat 4: natali0109 ($1.46 in chips) 
Seat 5: Gri6Nik ($6.90 in chips) 
Seat 6: begginner666 ($4.45 in chips) 
UNDACOVA86: posts small blind $0.01
yakka34: posts big blind $0.02
*** HOLE CARDS ***
Dealt to yakka34 [9d 8s]
natali0109: raises $0.06 to $0.08
Gri6Nik: folds 
begginner666: folds 
AdamCrowe: folds 
UNDACOVA86: folds 
yakka34: folds 
Uncalled bet ($0.06) returned to natali0109
natali0109 collected $0.05 from pot
natali0109: doesn't show hand 
*** SUMMARY ***
Total pot $0.05 | Rake $0 
Seat 1: AdamCrowe (button) folded before Flop (didn't bet)
Seat 2: UNDACOVA86 (small blind) folded before Flop
Seat 3: yakka34 (big blind) folded before Flop
Seat 4: natali0109 collected ($0.05)
Seat 5: Gri6Nik folded before Flop (didn't bet)
Seat 6: begginner666 folded before Flop (didn't bet)



PokerStars Zoom Hand #172105439366:  Hold'em No Limit ($0.01/$0.02) - 2017/06/22 18:34:26 UTC [2017/06/22 14:34:26 ET]
Table 'Halley' 6-max Seat #1 is the button
Seat 1: Olejka2068 ($0.32 in chips) 
Seat 2: AlexSun63 ($1.89 in chips) 
Seat 3: nicopetta91 ($1.94 in chips) 
Seat 4: yakka34 ($3.44 in chips) 
Seat 5: andreig2012 ($2 in chips) 
Seat 6: Edson2rr ($2.49 in chips) 
AlexSun63: posts small blind $0.01
nicopetta91: posts big blind $0.02
*** HOLE CARDS ***
Dealt to yakka34 [9h 5s]
yakka34: folds 
andreig2012: folds 
Edson2rr: folds 
Olejka2068: folds 
AlexSun63: folds 
Uncalled bet ($0.01) returned to nicopetta91
nicopetta91 collected $0.02 from pot
nicopetta91: doesn't show hand 
*** SUMMARY ***
Total pot $0.02 | Rake $0 
Seat 1: Olejka2068 (button) folded before Flop (didn't bet)
Seat 2: AlexSun63 (small blind) folded before Flop
Seat 3: nicopetta91 (big blind) collected ($0.02)
Seat 4: yakka34 folded before Flop (didn't bet)
Seat 5: andreig2012 folded before Flop (didn't bet)
Seat 6: Edson2rr folded before Flop (didn't bet)



PokerStars Zoom Hand #172105442190:  Hold'em No Limit ($0.01/$0.02) - 2017/06/22 18:34:30 UTC [2017/06/22 14:34:30 ET]
Table 'Halley' 6-max Seat #1 is the button
Seat 1: nkfustgp6bp6 ($2.20 in chips) 
Seat 2: a7236 ($2 in chips) 
Seat 3: ffev78 ($2.20 in chips) 
Seat 4: RaiseF0rWin ($2.81 in chips) 
Seat 5: yakka34 ($3.44 in chips) 
Seat 6: znALEK$ANDzn ($1.25 in chips) 
a7236: posts small blind $0.01
ffev78: posts big blind $0.02
*** HOLE CARDS ***
Dealt to yakka34 [7c 9d]
RaiseF0rWin: raises $0.04 to $0.06
yakka34: folds 
znALEK$ANDzn: folds 
nkfustgp6bp6: folds 
a7236: folds 
ffev78: folds 
Uncalled bet ($0.04) returned to RaiseF0rWin
RaiseF0rWin collected $0.05 from pot
RaiseF0rWin: doesn't show hand 
*** SUMMARY ***
Total pot $0.05 | Rake $0 
Seat 1: nkfustgp6bp6 (button) folded before Flop (didn't bet)
Seat 2: a7236 (small blind) folded before Flop
Seat 3: ffev78 (big blind) folded before Flop
Seat 4: RaiseF0rWin collected ($0.05)
Seat 5: yakka34 folded before Flop (didn't bet)
Seat 6: znALEK$ANDzn folded before Flop (didn't bet)



PokerStars Zoom Hand #172105447212:  Hold'em No Limit ($0.01/$0.02) - 2017/06/22 18:34:37 UTC [2017/06/22 14:34:37 ET]
Table 'Halley' 6-max Seat #1 is the button
Seat 1: yakka34 ($3.44 in chips) 
Seat 2: Krugelson ($4.52 in chips) 
Seat 3: flaviozaca ($1.92 in chips) 
Seat 4: tony dolbeat ($2.05 in chips) 
Seat 5: JensVan31 ($2.87 in chips) 
Seat 6: alex13590 ($7.44 in chips) 
Krugelson: posts small blind $0.01
flaviozaca: posts big blind $0.02
*** HOLE CARDS ***
Dealt to yakka34 [2s Kh]
tony dolbeat: raises $0.04 to $0.06
JensVan31: folds 
alex13590: folds 
yakka34: folds 
Krugelson: folds 
flaviozaca: folds 
Uncalled bet ($0.04) returned to tony dolbeat
tony dolbeat collected $0.05 from pot
tony dolbeat: doesn't show hand 
*** SUMMARY ***
Total pot $0.05 | Rake $0 
Seat 1: yakka34 (button) folded before Flop (didn't bet)
Seat 2: Krugelson (small blind) folded before Flop
Seat 3: flaviozaca (big blind) folded before Flop
Seat 4: tony dolbeat collected ($0.05)
Seat 5: JensVan31 folded before Flop (didn't bet)
Seat 6: alex13590 folded before Flop (didn't bet)



PokerStars Zoom Hand #172105452169:  Hold'em No Limit ($0.01/$0.02) - 2017/06/22 18:34:44 UTC [2017/06/22 14:34:44 ET]
Table 'Halley' 6-max Seat #1 is the button
Seat 1: Mr.acrobat01 ($2.06 in chips) 
Seat 2: yakka34 ($3.44 in chips) 
Seat 3: themis_89@ho ($24.31 in chips) 
Seat 4: luxio giovan ($2.48 in chips) 
Seat 5: BurOdell ($3.43 in chips) 
Seat 6: dimuth ($4.31 in chips) 
yakka34: posts small blind $0.01
themis_89@ho: posts big blind $0.02
*** HOLE CARDS ***
Dealt to yakka34 [9c 8h]
luxio giovan: folds 
BurOdell: raises $0.05 to $0.07
dimuth: folds 
Mr.acrobat01: folds 
yakka34: folds 
themis_89@ho: folds 
Uncalled bet ($0.05) returned to BurOdell
BurOdell collected $0.05 from pot
BurOdell: doesn't show hand 
*** SUMMARY ***
Total pot $0.05 | Rake $0 
Seat 1: Mr.acrobat01 (button) folded before Flop (didn't bet)
Seat 2: yakka34 (small blind) folded before Flop
Seat 3: themis_89@ho (big blind) folded before Flop
Seat 4: luxio giovan folded before Flop (didn't bet)
Seat 5: BurOdell collected ($0.05)
Seat 6: dimuth folded before Flop (didn't bet)



PokerStars Zoom Hand #172105434275:  Hold'em No Limit ($0.01/$0.02) - 2017/06/22 18:34:19 UTC [2017/06/22 14:34:19 ET]
Table 'Halley' 6-max Seat #1 is the button
Seat 1: urrrrdddd ($2.09 in chips) 
Seat 2: Mustangdood ($2.19 in chips) 
Seat 3: tehpara ($2 in chips) 
Seat 4: demure2607 ($1.91 in chips) 
Seat 5: aleumi lu ($1.88 in chips) 
Seat 6: yakka34 ($3.44 in chips) 
Mustangdood: posts small blind $0.01
tehpara: posts big blind $0.02
*** HOLE CARDS ***
Dealt to yakka34 [6s 5c]
demure2607: calls $0.02
aleumi lu: folds 
yakka34: folds 
urrrrdddd: folds 
Mustangdood: calls $0.01
tehpara: checks 
*** FLOP *** [6c Tc 8s]
Mustangdood: checks 
tehpara: checks 
demure2607: bets $0.04
Mustangdood: folds 
tehpara: folds 
Uncalled bet ($0.04) returned to demure2607
demure2607 collected $0.06 from pot
demure2607: doesn't show hand 
*** SUMMARY ***
Total pot $0.06 | Rake $0 
Board [6c Tc 8s]
Seat 1: urrrrdddd (button) folded before Flop (didn't bet)
Seat 2: Mustangdood (small blind) folded on the Flop
Seat 3: tehpara (big blind) folded on the Flop
Seat 4: demure2607 collected ($0.06)
Seat 5: aleumi lu folded before Flop (didn't bet)
Seat 6: yakka34 folded before Flop (didn't bet)



PokerStars Zoom Hand #172105463518:  Hold'em No Limit ($0.01/$0.02) - 2017/06/22 18:35:00 UTC [2017/06/22 14:35:00 ET]
Table 'Halley' 6-max Seat #1 is the button
Seat 1: Whatzaq ($2.13 in chips) 
Seat 2: Greg3184 ($2 in chips) 
Seat 3: AdamCrowe ($2 in chips) 
Seat 4: Troyan555 ($3.75 in chips) 
Seat 5: Goldjepwnt ($2 in chips) 
Seat 6: yakka34 ($3.41 in chips) 
Greg3184: posts small blind $0.01
AdamCrowe: posts big blind $0.02
*** HOLE CARDS ***
Dealt to yakka34 [6c 9s]
Troyan555: folds 
Goldjepwnt: folds 
yakka34: folds 
Whatzaq: raises $0.04 to $0.06
Greg3184: folds 
AdamCrowe: folds 
Uncalled bet ($0.04) returned to Whatzaq
Whatzaq collected $0.05 from pot
Whatzaq: doesn't show hand 
*** SUMMARY ***
Total pot $0.05 | Rake $0 
Seat 1: Whatzaq (button) collected ($0.05)
Seat 2: Greg3184 (small blind) folded before Flop
Seat 3: AdamCrowe (big blind) folded before Flop
Seat 4: Troyan555 folded before Flop (didn't bet)
Seat 5: Goldjepwnt folded before Flop (didn't bet)
Seat 6: yakka34 folded before Flop (didn't bet)



PokerStars Zoom Hand #172105470746:  Hold'em No Limit ($0.01/$0.02) - 2017/06/22 18:35:10 UTC [2017/06/22 14:35:10 ET]
Table 'Halley' 6-max Seat #1 is the button
Seat 1: GuinhoAK ($2 in chips) 
Seat 2: yakka34 ($3.41 in chips) 
Seat 3: LoLLiPoPchen ($2.53 in chips) 
Seat 4: MaksDV ($2.17 in chips) 
Seat 5: Holgje ($4.48 in chips) 
Seat 6: gosha873 ($1.32 in chips) 
yakka34: posts small blind $0.01
LoLLiPoPchen: posts big blind $0.02
*** HOLE CARDS ***
Dealt to yakka34 [8s Qs]
MaksDV: raises $0.02 to $0.04
Holgje: raises $0.12 to $0.16
gosha873: folds 
GuinhoAK: folds 
yakka34: folds 
LoLLiPoPchen: folds 
MaksDV: folds 
Uncalled bet ($0.12) returned to Holgje
Holgje collected $0.11 from pot
Holgje: doesn't show hand 
*** SUMMARY ***
Total pot $0.11 | Rake $0 
Seat 1: GuinhoAK (button) folded before Flop (didn't bet)
Seat 2: yakka34 (small blind) folded before Flop
Seat 3: LoLLiPoPchen (big blind) folded before Flop
Seat 4: MaksDV folded before Flop
Seat 5: Holgje collected ($0.11)
Seat 6: gosha873 folded before Flop (didn't bet)



PokerStars Zoom Hand #172105455035:  Hold'em No Limit ($0.01/$0.02) - 2017/06/22 18:34:48 UTC [2017/06/22 14:34:48 ET]
Table 'Halley' 6-max Seat #1 is the button
Seat 1: shullergts ($1.02 in chips) 
Seat 2: usek-huysek ($2.91 in chips) 
Seat 3: yakka34 ($3.43 in chips) 
Seat 4: MULGESEAL ($6.06 in chips) 
Seat 5: Piwos ($2.85 in chips) 
Seat 6: VotrokHK ($2 in chips) 
usek-huysek: posts small blind $0.01
yakka34: posts big blind $0.02
*** HOLE CARDS ***
Dealt to yakka34 [3d Kc]
MULGESEAL: folds 
Piwos: raises $0.04 to $0.06
VotrokHK: calls $0.06
shullergts: folds 
usek-huysek: raises $0.20 to $0.26
yakka34: folds 
Piwos: folds 
VotrokHK: folds 
Uncalled bet ($0.20) returned to usek-huysek
usek-huysek collected $0.20 from pot
usek-huysek: doesn't show hand 
*** SUMMARY ***
Total pot $0.20 | Rake $0 
Seat 1: shullergts (button) folded before Flop (didn't bet)
Seat 2: usek-huysek (small blind) collected ($0.20)
Seat 3: yakka34 (big blind) folded before Flop
Seat 4: MULGESEAL folded before Flop (didn't bet)
Seat 5: Piwos folded before Flop
Seat 6: VotrokHK folded before Flop



PokerStars Zoom Hand #172105477054:  Hold'em No Limit ($0.01/$0.02) - 2017/06/22 18:35:19 UTC [2017/06/22 14:35:19 ET]
Table 'Halley' 6-max Seat #1 is the button
Seat 1: m_dionel ($2.07 in chips) 
Seat 2: polunohnik ($0.69 in chips) 
Seat 3: demonuka ($2.03 in chips) 
Seat 4: MaksDV ($1.65 in chips) 
Seat 5: yakka34 ($3.40 in chips) 
Seat 6: easylavandos ($2.07 in chips) 
polunohnik: posts small blind $0.01
demonuka: posts big blind $0.02
*** HOLE CARDS ***
Dealt to yakka34 [Qd Js]
MaksDV: folds 
yakka34: raises $0.04 to $0.06
easylavandos: folds 
m_dionel: folds 
polunohnik: folds 
demonuka: calls $0.04
*** FLOP *** [Kh Tc 6d]
demonuka: checks 
yakka34: bets $0.07
demonuka: folds 
Uncalled bet ($0.07) returned to yakka34
yakka34 collected $0.13 from pot
yakka34: doesn't show hand 
*** SUMMARY ***
Total pot $0.13 | Rake $0 
Board [Kh Tc 6d]
Seat 1: m_dionel (button) folded before Flop (didn't bet)
Seat 2: polunohnik (small blind) folded before Flop
Seat 3: demonuka (big blind) folded on the Flop
Seat 4: MaksDV folded before Flop (didn't bet)
Seat 5: yakka34 collected ($0.13)
Seat 6: easylavandos folded before Flop (didn't bet)



PokerStars Zoom Hand #172105466456:  Hold'em No Limit ($0.01/$0.02) - 2017/06/22 18:35:04 UTC [2017/06/22 14:35:04 ET]
Table 'Halley' 6-max Seat #1 is the button
Seat 1: X BOOVER X ($1.36 in chips) 
Seat 2: tenberken ($2.06 in chips) 
Seat 3: VEEPfake ($2.77 in chips) 
Seat 4: BooBaDEI ($2.09 in chips) 
Seat 5: otzkar ($1.46 in chips) 
Seat 6: yakka34 ($3.41 in chips) 
tenberken: posts small blind $0.01
VEEPfake: posts big blind $0.02
*** HOLE CARDS ***
Dealt to yakka34 [8c 7h]
BooBaDEI: folds 
otzkar: folds 
yakka34: folds 
X BOOVER X: folds 
tenberken: raises $0.04 to $0.06
VEEPfake: calls $0.04
*** FLOP *** [4c 3d 2d]
tenberken: bets $0.06
VEEPfake: folds 
Uncalled bet ($0.06) returned to tenberken
tenberken collected $0.12 from pot
tenberken: doesn't show hand 
*** SUMMARY ***
Total pot $0.12 | Rake $0 
Board [4c 3d 2d]
Seat 1: X BOOVER X (button) folded before Flop (didn't bet)
Seat 2: tenberken (small blind) collected ($0.12)
Seat 3: VEEPfake (big blind) folded on the Flop
Seat 4: BooBaDEI folded before Flop (didn't bet)
Seat 5: otzkar folded before Flop (didn't bet)
Seat 6: yakka34 folded before Flop (didn't bet)



PokerStars Zoom Hand #172105494076:  Hold'em No Limit ($0.01/$0.02) - 2017/06/22 18:35:43 UTC [2017/06/22 14:35:43 ET]
Table 'Halley' 6-max Seat #1 is the button
Seat 1: lucastav206 ($3.29 in chips) 
Seat 2: Pedrosophiaa ($2.13 in chips) 
Seat 3: AceJeffKing ($2 in chips) 
Seat 4: yakka34 ($3.47 in chips) 
Seat 5: cappocne ($3.17 in chips) 
Seat 6: PSzpak ($2.77 in chips) 
Pedrosophiaa: posts small blind $0.01
AceJeffKing: posts big blind $0.02
*** HOLE CARDS ***
Dealt to yakka34 [4d 5d]
yakka34: folds 
cappocne: raises $0.04 to $0.06
PSzpak: folds 
lucastav206: folds 
Pedrosophiaa: folds 
AceJeffKing: folds 
Uncalled bet ($0.04) returned to cappocne
cappocne collected $0.05 from pot
cappocne: doesn't show hand 
*** SUMMARY ***
Total pot $0.05 | Rake $0 
Seat 1: lucastav206 (button) folded before Flop (didn't bet)
Seat 2: Pedrosophiaa (small blind) folded before Flop
Seat 3: AceJeffKing (big blind) folded before Flop
Seat 4: yakka34 folded before Flop (didn't bet)
Seat 5: cappocne collected ($0.05)
Seat 6: PSzpak folded before Flop (didn't bet)



PokerStars Zoom Hand #172105504881:  Hold'em No Limit ($0.01/$0.02) - 2017/06/22 18:35:58 UTC [2017/06/22 14:35:58 ET]
Table 'Halley' 6-max Seat #1 is the button
Seat 1: ffev78 ($2.27 in chips) 
Seat 2: Olegik555 ($3.36 in chips) 
Seat 3: ivan78russ ($0.92 in chips) 
Seat 4: yakka34 ($3.45 in chips) 
Seat 5: nappinho ($2.86 in chips) 
Seat 6: axi05 ($6.02 in chips) 
Olegik555: posts small blind $0.01
ivan78russ: posts big blind $0.02
*** HOLE CARDS ***
Dealt to yakka34 [9d Qd]
yakka34: calls $0.02
nappinho: folds 
axi05: raises $0.07 to $0.09
ffev78: folds 
Olegik555: folds 
ivan78russ: folds 
yakka34: folds 
Uncalled bet ($0.07) returned to axi05
axi05 collected $0.07 from pot
axi05: doesn't show hand 
*** SUMMARY ***
Total pot $0.07 | Rake $0 
Seat 1: ffev78 (button) folded before Flop (didn't bet)
Seat 2: Olegik555 (small blind) folded before Flop
Seat 3: ivan78russ (big blind) folded before Flop
Seat 4: yakka34 folded before Flop
Seat 5: nappinho folded before Flop (didn't bet)
Seat 6: axi05 collected ($0.07)



PokerStars Zoom Hand #172105496948:  Hold'em No Limit ($0.01/$0.02) - 2017/06/22 18:35:47 UTC [2017/06/22 14:35:47 ET]
Table 'Halley' 6-max Seat #1 is the button
Seat 1: JuanLevano ($4.23 in chips) 
Seat 2: chessman1997 ($3.17 in chips) 
Seat 3: yakka34 ($3.47 in chips) 
Seat 4: CrackingA ($2.16 in chips) 
Seat 5: Sofitamin ($4.87 in chips) 
Seat 6: mrspud12 ($2.01 in chips) 
chessman1997: posts small blind $0.01
yakka34: posts big blind $0.02
*** HOLE CARDS ***
Dealt to yakka34 [2d 9d]
CrackingA: folds 
Sofitamin: raises $0.05 to $0.07
mrspud12: folds 
JuanLevano: folds 
chessman1997: calls $0.06
yakka34: folds 
*** FLOP *** [Jh 2s 4s]
chessman1997: checks 
Sofitamin: bets $0.08
chessman1997: folds 
Uncalled bet ($0.08) returned to Sofitamin
Sofitamin collected $0.15 from pot
Sofitamin: doesn't show hand 
*** SUMMARY ***
Total pot $0.16 | Rake $0.01 
Board [Jh 2s 4s]
Seat 1: JuanLevano (button) folded before Flop (didn't bet)
Seat 2: chessman1997 (small blind) folded on the Flop
Seat 3: yakka34 (big blind) folded before Flop
Seat 4: CrackingA folded before Flop (didn't bet)
Seat 5: Sofitamin collected ($0.15)
Seat 6: mrspud12 folded before Flop (didn't bet)



PokerStars Zoom Hand #172105501966:  Hold'em No Limit ($0.01/$0.02) - 2017/06/22 18:35:54 UTC [2017/06/22 14:35:54 ET]
Table 'Halley' 6-max Seat #1 is the button
Seat 1: yakka34 ($3.45 in chips) 
Seat 2: Yanus200 ($0.90 in chips) 
Seat 3: livethelife7 ($4.48 in chips) 
Seat 4: 7rocket ($2.01 in chips) 
Seat 5: ugi-dugi ($2.56 in chips) 
Seat 6: cannabis52ru ($1.09 in chips) 
Yanus200: posts small blind $0.01
livethelife7: posts big blind $0.02
*** HOLE CARDS ***
Dealt to yakka34 [Js 6d]
7rocket: raises $0.04 to $0.06
ugi-dugi: folds 
cannabis52ru: folds 
yakka34: folds 
Yanus200: calls $0.05
livethelife7: folds 
*** FLOP *** [Kc 8h 7h]
Yanus200: checks 
7rocket: checks 
*** TURN *** [Kc 8h 7h] [9c]
Yanus200: bets $0.07
7rocket: folds 
Uncalled bet ($0.07) returned to Yanus200
Yanus200 collected $0.14 from pot
Yanus200: doesn't show hand 
*** SUMMARY ***
Total pot $0.14 | Rake $0 
Board [Kc 8h 7h 9c]
Seat 1: yakka34 (button) folded before Flop (didn't bet)
Seat 2: Yanus200 (small blind) collected ($0.14)
Seat 3: livethelife7 (big blind) folded before Flop
Seat 4: 7rocket folded on the Turn
Seat 5: ugi-dugi folded before Flop (didn't bet)
Seat 6: cannabis52ru folded before Flop (didn't bet)



PokerStars Zoom Hand #172105517628:  Hold'em No Limit ($0.01/$0.02) - 2017/06/22 18:36:16 UTC [2017/06/22 14:36:16 ET]
Table 'Halley' 6-max Seat #1 is the button
Seat 1: PSzpak ($2.75 in chips) 
Seat 2: marcosamx17 ($2.07 in chips) 
Seat 3: nkfustgp6bp6 ($2.23 in chips) 
Seat 4: Feuchter007 ($2.65 in chips) 
Seat 5: jobo1000 ($2.01 in chips) 
Seat 6: yakka34 ($3.42 in chips) 
marcosamx17: posts small blind $0.01
nkfustgp6bp6: posts big blind $0.02
*** HOLE CARDS ***
Dealt to yakka34 [5h 2s]
Feuchter007: folds 
jobo1000: raises $0.04 to $0.06
yakka34: folds 
PSzpak: folds 
marcosamx17: folds 
nkfustgp6bp6: folds 
Uncalled bet ($0.04) returned to jobo1000
jobo1000 collected $0.05 from pot
jobo1000: doesn't show hand 
*** SUMMARY ***
Total pot $0.05 | Rake $0 
Seat 1: PSzpak (button) folded before Flop (didn't bet)
Seat 2: marcosamx17 (small blind) folded before Flop
Seat 3: nkfustgp6bp6 (big blind) folded before Flop
Seat 4: Feuchter007 folded before Flop (didn't bet)
Seat 5: jobo1000 collected ($0.05)
Seat 6: yakka34 folded before Flop (didn't bet)



PokerStars Zoom Hand #172105523311:  Hold'em No Limit ($0.01/$0.02) - 2017/06/22 18:36:24 UTC [2017/06/22 14:36:24 ET]
Table 'Halley' 6-max Seat #1 is the button
Seat 1: RodRodri ($2 in chips) 
Seat 2: Diane0818 ($5.19 in chips) 
Seat 3: yakka34 ($3.42 in chips) 
Seat 4: GyNy1976 ($3.03 in chips) 
Seat 5: fx2709 ($1.89 in chips) 
Seat 6: Just_Million ($2.01 in chips) 
Diane0818: posts small blind $0.01
yakka34: posts big blind $0.02
*** HOLE CARDS ***
Dealt to yakka34 [Jd 9c]
GyNy1976: folds 
fx2709: folds 
Just_Million: folds 
RodRodri: raises $0.04 to $0.06
Diane0818: folds 
yakka34: folds 
Uncalled bet ($0.04) returned to RodRodri
RodRodri collected $0.05 from pot
RodRodri: doesn't show hand 
*** SUMMARY ***
Total pot $0.05 | Rake $0 
Seat 1: RodRodri (button) collected ($0.05)
Seat 2: Diane0818 (small blind) folded before Flop
Seat 3: yakka34 (big blind) folded before Flop
Seat 4: GyNy1976 folded before Flop (didn't bet)
Seat 5: fx2709 folded before Flop (didn't bet)
Seat 6: Just_Million folded before Flop (didn't bet)



PokerStars Zoom Hand #172105520492:  Hold'em No Limit ($0.01/$0.02) - 2017/06/22 18:36:20 UTC [2017/06/22 14:36:20 ET]
Table 'Halley' 6-max Seat #1 is the button
Seat 1: klounaprb ($3.22 in chips) 
Seat 2: Dantelot ($1.73 in chips) 
Seat 3: julia_don ($7.48 in chips) 
Seat 4: Greg3184 ($2.04 in chips) 
Seat 5: yakka34 ($3.42 in chips) 
Seat 6: easylavandos ($2 in chips) 
Dantelot: posts small blind $0.01
julia_don: posts big blind $0.02
*** HOLE CARDS ***
Dealt to yakka34 [6s Qd]
Greg3184: folds 
yakka34: folds 
easylavandos: folds 
klounaprb: raises $0.04 to $0.06
Dantelot: calls $0.05
julia_don: calls $0.04
*** FLOP *** [5s 2h 8h]
Dantelot: checks 
julia_don: bets $0.09
klounaprb: folds 
Dantelot: folds 
Uncalled bet ($0.09) returned to julia_don
julia_don collected $0.17 from pot
julia_don: doesn't show hand 
*** SUMMARY ***
Total pot $0.18 | Rake $0.01 
Board [5s 2h 8h]
Seat 1: klounaprb (button) folded on the Flop
Seat 2: Dantelot (small blind) folded on the Flop
Seat 3: julia_don (big blind) collected ($0.17)
Seat 4: Greg3184 folded before Flop (didn't bet)
Seat 5: yakka34 folded before Flop (didn't bet)
Seat 6: easylavandos folded before Flop (didn't bet)



PokerStars Zoom Hand #172105511897:  Hold'em No Limit ($0.01/$0.02) - 2017/06/22 18:36:08 UTC [2017/06/22 14:36:08 ET]
Table 'Halley' 6-max Seat #1 is the button
Seat 1: yakka34 ($3.43 in chips) 
Seat 2: AleksSiri ($2.53 in chips) 
Seat 3: mich125 ($4.50 in chips) 
Seat 4: MrAbe72 ($0.97 in chips) 
Seat 5: Troyan555 ($3.60 in chips) 
Seat 6: mr_peq ($1.97 in chips) 
AleksSiri: posts small blind $0.01
mich125: posts big blind $0.02
*** HOLE CARDS ***
Dealt to yakka34 [Ks 6d]
MrAbe72: folds 
Troyan555: folds 
mr_peq: folds 
yakka34: folds 
AleksSiri: calls $0.01
mich125: checks 
*** FLOP *** [Th 2c 7s]
AleksSiri: checks 
mich125: checks 
*** TURN *** [Th 2c 7s] [7c]
AleksSiri: checks 
mich125: checks 
*** RIVER *** [Th 2c 7s 7c] [Qc]
AleksSiri: checks 
mich125: checks 
*** SHOW DOWN ***
AleksSiri: shows [4s Jc] (a pair of Sevens)
mich125: mucks hand 
AleksSiri collected $0.04 from pot
*** SUMMARY ***
Total pot $0.04 | Rake $0 
Board [Th 2c 7s 7c Qc]
Seat 1: yakka34 (button) folded before Flop (didn't bet)
Seat 2: AleksSiri (small blind) showed [4s Jc] and won ($0.04) with a pair of Sevens
Seat 3: mich125 (big blind) mucked [9c 4d]
Seat 4: MrAbe72 folded before Flop (didn't bet)
Seat 5: Troyan555 folded before Flop (didn't bet)
Seat 6: mr_peq folded before Flop (didn't bet)



PokerStars Zoom Hand #172105529921:  Hold'em No Limit ($0.01/$0.02) - 2017/06/22 18:36:33 UTC [2017/06/22 14:36:33 ET]
Table 'Halley' 6-max Seat #1 is the button
Seat 1: Parker09SA ($6.64 in chips) 
Seat 2: yakka34 ($3.40 in chips) 
Seat 3: Dinarbank ($2.47 in chips) 
Seat 4: chopgate ($2 in chips) 
Seat 5: s0chi161090 ($1 in chips) 
Seat 6: Defilyator ($2 in chips) 
yakka34: posts small blind $0.01
Dinarbank: posts big blind $0.02
*** HOLE CARDS ***
Dealt to yakka34 [3s Qh]
chopgate: folds 
s0chi161090: folds 
Defilyator: folds 
Parker09SA: folds 
yakka34: folds 
Uncalled bet ($0.01) returned to Dinarbank
Dinarbank collected $0.02 from pot
Dinarbank: doesn't show hand 
*** SUMMARY ***
Total pot $0.02 | Rake $0 
Seat 1: Parker09SA (button) folded before Flop (didn't bet)
Seat 2: yakka34 (small blind) folded before Flop
Seat 3: Dinarbank (big blind) collected ($0.02)
Seat 4: chopgate folded before Flop (didn't bet)
Seat 5: s0chi161090 folded before Flop (didn't bet)
Seat 6: Defilyator folded before Flop (didn't bet)



PokerStars Zoom Hand #172105533498:  Hold'em No Limit ($0.01/$0.02) - 2017/06/22 18:36:38 UTC [2017/06/22 14:36:38 ET]
Table 'Halley' 6-max Seat #1 is the button
Seat 1: baters_rus ($3.56 in chips) 
Seat 2: cainelax ($3.70 in chips) 
Seat 3: cappocne ($3.26 in chips) 
Seat 4: DryBoard ($2 in chips) 
Seat 5: yakka34 ($3.39 in chips) 
Seat 6: Mikiki888 ($0.73 in chips) 
cainelax: posts small blind $0.01
cappocne: posts big blind $0.02
*** HOLE CARDS ***
Dealt to yakka34 [Ad 6s]
DryBoard: folds 
yakka34: raises $0.04 to $0.06
Mikiki888: folds 
baters_rus: folds 
cainelax: folds 
cappocne: folds 
Uncalled bet ($0.04) returned to yakka34
yakka34 collected $0.05 from pot
yakka34: doesn't show hand 
*** SUMMARY ***
Total pot $0.05 | Rake $0 
Seat 1: baters_rus (button) folded before Flop (didn't bet)
Seat 2: cainelax (small blind) folded before Flop
Seat 3: cappocne (big blind) folded before Flop
Seat 4: DryBoard folded before Flop (didn't bet)
Seat 5: yakka34 collected ($0.05)
Seat 6: Mikiki888 folded before Flop (didn't bet)



PokerStars Zoom Hand #172105514746:  Hold'em No Limit ($0.01/$0.02) - 2017/06/22 18:36:12 UTC [2017/06/22 14:36:12 ET]
Table 'Halley' 6-max Seat #1 is the button
Seat 1: AlexandrosJC ($6.19 in chips) 
Seat 2: yakka34 ($3.43 in chips) 
Seat 3: Supstar L ($2.49 in chips) 
Seat 4: Sarmat_for ($2.35 in chips) 
Seat 5: klounaprb ($2.70 in chips) 
Seat 6: pepsi2202 ($2.23 in chips) 
yakka34: posts small blind $0.01
Supstar L: posts big blind $0.02
*** HOLE CARDS ***
Dealt to yakka34 [3h 4d]
Sarmat_for: folds 
klounaprb: folds 
pepsi2202: folds 
AlexandrosJC: raises $0.02 to $0.04
yakka34: folds 
Supstar L: raises $0.05 to $0.09
AlexandrosJC: calls $0.05
*** FLOP *** [7d 5c 9h]
Supstar L: checks 
AlexandrosJC: checks 
*** TURN *** [7d 5c 9h] [Ks]
Supstar L: checks 
AlexandrosJC: checks 
*** RIVER *** [7d 5c 9h Ks] [Tc]
Supstar L: checks 
AlexandrosJC: checks 
*** SHOW DOWN ***
Supstar L: shows [Qc As] (high card Ace)
AlexandrosJC: mucks hand 
Supstar L collected $0.18 from pot
*** SUMMARY ***
Total pot $0.19 | Rake $0.01 
Board [7d 5c 9h Ks Tc]
Seat 1: AlexandrosJC (button) mucked [3c 4c]
Seat 2: yakka34 (small blind) folded before Flop
Seat 3: Supstar L (big blind) showed [Qc As] and won ($0.18) with high card Ace
Seat 4: Sarmat_for folded before Flop (didn't bet)
Seat 5: klounaprb folded before Flop (didn't bet)
Seat 6: pepsi2202 folded before Flop (didn't bet)



PokerStars Zoom Hand #172105542268:  Hold'em No Limit ($0.01/$0.02) - 2017/06/22 18:36:50 UTC [2017/06/22 14:36:50 ET]
Table 'Halley' 6-max Seat #1 is the button
Seat 1: yakka34 ($3.42 in chips) 
Seat 2: UZ=ZERO=UZ ($3.21 in chips) 
Seat 3: mercury2670 ($0.98 in chips) 
Seat 4: Slayer's Law ($6.41 in chips) 
Seat 5: Shogasin ($2 in chips) 
Seat 6: lucastav206 ($2 in chips) 
UZ=ZERO=UZ: posts small blind $0.01
mercury2670: posts big blind $0.02
*** HOLE CARDS ***
Dealt to yakka34 [Ac As]
Slayer's Law: folds 
Shogasin: folds 
lucastav206: raises $0.04 to $0.06
yakka34: raises $0.04 to $0.10
UZ=ZERO=UZ: folds 
mercury2670: calls $0.08
lucastav206: calls $0.04
*** FLOP *** [Ad 2h Jc]
mercury2670: checks 
lucastav206: checks 
yakka34: bets $0.10
mercury2670: calls $0.10
lucastav206: calls $0.10
*** TURN *** [Ad 2h Jc] [Th]
mercury2670: checks 
lucastav206: checks 
yakka34: bets $0.20
mercury2670: folds 
lucastav206: calls $0.20
*** RIVER *** [Ad 2h Jc Th] [8c]
lucastav206: checks 
yakka34: bets $0.50
lucastav206: folds 
Uncalled bet ($0.50) returned to yakka34
yakka34 collected $0.97 from pot
yakka34: doesn't show hand 
*** SUMMARY ***
Total pot $1.01 | Rake $0.04 
Board [Ad 2h Jc Th 8c]
Seat 1: yakka34 (button) collected ($0.97)
Seat 2: UZ=ZERO=UZ (small blind) folded before Flop
Seat 3: mercury2670 (big blind) folded on the Turn
Seat 4: Slayer's Law folded before Flop (didn't bet)
Seat 5: Shogasin folded before Flop (didn't bet)
Seat 6: lucastav206 folded on the River



PokerStars Zoom Hand #172105587582:  Hold'em No Limit ($0.01/$0.02) - 2017/06/22 18:37:54 UTC [2017/06/22 14:37:54 ET]
Table 'Halley' 6-max Seat #1 is the button
Seat 1: andreig2012 ($2 in chips) 
Seat 2: pedroaberger ($2.41 in chips) 
Seat 3: pubru ($1.72 in chips) 
Seat 4: Qyran ($2.67 in chips) 
Seat 5: Crowned SULA ($2.03 in chips) 
Seat 6: yakka34 ($3.99 in chips) 
pedroaberger: posts small blind $0.01
pubru: posts big blind $0.02
*** HOLE CARDS ***
Dealt to yakka34 [6d Ah]
Qyran: folds 
Crowned SULA: folds 
yakka34: calls $0.02
andreig2012: folds 
pedroaberger: folds 
pubru: checks 
*** FLOP *** [4s Jh Td]
pubru: bets $0.03
yakka34: raises $0.03 to $0.06
pubru: calls $0.03
*** TURN *** [4s Jh Td] [Ad]
pubru: checks 
yakka34: bets $0.08
pubru: folds 
Uncalled bet ($0.08) returned to yakka34
yakka34 collected $0.16 from pot
yakka34: doesn't show hand 
*** SUMMARY ***
Total pot $0.17 | Rake $0.01 
Board [4s Jh Td Ad]
Seat 1: andreig2012 (button) folded before Flop (didn't bet)
Seat 2: pedroaberger (small blind) folded before Flop
Seat 3: pubru (big blind) folded on the Turn
Seat 4: Qyran folded before Flop (didn't bet)
Seat 5: Crowned SULA folded before Flop (didn't bet)
Seat 6: yakka34 collected ($0.16)



PokerStars Zoom Hand #172105623372:  Hold'em No Limit ($0.01/$0.02) - 2017/06/22 18:38:44 UTC [2017/06/22 14:38:44 ET]
Table 'Halley' 6-max Seat #1 is the button
Seat 1: n3wb1ee ($2.86 in chips) 
Seat 2: a7236 ($2.46 in chips) 
Seat 3: yakka34 ($4.07 in chips) 
Seat 4: tehpara ($2.22 in chips) 
Seat 5: GyNy1976 ($2.28 in chips) 
Seat 6: murkaaaa4 ($2.02 in chips) 
a7236: posts small blind $0.01
yakka34: posts big blind $0.02
*** HOLE CARDS ***
Dealt to yakka34 [8d 3h]
tehpara: raises $0.04 to $0.06
GyNy1976: folds 
murkaaaa4: folds 
n3wb1ee: folds 
a7236: folds 
yakka34: folds 
Uncalled bet ($0.04) returned to tehpara
tehpara collected $0.05 from pot
tehpara: doesn't show hand 
*** SUMMARY ***
Total pot $0.05 | Rake $0 
Seat 1: n3wb1ee (button) folded before Flop (didn't bet)
Seat 2: a7236 (small blind) folded before Flop
Seat 3: yakka34 (big blind) folded before Flop
Seat 4: tehpara collected ($0.05)
Seat 5: GyNy1976 folded before Flop (didn't bet)
Seat 6: murkaaaa4 folded before Flop (didn't bet)



PokerStars Zoom Hand #172105634693:  Hold'em No Limit ($0.01/$0.02) - 2017/06/22 18:39:00 UTC [2017/06/22 14:39:00 ET]
Table 'Halley' 6-max Seat #1 is the button
Seat 1: andreig2012 ($2.73 in chips) 
Seat 2: yakka34 ($4.05 in chips) 
Seat 3: Edson2rr ($2.33 in chips) 
Seat 4: rec1890 ($10.45 in chips) 
Seat 5: nicopetta91 ($2.61 in chips) 
Seat 6: guigmr ($2.43 in chips) 
yakka34: posts small blind $0.01
Edson2rr: posts big blind $0.02
*** HOLE CARDS ***
Dealt to yakka34 [8s 2c]
rec1890: folds 
nicopetta91: folds 
guigmr: folds 
andreig2012: folds 
yakka34: folds 
Uncalled bet ($0.01) returned to Edson2rr
Edson2rr collected $0.02 from pot
Edson2rr: doesn't show hand 
*** SUMMARY ***
Total pot $0.02 | Rake $0 
Seat 1: andreig2012 (button) folded before Flop (didn't bet)
Seat 2: yakka34 (small blind) folded before Flop
Seat 3: Edson2rr (big blind) collected ($0.02)
Seat 4: rec1890 folded before Flop (didn't bet)
Seat 5: nicopetta91 folded before Flop (didn't bet)
Seat 6: guigmr folded before Flop (didn't bet)



PokerStars Zoom Hand #172105628276:  Hold'em No Limit ($0.01/$0.02) - 2017/06/22 18:38:51 UTC [2017/06/22 14:38:51 ET]
Table 'Halley' 6-max Seat #1 is the button
Seat 1: Norma Je4n ($3.33 in chips) 
Seat 2: VivaLaBee ($2.45 in chips) 
Seat 3: jonaswao ($2 in chips) 
Seat 4: yakka34 ($4.05 in chips) 
Seat 5: selicold ($1.47 in chips) 
Seat 6: ZhiznTakaja ($11.23 in chips) 
VivaLaBee: posts small blind $0.01
jonaswao: posts big blind $0.02
*** HOLE CARDS ***
Dealt to yakka34 [9d 7d]
yakka34: folds 
selicold: raises $0.04 to $0.06
ZhiznTakaja: folds 
Norma Je4n: folds 
VivaLaBee: folds 
jonaswao: folds 
Uncalled bet ($0.04) returned to selicold
selicold collected $0.05 from pot
selicold: doesn't show hand 
*** SUMMARY ***
Total pot $0.05 | Rake $0 
Seat 1: Norma Je4n (button) folded before Flop (didn't bet)
Seat 2: VivaLaBee (small blind) folded before Flop
Seat 3: jonaswao (big blind) folded before Flop
Seat 4: yakka34 folded before Flop (didn't bet)
Seat 5: selicold collected ($0.05)
Seat 6: ZhiznTakaja folded before Flop (didn't bet)



PokerStars Zoom Hand #172105636778:  Hold'em No Limit ($0.01/$0.02) - 2017/06/22 18:39:03 UTC [2017/06/22 14:39:03 ET]
Table 'Halley' 6-max Seat #1 is the button
Seat 1: yakka34 ($4.04 in chips) 
Seat 2: r3v3rs3f3r3t ($2.35 in chips) 
Seat 3: Pepe_7C7 ($2.40 in chips) 
Seat 4: msu.fedos ($5.64 in chips) 
Seat 5: Nomoney099 ($2.03 in chips) 
Seat 6: xtddai ($3.02 in chips) 
r3v3rs3f3r3t: posts small blind $0.01
Pepe_7C7: posts big blind $0.02
*** HOLE CARDS ***
Dealt to yakka34 [6s Ad]
msu.fedos: folds 
Nomoney099: folds 
xtddai: raises $0.04 to $0.06
yakka34: calls $0.06
r3v3rs3f3r3t: folds 
Pepe_7C7: folds 
*** FLOP *** [7h Jc As]
xtddai: checks 
yakka34: bets $0.07
xtddai: folds 
Uncalled bet ($0.07) returned to yakka34
yakka34 collected $0.14 from pot
yakka34: doesn't show hand 
*** SUMMARY ***
Total pot $0.15 | Rake $0.01 
Board [7h Jc As]
Seat 1: yakka34 (button) collected ($0.14)
Seat 2: r3v3rs3f3r3t (small blind) folded before Flop
Seat 3: Pepe_7C7 (big blind) folded before Flop
Seat 4: msu.fedos folded before Flop (didn't bet)
Seat 5: Nomoney099 folded before Flop (didn't bet)
Seat 6: xtddai folded on the Flop



PokerStars Zoom Hand #172105655889:  Hold'em No Limit ($0.01/$0.02) - 2017/06/22 18:39:30 UTC [2017/06/22 14:39:30 ET]
Table 'Halley' 6-max Seat #1 is the button
Seat 1: Sirboy143 ($1.18 in chips) 
Seat 2: WhatYourHand ($2.03 in chips) 
Seat 3: zetlife ($3.67 in chips) 
Seat 4: greenie777 ($2.59 in chips) 
Seat 5: AVIAc9999 ($1.37 in chips) 
Seat 6: yakka34 ($4.12 in chips) 
WhatYourHand: posts small blind $0.01
zetlife: posts big blind $0.02
*** HOLE CARDS ***
Dealt to yakka34 [5s Kh]
greenie777: folds 
AVIAc9999: folds 
yakka34: folds 
Sirboy143: folds 
WhatYourHand: folds 
Uncalled bet ($0.01) returned to zetlife
zetlife collected $0.02 from pot
zetlife: doesn't show hand 
*** SUMMARY ***
Total pot $0.02 | Rake $0 
Seat 1: Sirboy143 (button) folded before Flop (didn't bet)
Seat 2: WhatYourHand (small blind) folded before Flop
Seat 3: zetlife (big blind) collected ($0.02)
Seat 4: greenie777 folded before Flop (didn't bet)
Seat 5: AVIAc9999 folded before Flop (didn't bet)
Seat 6: yakka34 folded before Flop (didn't bet)



PokerStars Zoom Hand #172105631827:  Hold'em No Limit ($0.01/$0.02) - 2017/06/22 18:38:56 UTC [2017/06/22 14:38:56 ET]
Table 'Halley' 6-max Seat #1 is the button
Seat 1: s0chi161090 ($2.92 in chips) 
Seat 2: ASENNA76 ($2 in chips) 
Seat 3: firelex1 ($2.03 in chips) 
Seat 4: yakka34 ($4.05 in chips) 
Seat 5: TDMSK ($1 in chips) 
Seat 6: julita2015 ($2.33 in chips) 
ASENNA76: posts small blind $0.01
firelex1: posts big blind $0.02
*** HOLE CARDS ***
Dealt to yakka34 [4d 2s]
yakka34: folds 
TDMSK: folds 
julita2015: raises $0.03 to $0.05
s0chi161090: folds 
ASENNA76: calls $0.04
firelex1: calls $0.03
*** FLOP *** [Tc 6c Ts]
ASENNA76: checks 
firelex1: checks 
julita2015: bets $0.10
ASENNA76: calls $0.10
firelex1: folds 
*** TURN *** [Tc 6c Ts] [Ac]
ASENNA76: bets $0.22
julita2015: folds 
Uncalled bet ($0.22) returned to ASENNA76
ASENNA76 collected $0.34 from pot
ASENNA76: doesn't show hand 
*** SUMMARY ***
Total pot $0.35 | Rake $0.01 
Board [Tc 6c Ts Ac]
Seat 1: s0chi161090 (button) folded before Flop (didn't bet)
Seat 2: ASENNA76 (small blind) collected ($0.34)
Seat 3: firelex1 (big blind) folded on the Flop
Seat 4: yakka34 folded before Flop (didn't bet)
Seat 5: TDMSK folded before Flop (didn't bet)
Seat 6: julita2015 folded on the Turn



PokerStars Zoom Hand #172105665013:  Hold'em No Limit ($0.01/$0.02) - 2017/06/22 18:39:43 UTC [2017/06/22 14:39:43 ET]
Table 'Halley' 6-max Seat #1 is the button
Seat 1: atolt ($2 in chips) 
Seat 2: zetlife ($1.82 in chips) 
Seat 3: Squishee-Apu ($2.46 in chips) 
Seat 4: ICTrueCards ($5.68 in chips) 
Seat 5: yakka34 ($4.12 in chips) 
Seat 6: livethelife7 ($2 in chips) 
zetlife: posts small blind $0.01
Squishee-Apu: posts big blind $0.02
*** HOLE CARDS ***
Dealt to yakka34 [2h 5s]
ICTrueCards: folds 
yakka34: folds 
livethelife7: raises $0.03 to $0.05
atolt: folds 
zetlife: raises $0.12 to $0.17
Squishee-Apu: folds 
livethelife7: calls $0.12
*** FLOP *** [Td Ts 8h]
zetlife: checks 
livethelife7: checks 
*** TURN *** [Td Ts 8h] [Tc]
zetlife: checks 
livethelife7: bets $0.12
zetlife: folds 
Uncalled bet ($0.12) returned to livethelife7
livethelife7 collected $0.35 from pot
livethelife7: doesn't show hand 
*** SUMMARY ***
Total pot $0.36 | Rake $0.01 
Board [Td Ts 8h Tc]
Seat 1: atolt (button) folded before Flop (didn't bet)
Seat 2: zetlife (small blind) folded on the Turn
Seat 3: Squishee-Apu (big blind) folded before Flop
Seat 4: ICTrueCards folded before Flop (didn't bet)
Seat 5: yakka34 folded before Flop (didn't bet)
Seat 6: livethelife7 collected ($0.35)



PokerStars Zoom Hand #172105675917:  Hold'em No Limit ($0.01/$0.02) - 2017/06/22 18:39:58 UTC [2017/06/22 14:39:58 ET]
Table 'Halley' 6-max Seat #1 is the button
Seat 1: SIvanych ($2.41 in chips) 
Seat 2: gadraul ($2.42 in chips) 
Seat 3: yakka34 ($4.12 in chips) 
Seat 4: zVitaliKz ($2.98 in chips) 
Seat 5: idrun1260 ($2.48 in chips) 
Seat 6: n3wb1ee ($2.83 in chips) 
gadraul: posts small blind $0.01
yakka34: posts big blind $0.02
*** HOLE CARDS ***
Dealt to yakka34 [6c Ah]
zVitaliKz: folds 
idrun1260: folds 
n3wb1ee: calls $0.02
SIvanych: folds 
gadraul: folds 
yakka34: checks 
*** FLOP *** [3c 9d Ac]
yakka34: bets $0.02
n3wb1ee: calls $0.02
*** TURN *** [3c 9d Ac] [Qd]
yakka34: bets $0.05
n3wb1ee: calls $0.05
*** RIVER *** [3c 9d Ac Qd] [5h]
yakka34: checks 
n3wb1ee: bets $0.10
yakka34: folds 
Uncalled bet ($0.10) returned to n3wb1ee
n3wb1ee collected $0.18 from pot
n3wb1ee: doesn't show hand 
*** SUMMARY ***
Total pot $0.19 | Rake $0.01 
Board [3c 9d Ac Qd 5h]
Seat 1: SIvanych (button) folded before Flop (didn't bet)
Seat 2: gadraul (small blind) folded before Flop
Seat 3: yakka34 (big blind) folded on the River
Seat 4: zVitaliKz folded before Flop (didn't bet)
Seat 5: idrun1260 folded before Flop (didn't bet)
Seat 6: n3wb1ee collected ($0.18)



PokerStars Zoom Hand #172105673026:  Hold'em No Limit ($0.01/$0.02) - 2017/06/22 18:39:54 UTC [2017/06/22 14:39:54 ET]
Table 'Halley' 6-max Seat #1 is the button
Seat 1: GuinhoAK ($2.07 in chips) 
Seat 2: Nfokin ($3.10 in chips) 
Seat 3: rec1890 ($5.66 in chips) 
Seat 4: Anton8282 ($2 in chips) 
Seat 5: yakka34 ($4.12 in chips) 
Seat 6: nappinho ($2.89 in chips) 
Nfokin: posts small blind $0.01
rec1890: posts big blind $0.02
*** HOLE CARDS ***
Dealt to yakka34 [5d 8s]
Anton8282: folds 
yakka34: folds 
nappinho: folds 
GuinhoAK: raises $0.04 to $0.06
Nfokin: folds 
rec1890: calls $0.04
*** FLOP *** [Kh Ts Qd]
rec1890: checks 
GuinhoAK: bets $0.07
rec1890: calls $0.07
*** TURN *** [Kh Ts Qd] [2d]
rec1890: checks 
GuinhoAK: checks 
*** RIVER *** [Kh Ts Qd 2d] [Js]
rec1890: checks 
GuinhoAK: checks 
*** SHOW DOWN ***
rec1890: shows [5c Qc] (a pair of Queens)
GuinhoAK: mucks hand 
rec1890 collected $0.26 from pot
*** SUMMARY ***
Total pot $0.27 | Rake $0.01 
Board [Kh Ts Qd 2d Js]
Seat 1: GuinhoAK (button) mucked [7h Th]
Seat 2: Nfokin (small blind) folded before Flop
Seat 3: rec1890 (big blind) showed [5c Qc] and won ($0.26) with a pair of Queens
Seat 4: Anton8282 folded before Flop (didn't bet)
Seat 5: yakka34 folded before Flop (didn't bet)
Seat 6: nappinho folded before Flop (didn't bet)



PokerStars Zoom Hand #172105713267:  Hold'em No Limit ($0.01/$0.02) - 2017/06/22 18:40:50 UTC [2017/06/22 14:40:50 ET]
Table 'Halley' 6-max Seat #1 is the button
Seat 1: Fr3dST ($2.12 in chips) 
Seat 2: holtas212 ($2.06 in chips) 
Seat 3: JensVan31 ($2 in chips) 
Seat 4: iamonlineeu ($1.57 in chips) 
Seat 5: alvivas812 ($2.77 in chips) 
Seat 6: yakka34 ($4.03 in chips) 
holtas212: posts small blind $0.01
JensVan31: posts big blind $0.02
*** HOLE CARDS ***
Dealt to yakka34 [2c 8s]
iamonlineeu: folds 
alvivas812: folds 
yakka34: folds 
Fr3dST: folds 
holtas212: raises $0.03 to $0.05
JensVan31: calls $0.03
*** FLOP *** [Jc 6s Js]
holtas212: checks 
JensVan31: bets $0.07
holtas212: folds 
Uncalled bet ($0.07) returned to JensVan31
JensVan31 collected $0.10 from pot
JensVan31: doesn't show hand 
*** SUMMARY ***
Total pot $0.10 | Rake $0 
Board [Jc 6s Js]
Seat 1: Fr3dST (button) folded before Flop (didn't bet)
Seat 2: holtas212 (small blind) folded on the Flop
Seat 3: JensVan31 (big blind) collected ($0.10)
Seat 4: iamonlineeu folded before Flop (didn't bet)
Seat 5: alvivas812 folded before Flop (didn't bet)
Seat 6: yakka34 folded before Flop (didn't bet)



PokerStars Zoom Hand #172105716153:  Hold'em No Limit ($0.01/$0.02) - 2017/06/22 18:40:54 UTC [2017/06/22 14:40:54 ET]
Table 'Halley' 6-max Seat #1 is the button
Seat 1: Igorshtef ($3.12 in chips) 
Seat 2: yakka34 ($4.03 in chips) 
Seat 3: onlyfoolsguy ($6.31 in chips) 
Seat 4: RastaCore3 ($1.81 in chips) 
Seat 5: nicopetta91 ($2.14 in chips) 
Seat 6: Yanus200 ($1.13 in chips) 
yakka34: posts small blind $0.01
onlyfoolsguy: posts big blind $0.02
*** HOLE CARDS ***
Dealt to yakka34 [8s Ac]
RastaCore3: folds 
nicopetta91: folds 
Yanus200: calls $0.02
Igorshtef: calls $0.02
yakka34: calls $0.01
onlyfoolsguy: checks 
*** FLOP *** [5h 7c Ad]
yakka34: bets $0.04
onlyfoolsguy: folds 
Yanus200: folds 
Igorshtef: raises $0.12 to $0.16
yakka34: calls $0.12
*** TURN *** [5h 7c Ad] [Ts]
yakka34: checks 
Igorshtef: bets $0.29
yakka34: folds 
Uncalled bet ($0.29) returned to Igorshtef
Igorshtef collected $0.39 from pot
Igorshtef: doesn't show hand 
*** SUMMARY ***
Total pot $0.40 | Rake $0.01 
Board [5h 7c Ad Ts]
Seat 1: Igorshtef (button) collected ($0.39)
Seat 2: yakka34 (small blind) folded on the Turn
Seat 3: onlyfoolsguy (big blind) folded on the Flop
Seat 4: RastaCore3 folded before Flop (didn't bet)
Seat 5: nicopetta91 folded before Flop (didn't bet)
Seat 6: Yanus200 folded on the Flop



PokerStars Zoom Hand #172105753635:  Hold'em No Limit ($0.01/$0.02) - 2017/06/22 18:41:47 UTC [2017/06/22 14:41:47 ET]
Table 'Halley' 6-max Seat #1 is the button
Seat 1: yakka34 ($3.85 in chips) 
Seat 2: Artem_2302 ($2.04 in chips) 
Seat 3: Tanarri134 ($4.05 in chips) 
Seat 4: 3D.freiheit ($2 in chips) 
Seat 5: ungiwar ($2 in chips) 
Seat 6: Aleksei Leo ($1.66 in chips) 
Artem_2302: posts small blind $0.01
Tanarri134: posts big blind $0.02
*** HOLE CARDS ***
Dealt to yakka34 [9c 6c]
3D.freiheit: folds 
ungiwar: folds 
Aleksei Leo: folds 
yakka34: folds 
Artem_2302: calls $0.01
Tanarri134: checks 
*** FLOP *** [8s Jd 8c]
Artem_2302: checks 
Tanarri134: bets $0.02
Artem_2302: calls $0.02
*** TURN *** [8s Jd 8c] [Kc]
Artem_2302: checks 
Tanarri134: bets $0.04
Artem_2302: calls $0.04
*** RIVER *** [8s Jd 8c Kc] [6s]
Artem_2302: checks 
Tanarri134: checks 
*** SHOW DOWN ***
Artem_2302: shows [7c Td] (a pair of Eights)
Tanarri134: shows [4d Js] (two pair, Jacks and Eights)
Tanarri134 collected $0.15 from pot
*** SUMMARY ***
Total pot $0.16 | Rake $0.01 
Board [8s Jd 8c Kc 6s]
Seat 1: yakka34 (button) folded before Flop (didn't bet)
Seat 2: Artem_2302 (small blind) showed [7c Td] and lost with a pair of Eights
Seat 3: Tanarri134 (big blind) showed [4d Js] and won ($0.15) with two pair, Jacks and Eights
Seat 4: 3D.freiheit folded before Flop (didn't bet)
Seat 5: ungiwar folded before Flop (didn't bet)
Seat 6: Aleksei Leo folded before Flop (didn't bet)



PokerStars Zoom Hand #172105773552:  Hold'em No Limit ($0.01/$0.02) - 2017/06/22 18:42:15 UTC [2017/06/22 14:42:15 ET]
Table 'Halley' 6-max Seat #1 is the button
Seat 1: marcosamx17 ($5.05 in chips) 
Seat 2: KOLAYN 1985 ($2 in chips) 
Seat 3: yakka34 ($3.85 in chips) 
Seat 4: Pystogov ($2 in chips) 
Seat 5: xxxbohunxxx ($2.02 in chips) 
Seat 6: AlexandrosJC ($3.04 in chips) 
KOLAYN 1985: posts small blind $0.01
yakka34: posts big blind $0.02
*** HOLE CARDS ***
Dealt to yakka34 [5s Jc]
Pystogov: folds 
xxxbohunxxx: folds 
AlexandrosJC: raises $0.04 to $0.06
marcosamx17: folds 
KOLAYN 1985: folds 
yakka34: folds 
Uncalled bet ($0.04) returned to AlexandrosJC
AlexandrosJC collected $0.05 from pot
AlexandrosJC: doesn't show hand 
*** SUMMARY ***
Total pot $0.05 | Rake $0 
Seat 1: marcosamx17 (button) folded before Flop (didn't bet)
Seat 2: KOLAYN 1985 (small blind) folded before Flop
Seat 3: yakka34 (big blind) folded before Flop
Seat 4: Pystogov folded before Flop (didn't bet)
Seat 5: xxxbohunxxx folded before Flop (didn't bet)
Seat 6: AlexandrosJC collected ($0.05)



PokerStars Zoom Hand #172105766389:  Hold'em No Limit ($0.01/$0.02) - 2017/06/22 18:42:05 UTC [2017/06/22 14:42:05 ET]
Table 'Halley' 6-max Seat #1 is the button
Seat 1: AdamMysz ($1.96 in chips) 
Seat 2: AlexandrosJC ($3.05 in chips) 
Seat 3: easylavandos ($2.33 in chips) 
Seat 4: yakka34 ($3.85 in chips) 
Seat 5: sebasilva226 ($2.49 in chips) 
Seat 6: l1alex ($2.25 in chips) 
AlexandrosJC: posts small blind $0.01
easylavandos: posts big blind $0.02
*** HOLE CARDS ***
Dealt to yakka34 [Td 5d]
yakka34: folds 
sebasilva226: raises $0.08 to $0.10
l1alex: calls $0.10
AdamMysz: folds 
AlexandrosJC: folds 
easylavandos: folds 
*** FLOP *** [Ah 4d 7s]
sebasilva226: bets $0.12
l1alex: folds 
Uncalled bet ($0.12) returned to sebasilva226
sebasilva226 collected $0.22 from pot
sebasilva226: doesn't show hand 
*** SUMMARY ***
Total pot $0.23 | Rake $0.01 
Board [Ah 4d 7s]
Seat 1: AdamMysz (button) folded before Flop (didn't bet)
Seat 2: AlexandrosJC (small blind) folded before Flop
Seat 3: easylavandos (big blind) folded before Flop
Seat 4: yakka34 folded before Flop (didn't bet)
Seat 5: sebasilva226 collected ($0.22)
Seat 6: l1alex folded on the Flop



PokerStars Zoom Hand #172105787086:  Hold'em No Limit ($0.01/$0.02) - 2017/06/22 18:42:34 UTC [2017/06/22 14:42:34 ET]
Table 'Halley' 6-max Seat #1 is the button
Seat 1: Hoerath ($1.99 in chips) 
Seat 2: Karsh_1 ($2 in chips) 
Seat 3: l1alex ($3.61 in chips) 
Seat 4: mich125 ($2.02 in chips) 
Seat 5: yakka34 ($3.83 in chips) 
Seat 6: jpdrumond ($2.60 in chips) 
Karsh_1: posts small blind $0.01
l1alex: posts big blind $0.02
*** HOLE CARDS ***
Dealt to yakka34 [Jh Tc]
mich125: folds 
yakka34: raises $0.04 to $0.06
jpdrumond: raises $0.12 to $0.18
Hoerath: folds 
Karsh_1: folds 
l1alex: folds 
yakka34: folds 
Uncalled bet ($0.12) returned to jpdrumond
jpdrumond collected $0.15 from pot
jpdrumond: doesn't show hand 
*** SUMMARY ***
Total pot $0.15 | Rake $0 
Seat 1: Hoerath (button) folded before Flop (didn't bet)
Seat 2: Karsh_1 (small blind) folded before Flop
Seat 3: l1alex (big blind) folded before Flop
Seat 4: mich125 folded before Flop (didn't bet)
Seat 5: yakka34 folded before Flop
Seat 6: jpdrumond collected ($0.15)



PokerStars Zoom Hand #172105804195:  Hold'em No Limit ($0.01/$0.02) - 2017/06/22 18:42:58 UTC [2017/06/22 14:42:58 ET]
Table 'Halley' 6-max Seat #1 is the button
Seat 1: B3N1825 ($1.94 in chips) 
Seat 2: yakka34 ($3.77 in chips) 
Seat 3: sarge egras ($2.32 in chips) 
Seat 4: gurgen064 ($1.76 in chips) 
Seat 5: Slayer's Law ($6.09 in chips) 
Seat 6: jofl77 ($1.43 in chips) 
yakka34: posts small blind $0.01
sarge egras: posts big blind $0.02
*** HOLE CARDS ***
Dealt to yakka34 [6c Ah]
gurgen064: folds 
Slayer's Law: folds 
jofl77: folds 
B3N1825: folds 
yakka34: raises $0.02 to $0.04
sarge egras: folds 
Uncalled bet ($0.02) returned to yakka34
yakka34 collected $0.04 from pot
yakka34: doesn't show hand 
*** SUMMARY ***
Total pot $0.04 | Rake $0 
Seat 1: B3N1825 (button) folded before Flop (didn't bet)
Seat 2: yakka34 (small blind) collected ($0.04)
Seat 3: sarge egras (big blind) folded before Flop
Seat 4: gurgen064 folded before Flop (didn't bet)
Seat 5: Slayer's Law folded before Flop (didn't bet)
Seat 6: jofl77 folded before Flop (didn't bet)



PokerStars Zoom Hand #172105811952:  Hold'em No Limit ($0.01/$0.02) - 2017/06/22 18:43:09 UTC [2017/06/22 14:43:09 ET]
Table 'Halley' 6-max Seat #1 is the button
Seat 1: Crowned SULA ($2.49 in chips) 
Seat 2: regivasco ($0.74 in chips) 
Seat 3: yakka34 ($3.79 in chips) 
Seat 4: ollszi ($2.56 in chips) 
Seat 5: nick6666176 ($7.88 in chips) 
Seat 6: geng yan ($1.60 in chips) 
regivasco: posts small blind $0.01
yakka34: posts big blind $0.02
*** HOLE CARDS ***
Dealt to yakka34 [4c 2d]
ollszi: folds 
nick6666176: folds 
geng yan: folds 
Crowned SULA: raises $0.03 to $0.05
regivasco: folds 
yakka34: folds 
Uncalled bet ($0.03) returned to Crowned SULA
Crowned SULA collected $0.05 from pot
Crowned SULA: doesn't show hand 
*** SUMMARY ***
Total pot $0.05 | Rake $0 
Seat 1: Crowned SULA (button) collected ($0.05)
Seat 2: regivasco (small blind) folded before Flop
Seat 3: yakka34 (big blind) folded before Flop
Seat 4: ollszi folded before Flop (didn't bet)
Seat 5: nick6666176 folded before Flop (didn't bet)
Seat 6: geng yan folded before Flop (didn't bet)



PokerStars Zoom Hand #172105801212:  Hold'em No Limit ($0.01/$0.02) - 2017/06/22 18:42:54 UTC [2017/06/22 14:42:54 ET]
Table 'Halley' 6-max Seat #1 is the button
Seat 1: atolt ($2.24 in chips) 
Seat 2: Epiclouder ($2.31 in chips) 
Seat 3: huntingdog66 ($2.67 in chips) 
Seat 4: cantor1987 ($4.85 in chips) 
Seat 5: Alex316316 ($2 in chips) 
Seat 6: yakka34 ($3.77 in chips) 
Epiclouder: posts small blind $0.01
huntingdog66: posts big blind $0.02
*** HOLE CARDS ***
Dealt to yakka34 [4c 8h]
cantor1987: folds 
Alex316316: folds 
yakka34: folds 
atolt: raises $0.02 to $0.04
Epiclouder: calls $0.03
huntingdog66: calls $0.02
*** FLOP *** [2c 2d Jc]
Epiclouder: checks 
huntingdog66: bets $0.02
atolt: raises $0.11 to $0.13
Epiclouder: folds 
huntingdog66: calls $0.11
*** TURN *** [2c 2d Jc] [4d]
huntingdog66: checks 
atolt: bets $0.28
huntingdog66: calls $0.28
*** RIVER *** [2c 2d Jc 4d] [Ad]
huntingdog66: checks 
atolt: checks 
*** SHOW DOWN ***
huntingdog66: shows [7h Jh] (two pair, Jacks and Deuces)
atolt: shows [Jd 9h] (two pair, Jacks and Deuces)
huntingdog66 collected $0.46 from pot
atolt collected $0.45 from pot
*** SUMMARY ***
Total pot $0.94 | Rake $0.03 
Board [2c 2d Jc 4d Ad]
Seat 1: atolt (button) showed [Jd 9h] and won ($0.45) with two pair, Jacks and Deuces
Seat 2: Epiclouder (small blind) folded on the Flop
Seat 3: huntingdog66 (big blind) showed [7h Jh] and won ($0.46) with two pair, Jacks and Deuces
Seat 4: cantor1987 folded before Flop (didn't bet)
Seat 5: Alex316316 folded before Flop (didn't bet)
Seat 6: yakka34 folded before Flop (didn't bet)



PokerStars Zoom Hand #172105821807:  Hold'em No Limit ($0.01/$0.02) - 2017/06/22 18:43:23 UTC [2017/06/22 14:43:23 ET]
Table 'Halley' 6-max Seat #1 is the button
Seat 1: yakka34 ($3.77 in chips) 
Seat 2: mannequino ($3.46 in chips) 
Seat 3: evgenij717 ($1.34 in chips) 
Seat 4: begginner666 ($4.33 in chips) 
Seat 5: jonaswao ($2.25 in chips) 
Seat 6: Sharkiep99 ($2.26 in chips) 
mannequino: posts small blind $0.01
evgenij717: posts big blind $0.02
*** HOLE CARDS ***
Dealt to yakka34 [5s 6s]
begginner666: folds 
jonaswao: folds 
Sharkiep99: folds 
yakka34: folds 
mannequino: folds 
Uncalled bet ($0.01) returned to evgenij717
evgenij717 collected $0.02 from pot
evgenij717: doesn't show hand 
*** SUMMARY ***
Total pot $0.02 | Rake $0 
Seat 1: yakka34 (button) folded before Flop (didn't bet)
Seat 2: mannequino (small blind) folded before Flop
Seat 3: evgenij717 (big blind) collected ($0.02)
Seat 4: begginner666 folded before Flop (didn't bet)
Seat 5: jonaswao folded before Flop (didn't bet)
Seat 6: Sharkiep99 folded before Flop (didn't bet)



PokerStars Zoom Hand #172105826913:  Hold'em No Limit ($0.01/$0.02) - 2017/06/22 18:43:30 UTC [2017/06/22 14:43:30 ET]
Table 'Halley' 6-max Seat #1 is the button
Seat 1: privet1965 ($1.69 in chips) 
Seat 2: berik776 ($0.35 in chips) 
Seat 3: redsox4711 ($2.01 in chips) 
Seat 4: sash120386 ($2.73 in chips) 
Seat 5: answis ($0.96 in chips) 
Seat 6: yakka34 ($3.77 in chips) 
berik776: posts small blind $0.01
redsox4711: posts big blind $0.02
*** HOLE CARDS ***
Dealt to yakka34 [9h 6h]
sash120386: folds 
answis: folds 
yakka34: folds 
privet1965: raises $0.05 to $0.07
berik776: folds 
redsox4711: folds 
Uncalled bet ($0.05) returned to privet1965
privet1965 collected $0.05 from pot
privet1965: doesn't show hand 
*** SUMMARY ***
Total pot $0.05 | Rake $0 
Seat 1: privet1965 (button) collected ($0.05)
Seat 2: berik776 (small blind) folded before Flop
Seat 3: redsox4711 (big blind) folded before Flop
Seat 4: sash120386 folded before Flop (didn't bet)
Seat 5: answis folded before Flop (didn't bet)
Seat 6: yakka34 folded before Flop (didn't bet)



PokerStars Zoom Hand #172105832567:  Hold'em No Limit ($0.01/$0.02) - 2017/06/22 18:43:38 UTC [2017/06/22 14:43:38 ET]
Table 'Halley' 6-max Seat #1 is the button
Seat 1: evgenij717 ($1.35 in chips) 
Seat 2: Longside1978 ($1.98 in chips) 
Seat 3: weeed kid ($7.49 in chips) 
Seat 4: yakka34 ($3.77 in chips) 
Seat 5: Morgot339 ($0.78 in chips) 
Seat 6: KY Cygni 81 ($2.24 in chips) 
Longside1978: posts small blind $0.01
weeed kid: posts big blind $0.02
*** HOLE CARDS ***
Dealt to yakka34 [9h 3s]
yakka34: folds 
Morgot339: folds 
KY Cygni 81: folds 
evgenij717: folds 
Longside1978: folds 
Uncalled bet ($0.01) returned to weeed kid
weeed kid collected $0.02 from pot
weeed kid: doesn't show hand 
*** SUMMARY ***
Total pot $0.02 | Rake $0 
Seat 1: evgenij717 (button) folded before Flop (didn't bet)
Seat 2: Longside1978 (small blind) folded before Flop
Seat 3: weeed kid (big blind) collected ($0.02)
Seat 4: yakka34 folded before Flop (didn't bet)
Seat 5: Morgot339 folded before Flop (didn't bet)
Seat 6: KY Cygni 81 folded before Flop (didn't bet)



PokerStars Zoom Hand #172105835375:  Hold'em No Limit ($0.01/$0.02) - 2017/06/22 18:43:42 UTC [2017/06/22 14:43:42 ET]
Table 'Halley' 6-max Seat #1 is the button
Seat 1: AlexandrosJC ($3.09 in chips) 
Seat 2: TheLag20 ($0.75 in chips) 
Seat 3: MULGESEAL ($5.48 in chips) 
Seat 4: Dinarbank ($1.93 in chips) 
Seat 5: yakka34 ($3.77 in chips) 
Seat 6: todi72 ($2.09 in chips) 
TheLag20: posts small blind $0.01
MULGESEAL: posts big blind $0.02
*** HOLE CARDS ***
Dealt to yakka34 [9d 2h]
Dinarbank: folds 
yakka34: folds 
todi72: raises $0.02 to $0.04
AlexandrosJC: calls $0.04
TheLag20: folds 
MULGESEAL: folds 
*** FLOP *** [Js 2s Jd]
todi72: bets $0.11
AlexandrosJC: folds 
Uncalled bet ($0.11) returned to todi72
todi72 collected $0.11 from pot
todi72: doesn't show hand 
*** SUMMARY ***
Total pot $0.11 | Rake $0 
Board [Js 2s Jd]
Seat 1: AlexandrosJC (button) folded on the Flop
Seat 2: TheLag20 (small blind) folded before Flop
Seat 3: MULGESEAL (big blind) folded before Flop
Seat 4: Dinarbank folded before Flop (didn't bet)
Seat 5: yakka34 folded before Flop (didn't bet)
Seat 6: todi72 collected ($0.11)



PokerStars Zoom Hand #172105838292:  Hold'em No Limit ($0.01/$0.02) - 2017/06/22 18:43:46 UTC [2017/06/22 14:43:46 ET]
Table 'Halley' 6-max Seat #1 is the button
Seat 1: wyttrom ($2.57 in chips) 
Seat 2: yakka34 ($3.77 in chips) 
Seat 3: axi05 ($4.72 in chips) 
Seat 4: cjht1 ($2.42 in chips) 
Seat 5: Hart1993 ($2.21 in chips) 
Seat 6: DUCAGIVA ($1.91 in chips) 
yakka34: posts small blind $0.01
axi05: posts big blind $0.02
*** HOLE CARDS ***
Dealt to yakka34 [Kd Jd]
cjht1: folds 
Hart1993: raises $0.04 to $0.06
DUCAGIVA: folds 
wyttrom: folds 
yakka34: raises $0.04 to $0.10
axi05: folds 
Hart1993: calls $0.04
*** FLOP *** [Js Qd 6c]
yakka34: bets $0.11
Hart1993: calls $0.11
*** TURN *** [Js Qd 6c] [7s]
yakka34: bets $0.21
Hart1993: calls $0.21
*** RIVER *** [Js Qd 6c 7s] [Jc]
yakka34: bets $3.35 and is all-in
Hart1993: folds 
Uncalled bet ($3.35) returned to yakka34
yakka34 collected $0.83 from pot
yakka34: doesn't show hand 
*** SUMMARY ***
Total pot $0.86 | Rake $0.03 
Board [Js Qd 6c 7s Jc]
Seat 1: wyttrom (button) folded before Flop (didn't bet)
Seat 2: yakka34 (small blind) collected ($0.83)
Seat 3: axi05 (big blind) folded before Flop
Seat 4: cjht1 folded before Flop (didn't bet)
Seat 5: Hart1993 folded on the River
Seat 6: DUCAGIVA folded before Flop (didn't bet)



PokerStars Zoom Hand #172105877733:  Hold'em No Limit ($0.01/$0.02) - 2017/06/22 18:44:41 UTC [2017/06/22 14:44:41 ET]
Table 'Halley' 6-max Seat #1 is the button
Seat 1: jason2rose ($1.13 in chips) 
Seat 2: mavpo ($2.67 in chips) 
Seat 3: mich125 ($2.14 in chips) 
Seat 4: yakka34 ($4.18 in chips) 
Seat 5: Schmaggi94 ($2.55 in chips) 
Seat 6: AAs only ($3.34 in chips) 
mavpo: posts small blind $0.01
mich125: posts big blind $0.02
*** HOLE CARDS ***
Dealt to yakka34 [5d 3h]
yakka34: folds 
Schmaggi94: folds 
AAs only: raises $0.05 to $0.07
jason2rose: folds 
mavpo: folds 
mich125: folds 
Uncalled bet ($0.05) returned to AAs only
AAs only collected $0.05 from pot
AAs only: doesn't show hand 
*** SUMMARY ***
Total pot $0.05 | Rake $0 
Seat 1: jason2rose (button) folded before Flop (didn't bet)
Seat 2: mavpo (small blind) folded before Flop
Seat 3: mich125 (big blind) folded before Flop
Seat 4: yakka34 folded before Flop (didn't bet)
Seat 5: Schmaggi94 folded before Flop (didn't bet)
Seat 6: AAs only collected ($0.05)



PokerStars Zoom Hand #172105881995:  Hold'em No Limit ($0.01/$0.02) - 2017/06/22 18:44:47 UTC [2017/06/22 14:44:47 ET]
Table 'Halley' 6-max Seat #1 is the button
Seat 1: MrAbe72 ($0.65 in chips) 
Seat 2: maliniak75 ($1.06 in chips) 
Seat 3: yakka34 ($4.18 in chips) 
Seat 4: motorin40 ($3.76 in chips) 
Seat 5: AlexandrosJC ($7.39 in chips) 
Seat 6: GRIAGEN ($1.86 in chips) 
maliniak75: posts small blind $0.01
yakka34: posts big blind $0.02
*** HOLE CARDS ***
Dealt to yakka34 [9s 5c]
motorin40: folds 
AlexandrosJC: folds 
GRIAGEN: folds 
MrAbe72: folds 
maliniak75: calls $0.01
yakka34: checks 
*** FLOP *** [3s 2c 3h]
maliniak75: checks 
yakka34: bets $0.02
maliniak75: calls $0.02
*** TURN *** [3s 2c 3h] [Qd]
maliniak75: checks 
yakka34: bets $0.08
maliniak75: folds 
Uncalled bet ($0.08) returned to yakka34
yakka34 collected $0.08 from pot
yakka34: doesn't show hand 
*** SUMMARY ***
Total pot $0.08 | Rake $0 
Board [3s 2c 3h Qd]
Seat 1: MrAbe72 (button) folded before Flop (didn't bet)
Seat 2: maliniak75 (small blind) folded on the Turn
Seat 3: yakka34 (big blind) collected ($0.08)
Seat 4: motorin40 folded before Flop (didn't bet)
Seat 5: AlexandrosJC folded before Flop (didn't bet)
Seat 6: GRIAGEN folded before Flop (didn't bet)



PokerStars Zoom Hand #172105905094:  Hold'em No Limit ($0.01/$0.02) - 2017/06/22 18:45:19 UTC [2017/06/22 14:45:19 ET]
Table 'Halley' 6-max Seat #1 is the button
Seat 1: yakka34 ($4.22 in chips) 
Seat 2: kr@p@l_ik ($2.15 in chips) 
Seat 3: Cenzuura13 ($1.18 in chips) 
Seat 4: fin52 ($3.44 in chips) 
Seat 5: Morgot339 ($6.30 in chips) 
Seat 6: diceman0909 ($2.11 in chips) 
kr@p@l_ik: posts small blind $0.01
Cenzuura13: posts big blind $0.02
*** HOLE CARDS ***
Dealt to yakka34 [6s 4d]
fin52: folds 
Morgot339: folds 
diceman0909: folds 
yakka34: folds 
kr@p@l_ik: folds 
Uncalled bet ($0.01) returned to Cenzuura13
Cenzuura13 collected $0.02 from pot
Cenzuura13: doesn't show hand 
*** SUMMARY ***
Total pot $0.02 | Rake $0 
Seat 1: yakka34 (button) folded before Flop (didn't bet)
Seat 2: kr@p@l_ik (small blind) folded before Flop
Seat 3: Cenzuura13 (big blind) collected ($0.02)
Seat 4: fin52 folded before Flop (didn't bet)
Seat 5: Morgot339 folded before Flop (didn't bet)
Seat 6: diceman0909 folded before Flop (didn't bet)



PokerStars Zoom Hand #172105908068:  Hold'em No Limit ($0.01/$0.02) - 2017/06/22 18:45:23 UTC [2017/06/22 14:45:23 ET]
Table 'Halley' 6-max Seat #1 is the button
Seat 1: BoomBats87 ($2.09 in chips) 
Seat 2: gas_basket ($6.51 in chips) 
Seat 3: fin52 ($3.44 in chips) 
Seat 4: diceman0909 ($2.11 in chips) 
Seat 5: epikouros93 ($2.63 in chips) 
Seat 6: yakka34 ($4.22 in chips) 
gas_basket: posts small blind $0.01
fin52: posts big blind $0.02
*** HOLE CARDS ***
Dealt to yakka34 [4s 8h]
diceman0909: folds 
epikouros93: folds 
yakka34: folds 
BoomBats87: folds 
gas_basket: folds 
Uncalled bet ($0.01) returned to fin52
fin52 collected $0.02 from pot
fin52: doesn't show hand 
*** SUMMARY ***
Total pot $0.02 | Rake $0 
Seat 1: BoomBats87 (button) folded before Flop (didn't bet)
Seat 2: gas_basket (small blind) folded before Flop
Seat 3: fin52 (big blind) collected ($0.02)
Seat 4: diceman0909 folded before Flop (didn't bet)
Seat 5: epikouros93 folded before Flop (didn't bet)
Seat 6: yakka34 folded before Flop (didn't bet)



PokerStars Zoom Hand #172105916728:  Hold'em No Limit ($0.01/$0.02) - 2017/06/22 18:45:35 UTC [2017/06/22 14:45:35 ET]
Table 'Halley' 6-max Seat #1 is the button
Seat 1: Morgot339 ($6.28 in chips) 
Seat 2: virus359 ($1.92 in chips) 
Seat 3: L3zg1n ($1.95 in chips) 
Seat 4: phlopit ($2 in chips) 
Seat 5: yakka34 ($4.22 in chips) 
Seat 6: Tqlkkk-_- ($5.90 in chips) 
virus359: posts small blind $0.01
L3zg1n: posts big blind $0.02
*** HOLE CARDS ***
Dealt to yakka34 [Td 8s]
phlopit: folds 
yakka34: folds 
Tqlkkk-_-: folds 
Morgot339: folds 
virus359: folds 
Uncalled bet ($0.01) returned to L3zg1n
L3zg1n collected $0.02 from pot
L3zg1n: doesn't show hand 
*** SUMMARY ***
Total pot $0.02 | Rake $0 
Seat 1: Morgot339 (button) folded before Flop (didn't bet)
Seat 2: virus359 (small blind) folded before Flop
Seat 3: L3zg1n (big blind) collected ($0.02)
Seat 4: phlopit folded before Flop (didn't bet)
Seat 5: yakka34 folded before Flop (didn't bet)
Seat 6: Tqlkkk-_- folded before Flop (didn't bet)



PokerStars Zoom Hand #172105912357:  Hold'em No Limit ($0.01/$0.02) - 2017/06/22 18:45:29 UTC [2017/06/22 14:45:29 ET]
Table 'Halley' 6-max Seat #1 is the button
Seat 1: KOCTEHbKA193 ($2.03 in chips) 
Seat 2: ffev78 ($2.69 in chips) 
Seat 3: PavGur77 ($2.73 in chips) 
Seat 4: Cäse27 ($10.08 in chips) 
Seat 5: yakka34 ($4.22 in chips) 
Seat 6: s0chi161090 ($1.84 in chips) 
ffev78: posts small blind $0.01
PavGur77: posts big blind $0.02
*** HOLE CARDS ***
Dealt to yakka34 [9d Th]
Cäse27: folds 
yakka34: folds 
s0chi161090: folds 
KOCTEHbKA193: folds 
ffev78: folds 
Uncalled bet ($0.01) returned to PavGur77
PavGur77 collected $0.02 from pot
PavGur77: doesn't show hand 
*** SUMMARY ***
Total pot $0.02 | Rake $0 
Seat 1: KOCTEHbKA193 (button) folded before Flop (didn't bet)
Seat 2: ffev78 (small blind) folded before Flop
Seat 3: PavGur77 (big blind) collected ($0.02)
Seat 4: Cäse27 folded before Flop (didn't bet)
Seat 5: yakka34 folded before Flop (didn't bet)
Seat 6: s0chi161090 folded before Flop (didn't bet)



PokerStars Zoom Hand #172105919585:  Hold'em No Limit ($0.01/$0.02) - 2017/06/22 18:45:39 UTC [2017/06/22 14:45:39 ET]
Table 'Halley' 6-max Seat #1 is the button
Seat 1: milioneri011 ($2.99 in chips) 
Seat 2: yakka34 ($4.22 in chips) 
Seat 3: Sp!r!t_reSSr ($2.74 in chips) 
Seat 4: Faraon1207 ($2.17 in chips) 
Seat 5: usek-huysek ($2.20 in chips) 
Seat 6: cahalfish ($2.28 in chips) 
yakka34: posts small blind $0.01
Sp!r!t_reSSr: posts big blind $0.02
*** HOLE CARDS ***
Dealt to yakka34 [Qh Jd]
Faraon1207: folds 
usek-huysek: folds 
cahalfish: folds 
milioneri011: folds 
yakka34: raises $0.02 to $0.04
Sp!r!t_reSSr: folds 
Uncalled bet ($0.02) returned to yakka34
yakka34 collected $0.04 from pot
yakka34: doesn't show hand 
*** SUMMARY ***
Total pot $0.04 | Rake $0 
Seat 1: milioneri011 (button) folded before Flop (didn't bet)
Seat 2: yakka34 (small blind) collected ($0.04)
Seat 3: Sp!r!t_reSSr (big blind) folded before Flop
Seat 4: Faraon1207 folded before Flop (didn't bet)
Seat 5: usek-huysek folded before Flop (didn't bet)
Seat 6: cahalfish folded before Flop (didn't bet)



PokerStars Zoom Hand #172105933189:  Hold'em No Limit ($0.01/$0.02) - 2017/06/22 18:45:58 UTC [2017/06/22 14:45:58 ET]
Table 'Halley' 6-max Seat #1 is the button
Seat 1: yakka34 ($4.24 in chips) 
Seat 2: MULGESEAL ($4.93 in chips) 
Seat 3: Masha651 ($2.03 in chips) 
Seat 4: Panag88 ($3.68 in chips) 
Seat 5: 14kclayton14 ($2.22 in chips) 
Seat 6: ck387 ($5.26 in chips) 
MULGESEAL: posts small blind $0.01
Masha651: posts big blind $0.02
*** HOLE CARDS ***
Dealt to yakka34 [8d 5c]
Panag88: folds 
14kclayton14: folds 
ck387: folds 
yakka34: folds 
MULGESEAL: folds 
Uncalled bet ($0.01) returned to Masha651
Masha651 collected $0.02 from pot
Masha651: doesn't show hand 
*** SUMMARY ***
Total pot $0.02 | Rake $0 
Seat 1: yakka34 (button) folded before Flop (didn't bet)
Seat 2: MULGESEAL (small blind) folded before Flop
Seat 3: Masha651 (big blind) collected ($0.02)
Seat 4: Panag88 folded before Flop (didn't bet)
Seat 5: 14kclayton14 folded before Flop (didn't bet)
Seat 6: ck387 folded before Flop (didn't bet)



PokerStars Zoom Hand #172105938989:  Hold'em No Limit ($0.01/$0.02) - 2017/06/22 18:46:06 UTC [2017/06/22 14:46:06 ET]
Table 'Halley' 6-max Seat #1 is the button
Seat 1: jofl77 ($1.08 in chips) 
Seat 2: mcjacksonoff ($3.99 in chips) 
Seat 3: b0ll ($0.90 in chips) 
Seat 4: yakka34 ($4.24 in chips) 
Seat 5: Shogasin ($2.55 in chips) 
Seat 6: fin52 ($3.44 in chips) 
mcjacksonoff: posts small blind $0.01
b0ll: posts big blind $0.02
*** HOLE CARDS ***
Dealt to yakka34 [Jh 6s]
yakka34: folds 
Shogasin: folds 
fin52: folds 
jofl77: raises $0.04 to $0.06
mcjacksonoff: folds 
b0ll: folds 
Uncalled bet ($0.04) returned to jofl77
jofl77 collected $0.05 from pot
jofl77: doesn't show hand 
*** SUMMARY ***
Total pot $0.05 | Rake $0 
Seat 1: jofl77 (button) collected ($0.05)
Seat 2: mcjacksonoff (small blind) folded before Flop
Seat 3: b0ll (big blind) folded before Flop
Seat 4: yakka34 folded before Flop (didn't bet)
Seat 5: Shogasin folded before Flop (didn't bet)
Seat 6: fin52 folded before Flop (didn't bet)



PokerStars Zoom Hand #172105941108:  Hold'em No Limit ($0.01/$0.02) - 2017/06/22 18:46:09 UTC [2017/06/22 14:46:09 ET]
Table 'Halley' 6-max Seat #1 is the button
Seat 1: Hart1993 ($2 in chips) 
Seat 2: styxxx55 ($2.17 in chips) 
Seat 3: yakka34 ($4.24 in chips) 
Seat 4: Pepe_7C7 ($6.60 in chips) 
Seat 5: Kolpinets ($1.03 in chips) 
Seat 6: YaVamNeVeriu ($2 in chips) 
styxxx55: posts small blind $0.01
yakka34: posts big blind $0.02
*** HOLE CARDS ***
Dealt to yakka34 [Qs Tc]
Pepe_7C7: folds 
Kolpinets: folds 
YaVamNeVeriu: raises $0.04 to $0.06
Hart1993: calls $0.06
styxxx55: raises $0.22 to $0.28
yakka34: folds 
YaVamNeVeriu: folds 
Hart1993: folds 
Uncalled bet ($0.22) returned to styxxx55
styxxx55 collected $0.20 from pot
styxxx55: doesn't show hand 
*** SUMMARY ***
Total pot $0.20 | Rake $0 
Seat 1: Hart1993 (button) folded before Flop
Seat 2: styxxx55 (small blind) collected ($0.20)
Seat 3: yakka34 (big blind) folded before Flop
Seat 4: Pepe_7C7 folded before Flop (didn't bet)
Seat 5: Kolpinets folded before Flop (didn't bet)
Seat 6: YaVamNeVeriu folded before Flop



PokerStars Zoom Hand #172105952737:  Hold'em No Limit ($0.01/$0.02) - 2017/06/22 18:46:25 UTC [2017/06/22 14:46:25 ET]
Table 'Halley' 6-max Seat #1 is the button
Seat 1: pjsgalvao ($4.60 in chips) 
Seat 2: TheBoss1985 ($2.13 in chips) 
Seat 3: AAs only ($4.17 in chips) 
Seat 4: yakka34 ($4.22 in chips) 
Seat 5: Leonx98 ($2.88 in chips) 
Seat 6: Nomoney099 ($2 in chips) 
TheBoss1985: posts small blind $0.01
AAs only: posts big blind $0.02
*** HOLE CARDS ***
Dealt to yakka34 [8d 6s]
yakka34: folds 
Leonx98: raises $0.04 to $0.06
Nomoney099: folds 
pjsgalvao: folds 
TheBoss1985: folds 
AAs only: folds 
Uncalled bet ($0.04) returned to Leonx98
Leonx98 collected $0.05 from pot
Leonx98: doesn't show hand 
*** SUMMARY ***
Total pot $0.05 | Rake $0 
Seat 1: pjsgalvao (button) folded before Flop (didn't bet)
Seat 2: TheBoss1985 (small blind) folded before Flop
Seat 3: AAs only (big blind) folded before Flop
Seat 4: yakka34 folded before Flop (didn't bet)
Seat 5: Leonx98 collected ($0.05)
Seat 6: Nomoney099 folded before Flop (didn't bet)



PokerStars Zoom Hand #172105955749:  Hold'em No Limit ($0.01/$0.02) - 2017/06/22 18:46:29 UTC [2017/06/22 14:46:29 ET]
Table 'Halley' 6-max Seat #1 is the button
Seat 1: Greg3184 ($2 in chips) 
Seat 2: yakka34 ($4.22 in chips) 
Seat 3: cantor1987 ($3.30 in chips) 
Seat 4: Mastermuzzz ($2.76 in chips) 
Seat 5: somi58 ($1.64 in chips) 
Seat 6: Bedu1ia ($1.73 in chips) 
yakka34: posts small blind $0.01
cantor1987: posts big blind $0.02
*** HOLE CARDS ***
Dealt to yakka34 [7s 4d]
Mastermuzzz: folds 
somi58: folds 
Bedu1ia: folds 
Greg3184: folds 
yakka34: raises $0.02 to $0.04
cantor1987: calls $0.02
*** FLOP *** [7d 3h 5s]
yakka34: bets $0.04
cantor1987: folds 
Uncalled bet ($0.04) returned to yakka34
yakka34 collected $0.08 from pot
yakka34: doesn't show hand 
*** SUMMARY ***
Total pot $0.08 | Rake $0 
Board [7d 3h 5s]
Seat 1: Greg3184 (button) folded before Flop (didn't bet)
Seat 2: yakka34 (small blind) collected ($0.08)
Seat 3: cantor1987 (big blind) folded on the Flop
Seat 4: Mastermuzzz folded before Flop (didn't bet)
Seat 5: somi58 folded before Flop (didn't bet)
Seat 6: Bedu1ia folded before Flop (didn't bet)



PokerStars Zoom Hand #172105946947:  Hold'em No Limit ($0.01/$0.02) - 2017/06/22 18:46:17 UTC [2017/06/22 14:46:17 ET]
Table 'Halley' 6-max Seat #1 is the button
Seat 1: 14kclayton14 ($3.58 in chips) 
Seat 2: bohdanovitch ($2.96 in chips) 
Seat 3: Pystogov ($2.65 in chips) 
Seat 4: Bill9527 ($5.79 in chips) 
Seat 5: KY Cygni 81 ($3.94 in chips) 
Seat 6: yakka34 ($4.22 in chips) 
bohdanovitch: posts small blind $0.01
Pystogov: posts big blind $0.02
*** HOLE CARDS ***
Dealt to yakka34 [Qs Td]
Bill9527: raises $0.04 to $0.06
KY Cygni 81: folds 
yakka34: folds 
14kclayton14: calls $0.06
bohdanovitch: folds 
Pystogov: folds 
*** FLOP *** [9c Kc Ah]
Bill9527: checks 
14kclayton14: checks 
*** TURN *** [9c Kc Ah] [Th]
Bill9527: checks 
14kclayton14: bets $0.08
Bill9527: folds 
Uncalled bet ($0.08) returned to 14kclayton14
14kclayton14 collected $0.14 from pot
14kclayton14: doesn't show hand 
*** SUMMARY ***
Total pot $0.15 | Rake $0.01 
Board [9c Kc Ah Th]
Seat 1: 14kclayton14 (button) collected ($0.14)
Seat 2: bohdanovitch (small blind) folded before Flop
Seat 3: Pystogov (big blind) folded before Flop
Seat 4: Bill9527 folded on the Turn
Seat 5: KY Cygni 81 folded before Flop (didn't bet)
Seat 6: yakka34 folded before Flop (didn't bet)



PokerStars Zoom Hand #172105967178:  Hold'em No Limit ($0.01/$0.02) - 2017/06/22 18:46:45 UTC [2017/06/22 14:46:45 ET]
Table 'Halley' 6-max Seat #1 is the button
Seat 1: yakka34 ($4.26 in chips) 
Seat 2: WhatYourHand ($2.01 in chips) 
Seat 3: ZhiznTakaja ($2.26 in chips) 
Seat 4: Tanarri134 ($3.25 in chips) 
Seat 5: unique1012 ($4.11 in chips) 
Seat 6: SHALOMandKAT ($2.25 in chips) 
WhatYourHand: posts small blind $0.01
ZhiznTakaja: posts big blind $0.02
*** HOLE CARDS ***
Dealt to yakka34 [4d 4h]
Tanarri134: folds 
unique1012: raises $0.04 to $0.06
SHALOMandKAT: folds 
yakka34: folds 
WhatYourHand: folds 
ZhiznTakaja: folds 
Uncalled bet ($0.04) returned to unique1012
unique1012 collected $0.05 from pot
unique1012: doesn't show hand 
*** SUMMARY ***
Total pot $0.05 | Rake $0 
Seat 1: yakka34 (button) folded before Flop (didn't bet)
Seat 2: WhatYourHand (small blind) folded before Flop
Seat 3: ZhiznTakaja (big blind) folded before Flop
Seat 4: Tanarri134 folded before Flop (didn't bet)
Seat 5: unique1012 collected ($0.05)
Seat 6: SHALOMandKAT folded before Flop (didn't bet)



PokerStars Zoom Hand #172105974980:  Hold'em No Limit ($0.01/$0.02) - 2017/06/22 18:46:56 UTC [2017/06/22 14:46:56 ET]
Table 'Halley' 6-max Seat #1 is the button
Seat 1: bediboy ($4.43 in chips) 
Seat 2: fx2709 ($3.48 in chips) 
Seat 3: yakka34 ($4.26 in chips) 
Seat 4: M.CHIU1119 ($1.03 in chips) 
Seat 5: buffoo1 ($1.28 in chips) 
Seat 6: DonCell0404 ($1.78 in chips) 
fx2709: posts small blind $0.01
yakka34: posts big blind $0.02
*** HOLE CARDS ***
Dealt to yakka34 [Qs 2h]
M.CHIU1119: folds 
buffoo1: folds 
DonCell0404: folds 
bediboy: folds 
fx2709: raises $0.04 to $0.06
yakka34: folds 
Uncalled bet ($0.04) returned to fx2709
fx2709 collected $0.04 from pot
fx2709: doesn't show hand 
*** SUMMARY ***
Total pot $0.04 | Rake $0 
Seat 1: bediboy (button) folded before Flop (didn't bet)
Seat 2: fx2709 (small blind) collected ($0.04)
Seat 3: yakka34 (big blind) folded before Flop
Seat 4: M.CHIU1119 folded before Flop (didn't bet)
Seat 5: buffoo1 folded before Flop (didn't bet)
Seat 6: DonCell0404 folded before Flop (didn't bet)



PokerStars Zoom Hand #172105983639:  Hold'em No Limit ($0.01/$0.02) - 2017/06/22 18:47:08 UTC [2017/06/22 14:47:08 ET]
Table 'Halley' 6-max Seat #1 is the button
Seat 1: pubru ($1.71 in chips) 
Seat 2: ffev78 ($2.94 in chips) 
Seat 3: lovebug420 ($1.95 in chips) 
Seat 4: yakka34 ($4.24 in chips) 
Seat 5: pespo5 ($1.97 in chips) 
Seat 6: KOCTEHbKA193 ($2 in chips) 
ffev78: posts small blind $0.01
lovebug420: posts big blind $0.02
*** HOLE CARDS ***
Dealt to yakka34 [6h Kh]
yakka34: folds 
pespo5: folds 
KOCTEHbKA193: folds 
pubru: folds 
ffev78: raises $0.02 to $0.04
lovebug420: folds 
Uncalled bet ($0.02) returned to ffev78
ffev78 collected $0.04 from pot
ffev78: doesn't show hand 
*** SUMMARY ***
Total pot $0.04 | Rake $0 
Seat 1: pubru (button) folded before Flop (didn't bet)
Seat 2: ffev78 (small blind) collected ($0.04)
Seat 3: lovebug420 (big blind) folded before Flop
Seat 4: yakka34 folded before Flop (didn't bet)
Seat 5: pespo5 folded before Flop (didn't bet)
Seat 6: KOCTEHbKA193 folded before Flop (didn't bet)



PokerStars Zoom Hand #172106005153:  Hold'em No Limit ($0.01/$0.02) - 2017/06/22 18:47:38 UTC [2017/06/22 14:47:38 ET]
Table 'Halley' 6-max Seat #1 is the button
Seat 1: phriza1503 ($2 in chips) 
Seat 2: Fr3dST ($3.37 in chips) 
Seat 3: tuyokunaru ($3.59 in chips) 
Seat 4: WhatYourHand ($2.06 in chips) 
Seat 5: ZhiznTakaja ($2.26 in chips) 
Seat 6: yakka34 ($4.23 in chips) 
Fr3dST: posts small blind $0.01
tuyokunaru: posts big blind $0.02
*** HOLE CARDS ***
Dealt to yakka34 [3h 7c]
WhatYourHand: folds 
ZhiznTakaja: folds 
yakka34: folds 
phriza1503: folds 
Fr3dST: folds 
Uncalled bet ($0.01) returned to tuyokunaru
tuyokunaru collected $0.02 from pot
tuyokunaru: doesn't show hand 
*** SUMMARY ***
Total pot $0.02 | Rake $0 
Seat 1: phriza1503 (button) folded before Flop (didn't bet)
Seat 2: Fr3dST (small blind) folded before Flop
Seat 3: tuyokunaru (big blind) collected ($0.02)
Seat 4: WhatYourHand folded before Flop (didn't bet)
Seat 5: ZhiznTakaja folded before Flop (didn't bet)
Seat 6: yakka34 folded before Flop (didn't bet)



PokerStars Zoom Hand #172106008066:  Hold'em No Limit ($0.01/$0.02) - 2017/06/22 18:47:42 UTC [2017/06/22 14:47:42 ET]
Table 'Halley' 6-max Seat #1 is the button
Seat 1: alexb1403 ($5.34 in chips) 
Seat 2: _Adamasto_09 ($6.12 in chips) 
Seat 3: yakka34 ($4.23 in chips) 
Seat 4: YaVamNeVeriu ($2.59 in chips) 
Seat 5: Nomoney099 ($2.08 in chips) 
Seat 6: Mr.Capone9 ($2.06 in chips) 
_Adamasto_09: posts small blind $0.01
yakka34: posts big blind $0.02
*** HOLE CARDS ***
Dealt to yakka34 [Th 7d]
YaVamNeVeriu: folds 
Nomoney099: folds 
Mr.Capone9: folds 
alexb1403: folds 
_Adamasto_09: folds 
Uncalled bet ($0.01) returned to yakka34
yakka34 collected $0.02 from pot
yakka34: doesn't show hand 
*** SUMMARY ***
Total pot $0.02 | Rake $0 
Seat 1: alexb1403 (button) folded before Flop (didn't bet)
Seat 2: _Adamasto_09 (small blind) folded before Flop
Seat 3: yakka34 (big blind) collected ($0.02)
Seat 4: YaVamNeVeriu folded before Flop (didn't bet)
Seat 5: Nomoney099 folded before Flop (didn't bet)
Seat 6: Mr.Capone9 folded before Flop (didn't bet)



PokerStars Zoom Hand #172105990861:  Hold'em No Limit ($0.01/$0.02) - 2017/06/22 18:47:18 UTC [2017/06/22 14:47:18 ET]
Table 'Halley' 6-max Seat #1 is the button
Seat 1: yakka34 ($4.24 in chips) 
Seat 2: MIHA37641 ($0.98 in chips) 
Seat 3: Morgot339 ($0.81 in chips) 
Seat 4: Raistlin1984 ($2 in chips) 
Seat 5: MULGESEAL ($2.41 in chips) 
Seat 6: Suomi1982 ($3.10 in chips) 
MIHA37641: posts small blind $0.01
Morgot339: posts big blind $0.02
*** HOLE CARDS ***
Dealt to yakka34 [9h 3s]
Raistlin1984: folds 
MULGESEAL: folds 
Suomi1982: raises $0.03 to $0.05
yakka34: folds 
MIHA37641: calls $0.04
Morgot339: folds 
*** FLOP *** [4d 3c Jd]
MIHA37641: bets $0.18
Suomi1982: folds 
Uncalled bet ($0.18) returned to MIHA37641
MIHA37641 collected $0.12 from pot
MIHA37641: doesn't show hand 
*** SUMMARY ***
Total pot $0.12 | Rake $0 
Board [4d 3c Jd]
Seat 1: yakka34 (button) folded before Flop (didn't bet)
Seat 2: MIHA37641 (small blind) collected ($0.12)
Seat 3: Morgot339 (big blind) folded before Flop
Seat 4: Raistlin1984 folded before Flop (didn't bet)
Seat 5: MULGESEAL folded before Flop (didn't bet)
Seat 6: Suomi1982 folded on the Flop



PokerStars Zoom Hand #172105993732:  Hold'em No Limit ($0.01/$0.02) - 2017/06/22 18:47:22 UTC [2017/06/22 14:47:22 ET]
Table 'Halley' 6-max Seat #1 is the button
Seat 1: axi05 ($5.14 in chips) 
Seat 2: yakka34 ($4.24 in chips) 
Seat 3: Svartbäcken ($3.14 in chips) 
Seat 4: MULGESEAL ($2.41 in chips) 
Seat 5: Mikiki888 ($1.16 in chips) 
Seat 6: L3zg1n ($1.91 in chips) 
yakka34: posts small blind $0.01
Svartbäcken: posts big blind $0.02
*** HOLE CARDS ***
Dealt to yakka34 [9c 8d]
MULGESEAL: raises $0.03 to $0.05
Mikiki888: folds 
L3zg1n: raises $0.13 to $0.18
axi05: folds 
yakka34: folds 
Svartbäcken: folds 
MULGESEAL: calls $0.13
*** FLOP *** [2s 2d Ts]
MULGESEAL: checks 
L3zg1n: bets $0.38
MULGESEAL: calls $0.38
*** TURN *** [2s 2d Ts] [Jh]
MULGESEAL: checks 
L3zg1n: bets $1.11
MULGESEAL: raises $0.74 to $1.85 and is all-in
L3zg1n: calls $0.24 and is all-in
Uncalled bet ($0.50) returned to MULGESEAL
*** RIVER *** [2s 2d Ts Jh] [Qd]
*** SHOW DOWN ***
MULGESEAL: shows [Qh Qs] (a full house, Queens full of Deuces)
L3zg1n: shows [Kc Kh] (two pair, Kings and Deuces)
MULGESEAL collected $3.72 from pot
*** SUMMARY ***
Total pot $3.85 | Rake $0.13 
Board [2s 2d Ts Jh Qd]
Seat 1: axi05 (button) folded before Flop (didn't bet)
Seat 2: yakka34 (small blind) folded before Flop
Seat 3: Svartbäcken (big blind) folded before Flop
Seat 4: MULGESEAL showed [Qh Qs] and won ($3.72) with a full house, Queens full of Deuces
Seat 5: Mikiki888 folded before Flop (didn't bet)
Seat 6: L3zg1n showed [Kc Kh] and lost with two pair, Kings and Deuces



PokerStars Zoom Hand #172106013919:  Hold'em No Limit ($0.01/$0.02) - 2017/06/22 18:47:50 UTC [2017/06/22 14:47:50 ET]
Table 'Halley' 6-max Seat #1 is the button
Seat 1: yakka34 ($4.24 in chips) 
Seat 2: LicGuapo ($2 in chips) 
Seat 3: Raistlin1984 ($2 in chips) 
Seat 4: DUCAGIVA ($3.33 in chips) 
Seat 5: murkaaaa4 ($2 in chips) 
Seat 6: Epiclouder ($2.14 in chips) 
LicGuapo: posts small blind $0.01
Raistlin1984: posts big blind $0.02
*** HOLE CARDS ***
Dealt to yakka34 [3s 8s]
DUCAGIVA: folds 
murkaaaa4: folds 
Epiclouder: raises $0.02 to $0.04
yakka34: folds 
LicGuapo: folds 
Raistlin1984: folds 
Uncalled bet ($0.02) returned to Epiclouder
Epiclouder collected $0.05 from pot
Epiclouder: doesn't show hand 
*** SUMMARY ***
Total pot $0.05 | Rake $0 
Seat 1: yakka34 (button) folded before Flop (didn't bet)
Seat 2: LicGuapo (small blind) folded before Flop
Seat 3: Raistlin1984 (big blind) folded before Flop
Seat 4: DUCAGIVA folded before Flop (didn't bet)
Seat 5: murkaaaa4 folded before Flop (didn't bet)
Seat 6: Epiclouder collected ($0.05)



PokerStars Zoom Hand #172105987955:  Hold'em No Limit ($0.01/$0.02) - 2017/06/22 18:47:14 UTC [2017/06/22 14:47:14 ET]
Table 'Halley' 6-max Seat #1 is the button
Seat 1: Shless ($1.88 in chips) 
Seat 2: ZeZrArrow ($2.06 in chips) 
Seat 3: julita2015 ($2.17 in chips) 
Seat 4: 2bushy2 ($2.70 in chips) 
Seat 5: yakka34 ($4.24 in chips) 
Seat 6: jakubsong25 ($1.17 in chips) 
ZeZrArrow: posts small blind $0.01
julita2015: posts big blind $0.02
*** HOLE CARDS ***
Dealt to yakka34 [3s 4h]
2bushy2: folds 
yakka34: folds 
jakubsong25: folds 
Shless: raises $0.03 to $0.05
ZeZrArrow: calls $0.04
julita2015: calls $0.03
*** FLOP *** [9c Jh 5d]
ZeZrArrow: checks 
julita2015: checks 
Shless: bets $0.10
ZeZrArrow: folds 
julita2015: calls $0.10
*** TURN *** [9c Jh 5d] [As]
julita2015: checks 
Shless: checks 
*** RIVER *** [9c Jh 5d As] [5c]
julita2015: checks 
Shless: bets $0.14
julita2015: folds 
Uncalled bet ($0.14) returned to Shless
Shless collected $0.34 from pot
Shless: doesn't show hand 
*** SUMMARY ***
Total pot $0.35 | Rake $0.01 
Board [9c Jh 5d As 5c]
Seat 1: Shless (button) collected ($0.34)
Seat 2: ZeZrArrow (small blind) folded on the Flop
Seat 3: julita2015 (big blind) folded on the River
Seat 4: 2bushy2 folded before Flop (didn't bet)
Seat 5: yakka34 folded before Flop (didn't bet)
Seat 6: jakubsong25 folded before Flop (didn't bet)



PokerStars Zoom Hand #172106022551:  Hold'em No Limit ($0.01/$0.02) - 2017/06/22 18:48:02 UTC [2017/06/22 14:48:02 ET]
Table 'Halley' 6-max Seat #1 is the button
Seat 1: tarao1868 ($2.19 in chips) 
Seat 2: Pepe_7C7 ($2.70 in chips) 
Seat 3: superM432 ($2 in chips) 
Seat 4: eNroamer ($2.13 in chips) 
Seat 5: yakka34 ($4.24 in chips) 
Seat 6: Spiridon1980 ($2.28 in chips) 
Pepe_7C7: posts small blind $0.01
superM432: posts big blind $0.02
*** HOLE CARDS ***
Dealt to yakka34 [9h 6s]
eNroamer: folds 
yakka34: folds 
Spiridon1980: folds 
tarao1868: raises $0.04 to $0.06
Pepe_7C7: folds 
superM432: folds 
Uncalled bet ($0.04) returned to tarao1868
tarao1868 collected $0.05 from pot
tarao1868: doesn't show hand 
*** SUMMARY ***
Total pot $0.05 | Rake $0 
Seat 1: tarao1868 (button) collected ($0.05)
Seat 2: Pepe_7C7 (small blind) folded before Flop
Seat 3: superM432 (big blind) folded before Flop
Seat 4: eNroamer folded before Flop (didn't bet)
Seat 5: yakka34 folded before Flop (didn't bet)
Seat 6: Spiridon1980 folded before Flop (didn't bet)



PokerStars Zoom Hand #172106028288:  Hold'em No Limit ($0.01/$0.02) - 2017/06/22 18:48:10 UTC [2017/06/22 14:48:10 ET]
Table 'Halley' 6-max Seat #1 is the button
Seat 1: Higuchi_japa ($2.07 in chips) 
Seat 2: yakka34 ($4.24 in chips) 
Seat 3: mannequino ($3.20 in chips) 
Seat 4: Epiclouder ($2.12 in chips) 
Seat 5: aborigensoch ($2.01 in chips) 
Seat 6: Eltsupakabra ($1.97 in chips) 
yakka34: posts small blind $0.01
mannequino: posts big blind $0.02
*** HOLE CARDS ***
Dealt to yakka34 [8c 8h]
Epiclouder: folds 
aborigensoch: folds 
Eltsupakabra: folds 
Higuchi_japa: folds 
yakka34: raises $0.04 to $0.06
mannequino: folds 
Uncalled bet ($0.04) returned to yakka34
yakka34 collected $0.04 from pot
yakka34: doesn't show hand 
*** SUMMARY ***
Total pot $0.04 | Rake $0 
Seat 1: Higuchi_japa (button) folded before Flop (didn't bet)
Seat 2: yakka34 (small blind) collected ($0.04)
Seat 3: mannequino (big blind) folded before Flop
Seat 4: Epiclouder folded before Flop (didn't bet)
Seat 5: aborigensoch folded before Flop (didn't bet)
Seat 6: Eltsupakabra folded before Flop (didn't bet)



PokerStars Zoom Hand #172106025423:  Hold'em No Limit ($0.01/$0.02) - 2017/06/22 18:48:06 UTC [2017/06/22 14:48:06 ET]
Table 'Halley' 6-max Seat #1 is the button
Seat 1: Ne1tx ($4.55 in chips) 
Seat 2: demonuka ($2.30 in chips) 
Seat 3: michael12669 ($0.83 in chips) 
Seat 4: yakka34 ($4.24 in chips) 
Seat 5: PavGur77 ($4.14 in chips) 
Seat 6: acamarante ($2.16 in chips) 
demonuka: posts small blind $0.01
michael12669: posts big blind $0.02
*** HOLE CARDS ***
Dealt to yakka34 [Th 3h]
yakka34: folds 
PavGur77: folds 
acamarante: folds 
Ne1tx: folds 
demonuka: raises $0.03 to $0.05
michael12669: calls $0.03
*** FLOP *** [5s Kd 5c]
demonuka: bets $0.05
michael12669: calls $0.05
*** TURN *** [5s Kd 5c] [7d]
demonuka: checks 
michael12669: checks 
*** RIVER *** [5s Kd 5c 7d] [Ks]
demonuka: checks 
michael12669: bets $0.19
demonuka: folds 
Uncalled bet ($0.19) returned to michael12669
michael12669 collected $0.19 from pot
michael12669: doesn't show hand 
*** SUMMARY ***
Total pot $0.20 | Rake $0.01 
Board [5s Kd 5c 7d Ks]
Seat 1: Ne1tx (button) folded before Flop (didn't bet)
Seat 2: demonuka (small blind) folded on the River
Seat 3: michael12669 (big blind) collected ($0.19)
Seat 4: yakka34 folded before Flop (didn't bet)
Seat 5: PavGur77 folded before Flop (didn't bet)
Seat 6: acamarante folded before Flop (didn't bet)



PokerStars Zoom Hand #172106016877:  Hold'em No Limit ($0.01/$0.02) - 2017/06/22 18:47:54 UTC [2017/06/22 14:47:54 ET]
Table 'Halley' 6-max Seat #1 is the button
Seat 1: maliniak75 ($1.15 in chips) 
Seat 2: and1isgod92 ($1.91 in chips) 
Seat 3: Bedu1ia ($1.71 in chips) 
Seat 4: fx2709 ($3.44 in chips) 
Seat 5: todi72 ($2.05 in chips) 
Seat 6: yakka34 ($4.24 in chips) 
and1isgod92: posts small blind $0.01
Bedu1ia: posts big blind $0.02
*** HOLE CARDS ***
Dealt to yakka34 [2s 3s]
fx2709: raises $0.05 to $0.07
todi72: folds 
yakka34: folds 
maliniak75: calls $0.07
and1isgod92: folds 
Bedu1ia: calls $0.05
*** FLOP *** [Js Td 5d]
Bedu1ia: checks 
fx2709: bets $0.21
maliniak75: calls $0.21
Bedu1ia: calls $0.21
*** TURN *** [Js Td 5d] [6c]
Bedu1ia: checks 
fx2709: bets $0.82
maliniak75: folds 
Bedu1ia: calls $0.82
*** RIVER *** [Js Td 5d 6c] [6s]
Bedu1ia: checks 
fx2709: bets $2.34 and is all-in
Bedu1ia: calls $0.61 and is all-in
Uncalled bet ($1.73) returned to fx2709
*** SHOW DOWN ***
fx2709: shows [Th Ad] (two pair, Tens and Sixes)
Bedu1ia: shows [Jc Ks] (two pair, Jacks and Sixes)
Bedu1ia collected $3.58 from pot
*** SUMMARY ***
Total pot $3.71 | Rake $0.13 
Board [Js Td 5d 6c 6s]
Seat 1: maliniak75 (button) folded on the Turn
Seat 2: and1isgod92 (small blind) folded before Flop
Seat 3: Bedu1ia (big blind) showed [Jc Ks] and won ($3.58) with two pair, Jacks and Sixes
Seat 4: fx2709 showed [Th Ad] and lost with two pair, Tens and Sixes
Seat 5: todi72 folded before Flop (didn't bet)
Seat 6: yakka34 folded before Flop (didn't bet)



PokerStars Zoom Hand #172106041440:  Hold'em No Limit ($0.01/$0.02) - 2017/06/22 18:48:28 UTC [2017/06/22 14:48:28 ET]
Table 'Halley' 6-max Seat #1 is the button
Seat 1: dazanosi_ekb ($2 in chips) 
Seat 2: Higuchi_japa ($2.07 in chips) 
Seat 3: yakka34 ($4.26 in chips) 
Seat 4: easylavandos ($2.03 in chips) 
Seat 5: March of Cat ($1.46 in chips) 
Seat 6: Il moustruo ($2 in chips) 
Higuchi_japa: posts small blind $0.01
yakka34: posts big blind $0.02
*** HOLE CARDS ***
Dealt to yakka34 [4s 2d]
easylavandos: folds 
March of Cat: folds 
Il moustruo: folds 
dazanosi_ekb: folds 
Higuchi_japa: raises $0.05 to $0.07
yakka34: folds 
Uncalled bet ($0.05) returned to Higuchi_japa
Higuchi_japa collected $0.04 from pot
Higuchi_japa: doesn't show hand 
*** SUMMARY ***
Total pot $0.04 | Rake $0 
Seat 1: dazanosi_ekb (button) folded before Flop (didn't bet)
Seat 2: Higuchi_japa (small blind) collected ($0.04)
Seat 3: yakka34 (big blind) folded before Flop
Seat 4: easylavandos folded before Flop (didn't bet)
Seat 5: March of Cat folded before Flop (didn't bet)
Seat 6: Il moustruo folded before Flop (didn't bet)



PokerStars Zoom Hand #172106053935:  Hold'em No Limit ($0.01/$0.02) - 2017/06/22 18:48:45 UTC [2017/06/22 14:48:45 ET]
Table 'Halley' 6-max Seat #1 is the button
Seat 1: zetlife ($3.15 in chips) 
Seat 2: phriza1503 ($2.19 in chips) 
Seat 3: Crowned SULA ($2.83 in chips) 
Seat 4: sjoekewoe ($3.96 in chips) 
Seat 5: moneyMone151 ($1.08 in chips) 
Seat 6: yakka34 ($4.24 in chips) 
phriza1503: posts small blind $0.01
Crowned SULA: posts big blind $0.02
*** HOLE CARDS ***
Dealt to yakka34 [2c Ks]
sjoekewoe: folds 
moneyMone151: folds 
yakka34: raises $0.04 to $0.06
zetlife: folds 
phriza1503: folds 
Crowned SULA: folds 
Uncalled bet ($0.04) returned to yakka34
yakka34 collected $0.05 from pot
yakka34: doesn't show hand 
*** SUMMARY ***
Total pot $0.05 | Rake $0 
Seat 1: zetlife (button) folded before Flop (didn't bet)
Seat 2: phriza1503 (small blind) folded before Flop
Seat 3: Crowned SULA (big blind) folded before Flop
Seat 4: sjoekewoe folded before Flop (didn't bet)
Seat 5: moneyMone151 folded before Flop (didn't bet)
Seat 6: yakka34 collected ($0.05)



PokerStars Zoom Hand #172106064053:  Hold'em No Limit ($0.01/$0.02) - 2017/06/22 18:48:59 UTC [2017/06/22 14:48:59 ET]
Table 'Halley' 6-max Seat #1 is the button
Seat 1: yakka34 ($4.27 in chips) 
Seat 2: schlawinerr ($0.62 in chips) 
Seat 3: jofl77 ($1.16 in chips) 
Seat 4: motorin40 ($3.98 in chips) 
Seat 5: redkiyGAD ($5.64 in chips) 
Seat 6: marcosamx17 ($6.75 in chips) 
schlawinerr: posts small blind $0.01
jofl77: posts big blind $0.02
*** HOLE CARDS ***
Dealt to yakka34 [8s Jc]
motorin40: folds 
redkiyGAD: calls $0.02
marcosamx17: folds 
yakka34: raises $0.04 to $0.06
schlawinerr: raises $0.56 to $0.62 and is all-in
jofl77: folds 
redkiyGAD: folds 
yakka34: folds 
Uncalled bet ($0.56) returned to schlawinerr
schlawinerr collected $0.16 from pot
schlawinerr: doesn't show hand 
*** SUMMARY ***
Total pot $0.16 | Rake $0 
Seat 1: yakka34 (button) folded before Flop
Seat 2: schlawinerr (small blind) collected ($0.16)
Seat 3: jofl77 (big blind) folded before Flop
Seat 4: motorin40 folded before Flop (didn't bet)
Seat 5: redkiyGAD folded before Flop
Seat 6: marcosamx17 folded before Flop (didn't bet)



PokerStars Zoom Hand #172106073528:  Hold'em No Limit ($0.01/$0.02) - 2017/06/22 18:49:12 UTC [2017/06/22 14:49:12 ET]
Table 'Halley' 6-max Seat #1 is the button
Seat 1: l1alex ($2 in chips) 
Seat 2: NotTodayBoy ($1.81 in chips) 
Seat 3: ret7 ($2.03 in chips) 
Seat 4: Piwos ($1.75 in chips) 
Seat 5: yakka34 ($4.21 in chips) 
Seat 6: xtddai ($4.99 in chips) 
NotTodayBoy: posts small blind $0.01
ret7: posts big blind $0.02
*** HOLE CARDS ***
Dealt to yakka34 [Ah 4h]
Piwos: folds 
yakka34: calls $0.02
xtddai: folds 
l1alex: raises $0.06 to $0.08
NotTodayBoy: folds 
ret7: folds 
yakka34: calls $0.06
*** FLOP *** [8c 8s 4d]
yakka34: checks 
l1alex: checks 
*** TURN *** [8c 8s 4d] [7c]
yakka34: bets $0.09
l1alex: calls $0.09
*** RIVER *** [8c 8s 4d 7c] [7h]
yakka34: checks 
l1alex: checks 
*** SHOW DOWN ***
yakka34: shows [Ah 4h] (two pair, Eights and Sevens)
l1alex: shows [Ad Js] (two pair, Eights and Sevens)
yakka34 collected $0.18 from pot
l1alex collected $0.18 from pot
*** SUMMARY ***
Total pot $0.37 | Rake $0.01 
Board [8c 8s 4d 7c 7h]
Seat 1: l1alex (button) showed [Ad Js] and won ($0.18) with two pair, Eights and Sevens
Seat 2: NotTodayBoy (small blind) folded before Flop
Seat 3: ret7 (big blind) folded before Flop
Seat 4: Piwos folded before Flop (didn't bet)
Seat 5: yakka34 showed [Ah 4h] and won ($0.18) with two pair, Eights and Sevens
Seat 6: xtddai folded before Flop (didn't bet)



PokerStars Zoom Hand #172106104184:  Hold'em No Limit ($0.01/$0.02) - 2017/06/22 18:49:54 UTC [2017/06/22 14:49:54 ET]
Table 'Halley' 6-max Seat #1 is the button
Seat 1: xblujamx ($2.90 in chips) 
Seat 2: Saf-Margo89 ($1.64 in chips) 
Seat 3: ramzess 26 ($2 in chips) 
Seat 4: Vansun71 ($1.67 in chips) 
Seat 5: yakka34 ($4.21 in chips) 
Seat 6: Gri6Nik ($5.19 in chips) 
Saf-Margo89: posts small blind $0.01
ramzess 26: posts big blind $0.02
*** HOLE CARDS ***
Dealt to yakka34 [5d 4d]
Vansun71: folds 
yakka34: folds 
Gri6Nik: folds 
xblujamx: folds 
Saf-Margo89: raises $0.02 to $0.04
ramzess 26: folds 
Uncalled bet ($0.02) returned to Saf-Margo89
Saf-Margo89 collected $0.04 from pot
Saf-Margo89: doesn't show hand 
*** SUMMARY ***
Total pot $0.04 | Rake $0 
Seat 1: xblujamx (button) folded before Flop (didn't bet)
Seat 2: Saf-Margo89 (small blind) collected ($0.04)
Seat 3: ramzess 26 (big blind) folded before Flop
Seat 4: Vansun71 folded before Flop (didn't bet)
Seat 5: yakka34 folded before Flop (didn't bet)
Seat 6: Gri6Nik folded before Flop (didn't bet)



PokerStars Zoom Hand #172106100474:  Hold'em No Limit ($0.01/$0.02) - 2017/06/22 18:49:49 UTC [2017/06/22 14:49:49 ET]
Table 'Halley' 6-max Seat #1 is the button
Seat 1: demure2607 ($3.29 in chips) 
Seat 2: yakka34 ($4.22 in chips) 
Seat 3: azulut ($2 in chips) 
Seat 4: SeikoHeiko ($2.08 in chips) 
Seat 5: fatallrfehlr ($1.21 in chips) 
Seat 6: Bettler87 ($2.12 in chips) 
yakka34: posts small blind $0.01
azulut: posts big blind $0.02
*** HOLE CARDS ***
Dealt to yakka34 [Kh 4s]
SeikoHeiko: folds 
fatallrfehlr: raises $0.04 to $0.06
Bettler87: folds 
demure2607: folds 
yakka34: folds 
azulut: calls $0.04
*** FLOP *** [Ts Td 9d]
azulut: checks 
fatallrfehlr: bets $0.08
azulut: folds 
Uncalled bet ($0.08) returned to fatallrfehlr
fatallrfehlr collected $0.13 from pot
fatallrfehlr: doesn't show hand 
*** SUMMARY ***
Total pot $0.13 | Rake $0 
Board [Ts Td 9d]
Seat 1: demure2607 (button) folded before Flop (didn't bet)
Seat 2: yakka34 (small blind) folded before Flop
Seat 3: azulut (big blind) folded on the Flop
Seat 4: SeikoHeiko folded before Flop (didn't bet)
Seat 5: fatallrfehlr collected ($0.13)
Seat 6: Bettler87 folded before Flop (didn't bet)



PokerStars Zoom Hand #172106107074:  Hold'em No Limit ($0.01/$0.02) - 2017/06/22 18:49:58 UTC [2017/06/22 14:49:58 ET]
Table 'Halley' 6-max Seat #1 is the button
Seat 1: Shokkin ($1.63 in chips) 
Seat 2: avg35 ($3.15 in chips) 
Seat 3: slaviku.82 ($1 in chips) 
Seat 4: yakka34 ($4.21 in chips) 
Seat 5: flaviozaca ($2.45 in chips) 
Seat 6: regivasco ($0.77 in chips) 
avg35: posts small blind $0.01
slaviku.82: posts big blind $0.02
*** HOLE CARDS ***
Dealt to yakka34 [9h 6c]
yakka34: folds 
flaviozaca: folds 
regivasco: folds 
Shokkin: raises $0.04 to $0.06
avg35: folds 
slaviku.82: raises $0.04 to $0.10
Shokkin: calls $0.04
*** FLOP *** [Tc Ah 8h]
slaviku.82: checks 
Shokkin: bets $0.10
slaviku.82: raises $0.10 to $0.20
Shokkin: folds 
Uncalled bet ($0.10) returned to slaviku.82
slaviku.82 collected $0.40 from pot
slaviku.82: doesn't show hand 
*** SUMMARY ***
Total pot $0.41 | Rake $0.01 
Board [Tc Ah 8h]
Seat 1: Shokkin (button) folded on the Flop
Seat 2: avg35 (small blind) folded before Flop
Seat 3: slaviku.82 (big blind) collected ($0.40)
Seat 4: yakka34 folded before Flop (didn't bet)
Seat 5: flaviozaca folded before Flop (didn't bet)
Seat 6: regivasco folded before Flop (didn't bet)



PokerStars Zoom Hand #172106109988:  Hold'em No Limit ($0.01/$0.02) - 2017/06/22 18:50:02 UTC [2017/06/22 14:50:02 ET]
Table 'Halley' 6-max Seat #1 is the button
Seat 1: r3v3r ($2.27 in chips) 
Seat 2: DMCHMB ($3.16 in chips) 
Seat 3: yakka34 ($4.21 in chips) 
Seat 4: pubru ($1.80 in chips) 
Seat 5: Hoerath ($2.67 in chips) 
Seat 6: mavpo ($2 in chips) 
DMCHMB: posts small blind $0.01
yakka34: posts big blind $0.02
*** HOLE CARDS ***
Dealt to yakka34 [3c As]
pubru: raises $0.02 to $0.04
Hoerath: folds 
mavpo: folds 
r3v3r: folds 
DMCHMB: folds 
yakka34: calls $0.02
*** FLOP *** [Qc Kh Th]
yakka34: checks 
pubru: bets $0.07
yakka34: calls $0.07
*** TURN *** [Qc Kh Th] [Ad]
yakka34: checks 
pubru: checks 
*** RIVER *** [Qc Kh Th Ad] [9c]
yakka34: bets $0.22
pubru: calls $0.22
*** SHOW DOWN ***
yakka34: shows [3c As] (a pair of Aces)
pubru: shows [Ks Td] (two pair, Kings and Tens)
pubru collected $0.65 from pot
*** SUMMARY ***
Total pot $0.67 | Rake $0.02 
Board [Qc Kh Th Ad 9c]
Seat 1: r3v3r (button) folded before Flop (didn't bet)
Seat 2: DMCHMB (small blind) folded before Flop
Seat 3: yakka34 (big blind) showed [3c As] and lost with a pair of Aces
Seat 4: pubru showed [Ks Td] and won ($0.65) with two pair, Kings and Tens
Seat 5: Hoerath folded before Flop (didn't bet)
Seat 6: mavpo folded before Flop (didn't bet)



PokerStars Zoom Hand #172106128838:  Hold'em No Limit ($0.01/$0.02) - 2017/06/22 18:50:28 UTC [2017/06/22 14:50:28 ET]
Table 'Halley' 6-max Seat #1 is the button
Seat 1: WhatYourHand ($2 in chips) 
Seat 2: Krugelson ($2.41 in chips) 
Seat 3: kyvaldo ($2 in chips) 
Seat 4: ASENNA76 ($2 in chips) 
Seat 5: lt'spossible ($2.08 in chips) 
Seat 6: yakka34 ($3.88 in chips) 
Krugelson: posts small blind $0.01
kyvaldo: posts big blind $0.02
*** HOLE CARDS ***
Dealt to yakka34 [8h 8s]
ASENNA76: raises $0.04 to $0.06
lt'spossible: calls $0.06
yakka34: raises $0.04 to $0.10
WhatYourHand: folds 
Krugelson: calls $0.09
kyvaldo: folds 
ASENNA76: calls $0.04
lt'spossible: calls $0.04
*** FLOP *** [3c Tc 5c]
Krugelson: checks 
ASENNA76: checks 
lt'spossible: checks 
yakka34: bets $0.21
Krugelson: calls $0.21
ASENNA76: raises $1.69 to $1.90 and is all-in
lt'spossible: folds 
yakka34: folds 
Krugelson: calls $1.69
*** TURN *** [3c Tc 5c] [As]
*** RIVER *** [3c Tc 5c As] [Ah]
*** SHOW DOWN ***
Krugelson: shows [Ts Td] (a full house, Tens full of Aces)
ASENNA76: shows [Ac Qd] (three of a kind, Aces)
Krugelson collected $4.27 from pot
*** SUMMARY ***
Total pot $4.43 | Rake $0.16 
Board [3c Tc 5c As Ah]
Seat 1: WhatYourHand (button) folded before Flop (didn't bet)
Seat 2: Krugelson (small blind) showed [Ts Td] and won ($4.27) with a full house, Tens full of Aces
Seat 3: kyvaldo (big blind) folded before Flop
Seat 4: ASENNA76 showed [Ac Qd] and lost with three of a kind, Aces
Seat 5: lt'spossible folded on the Flop
Seat 6: yakka34 folded on the Flop



