PokerStars Zoom Hand #172695622425:  Hold'em No Limit ($0.01/$0.02) - 2017/07/06 18:03:38 ET
Table 'McNaught' 9-max Seat #1 is the button
Seat 1: solyom217 ($2.66 in chips) 
Seat 2: FriendlyElf ($2.19 in chips) 
Seat 3: Redvin33 ($1.60 in chips) 
Seat 4: eviljanne ($1.93 in chips) 
Seat 5: SandroVM ($1.83 in chips) 
Seat 6: Grisperlado ($1.47 in chips) 
Seat 7: LEONIDYS ($2.83 in chips) 
Seat 8: Waldemar A ($0.76 in chips) 
Seat 9: PoWeRBaRd ($2.31 in chips) 
FriendlyElf: posts small blind $0.01
Redvin33: posts big blind $0.02
*** HOLE CARDS ***
Dealt to Redvin33 [Qh 5d]
eviljanne: folds 
SandroVM: folds 
Grisperlado: folds 
LEONIDYS: folds 
Waldemar A: folds 
PoWeRBaRd: folds 
solyom217: folds 
FriendlyElf: raises $0.04 to $0.06
Redvin33: folds 
Uncalled bet ($0.04) returned to FriendlyElf
FriendlyElf collected $0.04 from pot
FriendlyElf: doesn't show hand 
*** SUMMARY ***
Total pot $0.04 | Rake $0 
Seat 1: solyom217 (button) folded before Flop (didn't bet)
Seat 2: FriendlyElf (small blind) collected ($0.04)
Seat 3: Redvin33 (big blind) folded before Flop
Seat 4: eviljanne folded before Flop (didn't bet)
Seat 5: SandroVM folded before Flop (didn't bet)
Seat 6: Grisperlado folded before Flop (didn't bet)
Seat 7: LEONIDYS folded before Flop (didn't bet)
Seat 8: Waldemar A folded before Flop (didn't bet)
Seat 9: PoWeRBaRd folded before Flop (didn't bet)



PokerStars Zoom Hand #172695637514:  Hold'em No Limit ($0.01/$0.02) - 2017/07/06 18:03:59 ET
Table 'McNaught' 9-max Seat #1 is the button
Seat 1: smopuim ($2.92 in chips) 
Seat 2: mario45648 ($2.76 in chips) 
Seat 3: COULEUR7 ($2.05 in chips) 
Seat 4: ArgusLL ($2.73 in chips) 
Seat 5: prostars62 ($3.28 in chips) 
Seat 6: Grigoris1962 ($2.17 in chips) 
Seat 7: red13rum ($4.99 in chips) 
Seat 8: Ksan5979 ($2.03 in chips) 
Seat 9: Redvin33 ($1.58 in chips) 
mario45648: posts small blind $0.01
COULEUR7: posts big blind $0.02
*** HOLE CARDS ***
Dealt to Redvin33 [5c 5d]
ArgusLL: folds 
prostars62: raises $0.05 to $0.07
Grigoris1962: folds 
red13rum: folds 
Ksan5979: folds 
Redvin33: calls $0.07
smopuim: folds 
mario45648: folds 
COULEUR7: folds 
*** FLOP *** [7d 6s 7h]
prostars62: checks 
Redvin33: bets $0.06
prostars62: calls $0.06
*** TURN *** [7d 6s 7h] [2h]
prostars62: checks 
Redvin33: bets $0.08
prostars62: calls $0.08
*** RIVER *** [7d 6s 7h 2h] [Kh]
prostars62: checks 
Redvin33: checks 
*** SHOW DOWN ***
prostars62: shows [Qd As] (a pair of Sevens)
Redvin33: shows [5c 5d] (two pair, Sevens and Fives)
Redvin33 collected $0.43 from pot
*** SUMMARY ***
Total pot $0.45 | Rake $0.02 
Board [7d 6s 7h 2h Kh]
Seat 1: smopuim (button) folded before Flop (didn't bet)
Seat 2: mario45648 (small blind) folded before Flop
Seat 3: COULEUR7 (big blind) folded before Flop
Seat 4: ArgusLL folded before Flop (didn't bet)
Seat 5: prostars62 showed [Qd As] and lost with a pair of Sevens
Seat 6: Grigoris1962 folded before Flop (didn't bet)
Seat 7: red13rum folded before Flop (didn't bet)
Seat 8: Ksan5979 folded before Flop (didn't bet)
Seat 9: Redvin33 showed [5c 5d] and won ($0.43) with two pair, Sevens and Fives



PokerStars Zoom Hand #172695665659:  Hold'em No Limit ($0.01/$0.02) - 2017/07/06 18:04:38 ET
Table 'McNaught' 9-max Seat #1 is the button
Seat 1: Cayoosh16 ($1.65 in chips) 
Seat 2: Redvin33 ($1.80 in chips) 
Seat 3: amergedon ($3.88 in chips) 
Seat 4: Haczlo ($5.28 in chips) 
Seat 5: PoWeRBaRd ($2.13 in chips) 
Seat 6: Rishnu Fr ($2.60 in chips) 
Seat 7: ta5090 ($2 in chips) 
Seat 8: O_Atec ($2 in chips) 
Seat 9: Cheburekuzz ($2.01 in chips) 
Redvin33: posts small blind $0.01
amergedon: posts big blind $0.02
*** HOLE CARDS ***
Dealt to Redvin33 [2s Qd]
Haczlo: folds 
PoWeRBaRd: folds 
Rishnu Fr: folds 
ta5090: folds 
O_Atec: folds 
Cheburekuzz: folds 
Cayoosh16: folds 
Redvin33: folds 
Uncalled bet ($0.01) returned to amergedon
amergedon collected $0.02 from pot
amergedon: doesn't show hand 
*** SUMMARY ***
Total pot $0.02 | Rake $0 
Seat 1: Cayoosh16 (button) folded before Flop (didn't bet)
Seat 2: Redvin33 (small blind) folded before Flop
Seat 3: amergedon (big blind) collected ($0.02)
Seat 4: Haczlo folded before Flop (didn't bet)
Seat 5: PoWeRBaRd folded before Flop (didn't bet)
Seat 6: Rishnu Fr folded before Flop (didn't bet)
Seat 7: ta5090 folded before Flop (didn't bet)
Seat 8: O_Atec folded before Flop (didn't bet)
Seat 9: Cheburekuzz folded before Flop (didn't bet)



PokerStars Zoom Hand #172695669273:  Hold'em No Limit ($0.01/$0.02) - 2017/07/06 18:04:43 ET
Table 'McNaught' 9-max Seat #1 is the button
Seat 1: Redvin33 ($1.79 in chips) 
Seat 2: japu2010 ($2.44 in chips) 
Seat 3: manowar7771 ($1.93 in chips) 
Seat 4: hapu ($7.77 in chips) 
Seat 5: bjrtyuk ($2.05 in chips) 
Seat 6: Bugiel ($2.57 in chips) 
Seat 7: NJoy2Win ($8.17 in chips) 
Seat 8: valera_9696@ ($2.72 in chips) 
Seat 9: Krja000 ($3.04 in chips) 
japu2010: posts small blind $0.01
manowar7771: posts big blind $0.02
*** HOLE CARDS ***
Dealt to Redvin33 [9d Jd]
hapu: folds 
bjrtyuk: folds 
Bugiel: folds 
NJoy2Win: folds 
valera_9696@: folds 
Krja000: folds 
Redvin33: raises $0.03 to $0.05
japu2010: folds 
manowar7771: folds 
Uncalled bet ($0.03) returned to Redvin33
Redvin33 collected $0.05 from pot
Redvin33: doesn't show hand 
*** SUMMARY ***
Total pot $0.05 | Rake $0 
Seat 1: Redvin33 (button) collected ($0.05)
Seat 2: japu2010 (small blind) folded before Flop
Seat 3: manowar7771 (big blind) folded before Flop
Seat 4: hapu folded before Flop (didn't bet)
Seat 5: bjrtyuk folded before Flop (didn't bet)
Seat 6: Bugiel folded before Flop (didn't bet)
Seat 7: NJoy2Win folded before Flop (didn't bet)
Seat 8: valera_9696@ folded before Flop (didn't bet)
Seat 9: Krja000 folded before Flop (didn't bet)



PokerStars Zoom Hand #172695678699:  Hold'em No Limit ($0.01/$0.02) - 2017/07/06 18:04:56 ET
Table 'McNaught' 9-max Seat #1 is the button
Seat 1: Ksan5979 ($2.03 in chips) 
Seat 2: KratEx-AK ($5.36 in chips) 
Seat 3: Luiz_Futeco ($0.38 in chips) 
Seat 4: Svetlana2962 ($2 in chips) 
Seat 5: ntr2xit ($2.03 in chips) 
Seat 6: SandroVM ($1.86 in chips) 
Seat 7: Kakadu 38 ($3 in chips) 
Seat 8: Redvin33 ($1.82 in chips) 
Seat 9: O_Atec ($2 in chips) 
KratEx-AK: posts small blind $0.01
Luiz_Futeco: posts big blind $0.02
*** HOLE CARDS ***
Dealt to Redvin33 [4c 4d]
Svetlana2962: folds 
ntr2xit: folds 
SandroVM: folds 
Kakadu 38: folds 
Redvin33: raises $0.03 to $0.05
O_Atec: folds 
Ksan5979: folds 
KratEx-AK: folds 
Luiz_Futeco: calls $0.03
*** FLOP *** [6h 9s Js]
Luiz_Futeco: checks 
Redvin33: checks 
*** TURN *** [6h 9s Js] [2d]
Luiz_Futeco: checks 
Redvin33: bets $0.04
Luiz_Futeco: folds 
Uncalled bet ($0.04) returned to Redvin33
Redvin33 collected $0.11 from pot
Redvin33: doesn't show hand 
*** SUMMARY ***
Total pot $0.11 | Rake $0 
Board [6h 9s Js 2d]
Seat 1: Ksan5979 (button) folded before Flop (didn't bet)
Seat 2: KratEx-AK (small blind) folded before Flop
Seat 3: Luiz_Futeco (big blind) folded on the Turn
Seat 4: Svetlana2962 folded before Flop (didn't bet)
Seat 5: ntr2xit folded before Flop (didn't bet)
Seat 6: SandroVM folded before Flop (didn't bet)
Seat 7: Kakadu 38 folded before Flop (didn't bet)
Seat 8: Redvin33 collected ($0.11)
Seat 9: O_Atec folded before Flop (didn't bet)



PokerStars Zoom Hand #172695704837:  Hold'em No Limit ($0.01/$0.02) - 2017/07/06 18:05:32 ET
Table 'McNaught' 9-max Seat #1 is the button
Seat 1: smopuim ($2.82 in chips) 
Seat 2: Turlock ($2.58 in chips) 
Seat 3: Xamil666 ($4.40 in chips) 
Seat 4: Redvin33 ($1.88 in chips) 
Seat 5: deichgraf000 ($5.51 in chips) 
Seat 6: bellamia26 ($4.41 in chips) 
Seat 7: FriendlyElf ($3.31 in chips) 
Seat 8: grave_17 ($2.46 in chips) 
Seat 9: Fr0l0FF ($5.46 in chips) 
Turlock: posts small blind $0.01
Xamil666: posts big blind $0.02
*** HOLE CARDS ***
Dealt to Redvin33 [7s Jh]
Redvin33: folds 
deichgraf000: folds 
bellamia26: folds 
FriendlyElf: raises $0.04 to $0.06
grave_17: folds 
Fr0l0FF: folds 
smopuim: folds 
Turlock: folds 
Xamil666: folds 
Uncalled bet ($0.04) returned to FriendlyElf
FriendlyElf collected $0.05 from pot
FriendlyElf: doesn't show hand 
*** SUMMARY ***
Total pot $0.05 | Rake $0 
Seat 1: smopuim (button) folded before Flop (didn't bet)
Seat 2: Turlock (small blind) folded before Flop
Seat 3: Xamil666 (big blind) folded before Flop
Seat 4: Redvin33 folded before Flop (didn't bet)
Seat 5: deichgraf000 folded before Flop (didn't bet)
Seat 6: bellamia26 folded before Flop (didn't bet)
Seat 7: FriendlyElf collected ($0.05)
Seat 8: grave_17 folded before Flop (didn't bet)
Seat 9: Fr0l0FF folded before Flop (didn't bet)



PokerStars Zoom Hand #172695710606:  Hold'em No Limit ($0.01/$0.02) - 2017/07/06 18:05:40 ET
Table 'McNaught' 9-max Seat #1 is the button
Seat 1: VladislavaV ($2.03 in chips) 
Seat 2: werner1293 ($2.12 in chips) 
Seat 3: AlexOzr74 ($2 in chips) 
Seat 4: KaHcTpykTap ($2.40 in chips) 
Seat 5: COULEUR7 ($2 in chips) 
Seat 6: Redvin33 ($1.88 in chips) 
Seat 7: VOLOOOODYA ($3.36 in chips) 
Seat 8: ArthurStk ($1.94 in chips) 
Seat 9: DiNiceBoy ($2.76 in chips) 
werner1293: posts small blind $0.01
AlexOzr74: posts big blind $0.02
*** HOLE CARDS ***
Dealt to Redvin33 [7c 9d]
KaHcTpykTap: folds 
COULEUR7: folds 
Redvin33: folds 
VOLOOOODYA: folds 
ArthurStk: folds 
DiNiceBoy: folds 
VladislavaV: folds 
werner1293: folds 
Uncalled bet ($0.01) returned to AlexOzr74
AlexOzr74 collected $0.02 from pot
AlexOzr74: doesn't show hand 
*** SUMMARY ***
Total pot $0.02 | Rake $0 
Seat 1: VladislavaV (button) folded before Flop (didn't bet)
Seat 2: werner1293 (small blind) folded before Flop
Seat 3: AlexOzr74 (big blind) collected ($0.02)
Seat 4: KaHcTpykTap folded before Flop (didn't bet)
Seat 5: COULEUR7 folded before Flop (didn't bet)
Seat 6: Redvin33 folded before Flop (didn't bet)
Seat 7: VOLOOOODYA folded before Flop (didn't bet)
Seat 8: ArthurStk folded before Flop (didn't bet)
Seat 9: DiNiceBoy folded before Flop (didn't bet)



PokerStars Zoom Hand #172695707781:  Hold'em No Limit ($0.01/$0.02) - 2017/07/06 18:05:36 ET
Table 'McNaught' 9-max Seat #1 is the button
Seat 1: PoWeRBaRd ($2.09 in chips) 
Seat 2: deichgraf000 ($5.51 in chips) 
Seat 3: Kilativ1972 ($2.04 in chips) 
Seat 4: Gorwfwefwed ($2.17 in chips) 
Seat 5: JJhatesMe ($2.26 in chips) 
Seat 6: FriendlyElf ($5.34 in chips) 
Seat 7: Redvin33 ($1.88 in chips) 
Seat 8: dmitrychuk ($2.72 in chips) 
Seat 9: Artem23Ka ($4.35 in chips) 
deichgraf000: posts small blind $0.01
Kilativ1972: posts big blind $0.02
*** HOLE CARDS ***
Dealt to Redvin33 [7d 2s]
Gorwfwefwed: folds 
JJhatesMe: folds 
FriendlyElf: folds 
Redvin33: folds 
dmitrychuk: folds 
Artem23Ka: raises $0.03 to $0.05
PoWeRBaRd: folds 
deichgraf000: folds 
Kilativ1972: calls $0.03
*** FLOP *** [Th 3s Js]
Kilativ1972: checks 
Artem23Ka: bets $0.09
Kilativ1972: raises $0.17 to $0.26
Artem23Ka: raises $0.42 to $0.68
Kilativ1972: raises $1.31 to $1.99 and is all-in
Artem23Ka: calls $1.31
*** FIRST TURN *** [Th 3s Js] [Ah]
*** FIRST RIVER *** [Th 3s Js Ah] [9s]
*** SECOND TURN *** [Th 3s Js] [Qh]
*** SECOND RIVER *** [Th 3s Js Qh] [5d]
*** FIRST SHOW DOWN ***
Kilativ1972: shows [Qs As] (a flush, Ace high)
Artem23Ka: shows [Tc Jh] (two pair, Jacks and Tens)
Kilativ1972 collected $1.98 from pot
*** SECOND SHOW DOWN ***
Kilativ1972: shows [Qs As] (a pair of Queens)
Artem23Ka: shows [Tc Jh] (two pair, Jacks and Tens)
Artem23Ka collected $1.97 from pot
*** SUMMARY ***
Total pot $4.09 | Rake $0.14 
Hand was run twice
FIRST Board [Th 3s Js Ah 9s]
SECOND Board [Th 3s Js Qh 5d]
Seat 1: PoWeRBaRd (button) folded before Flop (didn't bet)
Seat 2: deichgraf000 (small blind) folded before Flop
Seat 3: Kilativ1972 (big blind) showed [Qs As] and won ($1.98) with a flush, Ace high, and lost with a pair of Queens
Seat 4: Gorwfwefwed folded before Flop (didn't bet)
Seat 5: JJhatesMe folded before Flop (didn't bet)
Seat 6: FriendlyElf folded before Flop (didn't bet)
Seat 7: Redvin33 folded before Flop (didn't bet)
Seat 8: dmitrychuk folded before Flop (didn't bet)
Seat 9: Artem23Ka showed [Tc Jh] and lost with two pair, Jacks and Tens, and won ($1.97) with two pair, Jacks and Tens



PokerStars Zoom Hand #172695713446:  Hold'em No Limit ($0.01/$0.02) - 2017/07/06 18:05:44 ET
Table 'McNaught' 9-max Seat #1 is the button
Seat 1: Cnopic666 ($3.41 in chips) 
Seat 2: LYUBOW ($5.27 in chips) 
Seat 3: nerml000 ($1.37 in chips) 
Seat 4: Taraba68 ($2.31 in chips) 
Seat 5: Redvin33 ($1.88 in chips) 
Seat 6: valera_9696@ ($2.61 in chips) 
Seat 7: Rarog-Rusich ($3.88 in chips) 
Seat 8: Clarence Jr ($1.51 in chips) 
Seat 9: Grigoris1962 ($2.22 in chips) 
LYUBOW: posts small blind $0.01
nerml000: posts big blind $0.02
*** HOLE CARDS ***
Dealt to Redvin33 [Jd Qc]
Taraba68: folds 
Redvin33: calls $0.02
valera_9696@: folds 
Rarog-Rusich: folds 
Clarence Jr: raises $0.04 to $0.06
Grigoris1962: folds 
Cnopic666: folds 
LYUBOW: folds 
nerml000: folds 
Redvin33: calls $0.04
*** FLOP *** [Td 4h Qh]
Redvin33: checks 
Clarence Jr: bets $0.04
Redvin33: raises $0.08 to $0.12
Clarence Jr: raises $0.22 to $0.34
Redvin33: calls $0.22
*** TURN *** [Td 4h Qh] [Ac]
Redvin33: checks 
Clarence Jr: checks 
*** RIVER *** [Td 4h Qh Ac] [4d]
Redvin33: bets $0.24
Clarence Jr: calls $0.24
*** SHOW DOWN ***
Redvin33: shows [Jd Qc] (two pair, Queens and Fours)
Clarence Jr: shows [Qs Th] (two pair, Queens and Tens)
Clarence Jr collected $1.26 from pot
*** SUMMARY ***
Total pot $1.31 | Rake $0.05 
Board [Td 4h Qh Ac 4d]
Seat 1: Cnopic666 (button) folded before Flop (didn't bet)
Seat 2: LYUBOW (small blind) folded before Flop
Seat 3: nerml000 (big blind) folded before Flop
Seat 4: Taraba68 folded before Flop (didn't bet)
Seat 5: Redvin33 showed [Jd Qc] and lost with two pair, Queens and Fours
Seat 6: valera_9696@ folded before Flop (didn't bet)
Seat 7: Rarog-Rusich folded before Flop (didn't bet)
Seat 8: Clarence Jr showed [Qs Th] and won ($1.26) with two pair, Queens and Tens
Seat 9: Grigoris1962 folded before Flop (didn't bet)



PokerStars Zoom Hand #172695773922:  Hold'em No Limit ($0.01/$0.02) - 2017/07/06 18:07:08 ET
Table 'McNaught' 9-max Seat #1 is the button
Seat 1: Artem23Ka ($4.90 in chips) 
Seat 2: soldat871501 ($0.42 in chips) 
Seat 3: Redvin33 ($1.24 in chips) 
Seat 4: dmitrychuk ($2.64 in chips) 
Seat 5: delete333 ($2 in chips) 
Seat 6: denzell574 ($2 in chips) 
Seat 7: christina 1989 ($2 in chips) 
Seat 8: Cayoosh16 ($1.65 in chips) 
Seat 9: djfloss7 ($0.88 in chips) 
soldat871501: posts small blind $0.01
Redvin33: posts big blind $0.02
*** HOLE CARDS ***
Dealt to Redvin33 [Qc 3c]
dmitrychuk: folds 
delete333: folds 
denzell574: folds 
christina 1989: folds 
Cayoosh16: folds 
djfloss7: folds 
Artem23Ka: raises $0.04 to $0.06
soldat871501: folds 
Redvin33: folds 
Uncalled bet ($0.04) returned to Artem23Ka
Artem23Ka collected $0.05 from pot
Artem23Ka: doesn't show hand 
*** SUMMARY ***
Total pot $0.05 | Rake $0 
Seat 1: Artem23Ka (button) collected ($0.05)
Seat 2: soldat871501 (small blind) folded before Flop
Seat 3: Redvin33 (big blind) folded before Flop
Seat 4: dmitrychuk folded before Flop (didn't bet)
Seat 5: delete333 folded before Flop (didn't bet)
Seat 6: denzell574 folded before Flop (didn't bet)
Seat 7: christina 1989 folded before Flop (didn't bet)
Seat 8: Cayoosh16 folded before Flop (didn't bet)
Seat 9: djfloss7 folded before Flop (didn't bet)



PokerStars Zoom Hand #172695771018:  Hold'em No Limit ($0.01/$0.02) - 2017/07/06 18:07:04 ET
Table 'McNaught' 9-max Seat #1 is the button
Seat 1: npoBogHuLLa ($3.81 in chips) 
Seat 2: Taraba68 ($2.01 in chips) 
Seat 3: Dows&Poker ($2.94 in chips) 
Seat 4: NJoy2Win ($5.99 in chips) 
Seat 5: Gorwfwefwed ($3.54 in chips) 
Seat 6: Redvin33 ($1.24 in chips) 
Seat 7: patron5hot ($2.43 in chips) 
Seat 8: smopuim ($2.77 in chips) 
Seat 9: christina 1989 ($2 in chips) 
Taraba68: posts small blind $0.01
Dows&Poker: posts big blind $0.02
*** HOLE CARDS ***
Dealt to Redvin33 [4d 7s]
NJoy2Win: raises $0.04 to $0.06
Gorwfwefwed: folds 
Redvin33: folds 
patron5hot: folds 
smopuim: folds 
christina 1989: folds 
npoBogHuLLa: folds 
Taraba68: folds 
Dows&Poker: calls $0.04
*** FLOP *** [8s Kh 7d]
Dows&Poker: checks 
NJoy2Win: checks 
*** TURN *** [8s Kh 7d] [7c]
Dows&Poker: checks 
NJoy2Win: checks 
*** RIVER *** [8s Kh 7d 7c] [Jc]
Dows&Poker: checks 
NJoy2Win: checks 
*** SHOW DOWN ***
Dows&Poker: shows [Ac Qd] (a pair of Sevens)
NJoy2Win: shows [Qs As] (a pair of Sevens)
Dows&Poker collected $0.07 from pot
NJoy2Win collected $0.06 from pot
*** SUMMARY ***
Total pot $0.13 | Rake $0 
Board [8s Kh 7d 7c Jc]
Seat 1: npoBogHuLLa (button) folded before Flop (didn't bet)
Seat 2: Taraba68 (small blind) folded before Flop
Seat 3: Dows&Poker (big blind) showed [Ac Qd] and won ($0.07) with a pair of Sevens
Seat 4: NJoy2Win showed [Qs As] and won ($0.06) with a pair of Sevens
Seat 5: Gorwfwefwed folded before Flop (didn't bet)
Seat 6: Redvin33 folded before Flop (didn't bet)
Seat 7: patron5hot folded before Flop (didn't bet)
Seat 8: smopuim folded before Flop (didn't bet)
Seat 9: christina 1989 folded before Flop (didn't bet)



PokerStars Zoom Hand #172695783927:  Hold'em No Limit ($0.01/$0.02) - 2017/07/06 18:07:22 ET
Table 'McNaught' 9-max Seat #1 is the button
Seat 1: SweetPlay777 ($1.87 in chips) 
Seat 2: Redvin33 ($1.22 in chips) 
Seat 3: Luiz_Futeco ($0.34 in chips) 
Seat 4: filon21 ($3.49 in chips) 
Seat 5: Cayoosh16 ($1.70 in chips) 
Seat 6: ^J0K3RST@RS! ($2.86 in chips) 
Seat 7: Rajjan92 ($1.69 in chips) 
Seat 8: filipov1976 ($4.02 in chips) 
Seat 9: VOLOOOODYA ($2.67 in chips) 
Redvin33: posts small blind $0.01
Luiz_Futeco: posts big blind $0.02
*** HOLE CARDS ***
Dealt to Redvin33 [Qc 2s]
filon21: folds 
Cayoosh16: folds 
^J0K3RST@RS!: folds 
Rajjan92: folds 
filipov1976: folds 
VOLOOOODYA: folds 
SweetPlay777: folds 
Redvin33: folds 
Uncalled bet ($0.01) returned to Luiz_Futeco
Luiz_Futeco collected $0.02 from pot
Luiz_Futeco: doesn't show hand 
*** SUMMARY ***
Total pot $0.02 | Rake $0 
Seat 1: SweetPlay777 (button) folded before Flop (didn't bet)
Seat 2: Redvin33 (small blind) folded before Flop
Seat 3: Luiz_Futeco (big blind) collected ($0.02)
Seat 4: filon21 folded before Flop (didn't bet)
Seat 5: Cayoosh16 folded before Flop (didn't bet)
Seat 6: ^J0K3RST@RS! folded before Flop (didn't bet)
Seat 7: Rajjan92 folded before Flop (didn't bet)
Seat 8: filipov1976 folded before Flop (didn't bet)
Seat 9: VOLOOOODYA folded before Flop (didn't bet)



PokerStars Zoom Hand #172695787460:  Hold'em No Limit ($0.01/$0.02) - 2017/07/06 18:07:27 ET
Table 'McNaught' 9-max Seat #1 is the button
Seat 1: Redvin33 ($1.21 in chips) 
Seat 2: SweetPlay777 ($1.87 in chips) 
Seat 3: vadim1605 ($2.78 in chips) 
Seat 4: ArgusLL ($2.04 in chips) 
Seat 5: baboon100 ($2.89 in chips) 
Seat 6: COULEUR7 ($2 in chips) 
Seat 7: doberman1977 ($0.77 in chips) 
Seat 8: goku1212 ($0.62 in chips) 
Seat 9: Sympathya ($2.47 in chips) 
SweetPlay777: posts small blind $0.01
vadim1605: posts big blind $0.02
*** HOLE CARDS ***
Dealt to Redvin33 [9c Qd]
ArgusLL: folds 
baboon100: folds 
COULEUR7: folds 
doberman1977: folds 
goku1212: folds 
Sympathya: folds 
Redvin33: raises $0.02 to $0.04
SweetPlay777: folds 
vadim1605: folds 
Uncalled bet ($0.02) returned to Redvin33
Redvin33 collected $0.05 from pot
Redvin33: doesn't show hand 
*** SUMMARY ***
Total pot $0.05 | Rake $0 
Seat 1: Redvin33 (button) collected ($0.05)
Seat 2: SweetPlay777 (small blind) folded before Flop
Seat 3: vadim1605 (big blind) folded before Flop
Seat 4: ArgusLL folded before Flop (didn't bet)
Seat 5: baboon100 folded before Flop (didn't bet)
Seat 6: COULEUR7 folded before Flop (didn't bet)
Seat 7: doberman1977 folded before Flop (didn't bet)
Seat 8: goku1212 folded before Flop (didn't bet)
Seat 9: Sympathya folded before Flop (didn't bet)



PokerStars Zoom Hand #172695801307:  Hold'em No Limit ($0.01/$0.02) - 2017/07/06 18:07:46 ET
Table 'McNaught' 9-max Seat #1 is the button
Seat 1: yayadub ($1.97 in chips) 
Seat 2: babaevv0 ($4.10 in chips) 
Seat 3: YOHONSON ($2 in chips) 
Seat 4: serg197211 ($2.15 in chips) 
Seat 5: JJhatesMe ($3.10 in chips) 
Seat 6: bicho1040 ($4.36 in chips) 
Seat 7: Redvin33 ($1.24 in chips) 
Seat 8: dmitrychuk ($2.33 in chips) 
Seat 9: amergedon ($3.42 in chips) 
babaevv0: posts small blind $0.01
YOHONSON: posts big blind $0.02
*** HOLE CARDS ***
Dealt to Redvin33 [4s Qc]
serg197211: folds 
JJhatesMe: folds 
bicho1040: folds 
Redvin33: folds 
dmitrychuk: folds 
amergedon: folds 
yayadub: folds 
babaevv0: folds 
Uncalled bet ($0.01) returned to YOHONSON
YOHONSON collected $0.02 from pot
YOHONSON: doesn't show hand 
*** SUMMARY ***
Total pot $0.02 | Rake $0 
Seat 1: yayadub (button) folded before Flop (didn't bet)
Seat 2: babaevv0 (small blind) folded before Flop
Seat 3: YOHONSON (big blind) collected ($0.02)
Seat 4: serg197211 folded before Flop (didn't bet)
Seat 5: JJhatesMe folded before Flop (didn't bet)
Seat 6: bicho1040 folded before Flop (didn't bet)
Seat 7: Redvin33 folded before Flop (didn't bet)
Seat 8: dmitrychuk folded before Flop (didn't bet)
Seat 9: amergedon folded before Flop (didn't bet)



PokerStars Zoom Hand #172695798426:  Hold'em No Limit ($0.01/$0.02) - 2017/07/06 18:07:42 ET
Table 'McNaught' 9-max Seat #1 is the button
Seat 1: LEONIDYS ($3.69 in chips) 
Seat 2: christina 1989 ($3.84 in chips) 
Seat 3: JOHN_DOE071 ($1.87 in chips) 
Seat 4: PusyManiak ($2.19 in chips) 
Seat 5: Ksan5979 ($2.03 in chips) 
Seat 6: deichgraf000 ($5.49 in chips) 
Seat 7: soares0103 ($0.55 in chips) 
Seat 8: delete333 ($2 in chips) 
Seat 9: Redvin33 ($1.24 in chips) 
christina 1989: posts small blind $0.01
JOHN_DOE071: posts big blind $0.02
*** HOLE CARDS ***
Dealt to Redvin33 [2s Jd]
PusyManiak: folds 
Ksan5979: folds 
deichgraf000: folds 
soares0103: folds 
delete333: folds 
Redvin33: folds 
LEONIDYS: raises $0.03 to $0.05
christina 1989: raises $0.15 to $0.20
JOHN_DOE071: folds 
LEONIDYS: folds 
Uncalled bet ($0.15) returned to christina 1989
christina 1989 collected $0.12 from pot
christina 1989: doesn't show hand 
*** SUMMARY ***
Total pot $0.12 | Rake $0 
Seat 1: LEONIDYS (button) folded before Flop
Seat 2: christina 1989 (small blind) collected ($0.12)
Seat 3: JOHN_DOE071 (big blind) folded before Flop
Seat 4: PusyManiak folded before Flop (didn't bet)
Seat 5: Ksan5979 folded before Flop (didn't bet)
Seat 6: deichgraf000 folded before Flop (didn't bet)
Seat 7: soares0103 folded before Flop (didn't bet)
Seat 8: delete333 folded before Flop (didn't bet)
Seat 9: Redvin33 folded before Flop (didn't bet)



PokerStars Zoom Hand #172695807091:  Hold'em No Limit ($0.01/$0.02) - 2017/07/06 18:07:54 ET
Table 'McNaught' 9-max Seat #1 is the button
Seat 1: Artem23Ka ($2.23 in chips) 
Seat 2: manowar7771 ($1.83 in chips) 
Seat 3: Exclusiveby ($2.78 in chips) 
Seat 4: baboon100 ($2.87 in chips) 
Seat 5: Redvin33 ($1.24 in chips) 
Seat 6: Leorabotaet ($1.62 in chips) 
Seat 7: JJhatesMe ($3.14 in chips) 
Seat 8: goku1212 ($0.64 in chips) 
Seat 9: denzell574 ($1.95 in chips) 
manowar7771: posts small blind $0.01
Exclusiveby: posts big blind $0.02
*** HOLE CARDS ***
Dealt to Redvin33 [Jc Qd]
baboon100: folds 
Redvin33: calls $0.02
Leorabotaet: folds 
JJhatesMe: folds 
goku1212: folds 
denzell574: folds 
Artem23Ka: folds 
manowar7771: raises $0.08 to $0.10
Exclusiveby: folds 
Redvin33: folds 
Uncalled bet ($0.08) returned to manowar7771
manowar7771 collected $0.06 from pot
manowar7771: doesn't show hand 
*** SUMMARY ***
Total pot $0.06 | Rake $0 
Seat 1: Artem23Ka (button) folded before Flop (didn't bet)
Seat 2: manowar7771 (small blind) collected ($0.06)
Seat 3: Exclusiveby (big blind) folded before Flop
Seat 4: baboon100 folded before Flop (didn't bet)
Seat 5: Redvin33 folded before Flop
Seat 6: Leorabotaet folded before Flop (didn't bet)
Seat 7: JJhatesMe folded before Flop (didn't bet)
Seat 8: goku1212 folded before Flop (didn't bet)
Seat 9: denzell574 folded before Flop (didn't bet)



PokerStars Zoom Hand #172695804183:  Hold'em No Limit ($0.01/$0.02) - 2017/07/06 18:07:50 ET
Table 'McNaught' 9-max Seat #1 is the button
Seat 1: toluschev ($1.98 in chips) 
Seat 2: djfloss7 ($0.97 in chips) 
Seat 3: lilasg ($1 in chips) 
Seat 4: freeman77222 ($3.15 in chips) 
Seat 5: NJoy2Win ($8.25 in chips) 
Seat 6: KrPeter ($4.71 in chips) 
Seat 7: ArgusLL ($2.26 in chips) 
Seat 8: Redvin33 ($1.24 in chips) 
Seat 9: Ksan5979 ($2.12 in chips) 
djfloss7: posts small blind $0.01
lilasg: posts big blind $0.02
*** HOLE CARDS ***
Dealt to Redvin33 [5c 7c]
freeman77222: folds 
NJoy2Win: folds 
KrPeter: folds 
ArgusLL: folds 
Redvin33: folds 
Ksan5979: raises $0.04 to $0.06
toluschev: calls $0.06
djfloss7: folds 
lilasg: folds 
*** FLOP *** [6h Th 2h]
Ksan5979: bets $0.09
toluschev: calls $0.09
*** TURN *** [6h Th 2h] [Ad]
Ksan5979: bets $0.21
toluschev: calls $0.21
*** RIVER *** [6h Th 2h Ad] [4s]
Ksan5979: checks 
toluschev: checks 
*** SHOW DOWN ***
Ksan5979: shows [Ah 8d] (a pair of Aces)
toluschev: mucks hand 
Ksan5979 collected $0.72 from pot
*** SUMMARY ***
Total pot $0.75 | Rake $0.03 
Board [6h Th 2h Ad 4s]
Seat 1: toluschev (button) mucked [Qc Kh]
Seat 2: djfloss7 (small blind) folded before Flop
Seat 3: lilasg (big blind) folded before Flop
Seat 4: freeman77222 folded before Flop (didn't bet)
Seat 5: NJoy2Win folded before Flop (didn't bet)
Seat 6: KrPeter folded before Flop (didn't bet)
Seat 7: ArgusLL folded before Flop (didn't bet)
Seat 8: Redvin33 folded before Flop (didn't bet)
Seat 9: Ksan5979 showed [Ah 8d] and won ($0.72) with a pair of Aces



PokerStars Zoom Hand #172695822199:  Hold'em No Limit ($0.01/$0.02) - 2017/07/06 18:08:15 ET
Table 'McNaught' 9-max Seat #1 is the button
Seat 1: bediboy ($2.11 in chips) 
Seat 2: serg197211 ($2.13 in chips) 
Seat 3: nats0405 ($2.02 in chips) 
Seat 4: Redvin33 ($1.22 in chips) 
Seat 5: Brianezi ($0.97 in chips) 
Seat 6: Quijotelito ($4.99 in chips) 
Seat 7: goku1212 ($0.61 in chips) 
Seat 8: FriendlyElf ($2.96 in chips) 
Seat 9: Maxikreker ($0.83 in chips) 
serg197211: posts small blind $0.01
nats0405: posts big blind $0.02
*** HOLE CARDS ***
Dealt to Redvin33 [2d Ah]
Redvin33: calls $0.02
Brianezi: folds 
Quijotelito: folds 
goku1212: folds 
FriendlyElf: raises $0.06 to $0.08
Maxikreker: folds 
bediboy: folds 
serg197211: folds 
nats0405: calls $0.06
Redvin33: calls $0.06
*** FLOP *** [Ks 2h Jc]
nats0405: checks 
Redvin33: checks 
FriendlyElf: bets $0.24
nats0405: calls $0.24
Redvin33: folds 
*** TURN *** [Ks 2h Jc] [9s]
nats0405: bets $1.70 and is all-in
FriendlyElf: calls $1.70
*** RIVER *** [Ks 2h Jc 9s] [4c]
*** SHOW DOWN ***
nats0405: shows [2s As] (a pair of Deuces)
FriendlyElf: shows [Jd Js] (three of a kind, Jacks)
FriendlyElf collected $3.99 from pot
*** SUMMARY ***
Total pot $4.13 | Rake $0.14 
Board [Ks 2h Jc 9s 4c]
Seat 1: bediboy (button) folded before Flop (didn't bet)
Seat 2: serg197211 (small blind) folded before Flop
Seat 3: nats0405 (big blind) showed [2s As] and lost with a pair of Deuces
Seat 4: Redvin33 folded on the Flop
Seat 5: Brianezi folded before Flop (didn't bet)
Seat 6: Quijotelito folded before Flop (didn't bet)
Seat 7: goku1212 folded before Flop (didn't bet)
Seat 8: FriendlyElf showed [Jd Js] and won ($3.99) with three of a kind, Jacks
Seat 9: Maxikreker folded before Flop (didn't bet)



PokerStars Zoom Hand #172695854323:  Hold'em No Limit ($0.01/$0.02) - 2017/07/06 18:09:00 ET
Table 'McNaught' 9-max Seat #1 is the button
Seat 1: E-Berta ($1.02 in chips) 
Seat 2: NJoy2Win ($14.84 in chips) 
Seat 3: Sevastos ($1.10 in chips) 
Seat 4: Redvin33 ($1.14 in chips) 
Seat 5: Luiz_Futeco ($0.33 in chips) 
Seat 6: Xamil666 ($2.02 in chips) 
Seat 7: bediboy ($5.67 in chips) 
Seat 8: Fr0l0FF ($5.59 in chips) 
Seat 9: Bugiel ($2 in chips) 
NJoy2Win: posts small blind $0.01
Sevastos: posts big blind $0.02
*** HOLE CARDS ***
Dealt to Redvin33 [8d Kd]
Redvin33: calls $0.02
Luiz_Futeco: folds 
Xamil666: folds 
bediboy: folds 
Fr0l0FF: folds 
Bugiel: folds 
E-Berta: folds 
NJoy2Win: folds 
Sevastos: checks 
*** FLOP *** [9s 2s 3c]
Sevastos: checks 
Redvin33: bets $0.05
Sevastos: folds 
Uncalled bet ($0.05) returned to Redvin33
Redvin33 collected $0.05 from pot
Redvin33: doesn't show hand 
*** SUMMARY ***
Total pot $0.05 | Rake $0 
Board [9s 2s 3c]
Seat 1: E-Berta (button) folded before Flop (didn't bet)
Seat 2: NJoy2Win (small blind) folded before Flop
Seat 3: Sevastos (big blind) folded on the Flop
Seat 4: Redvin33 collected ($0.05)
Seat 5: Luiz_Futeco folded before Flop (didn't bet)
Seat 6: Xamil666 folded before Flop (didn't bet)
Seat 7: bediboy folded before Flop (didn't bet)
Seat 8: Fr0l0FF folded before Flop (didn't bet)
Seat 9: Bugiel folded before Flop (didn't bet)



PokerStars Zoom Hand #172695873641:  Hold'em No Limit ($0.01/$0.02) - 2017/07/06 18:09:27 ET
Table 'McNaught' 9-max Seat #1 is the button
Seat 1: Artem23Ka ($5.08 in chips) 
Seat 2: Redvin33 ($1.17 in chips) 
Seat 3: serg197211 ($2.50 in chips) 
Seat 4: Mùúh 22 ($3.34 in chips) 
Seat 5: robertomuc ($2.37 in chips) 
Seat 6: ArgusLL ($2.45 in chips) 
Seat 7: SandroVM ($2.08 in chips) 
Seat 8: komarkoff ($2.02 in chips) 
Seat 9: VOLOOOODYA ($7.98 in chips) 
Redvin33: posts small blind $0.01
serg197211: posts big blind $0.02
*** HOLE CARDS ***
Dealt to Redvin33 [Js 6h]
Mùúh 22: raises $0.05 to $0.07
robertomuc: folds 
ArgusLL: folds 
SandroVM: folds 
komarkoff: folds 
VOLOOOODYA: folds 
Artem23Ka: folds 
Redvin33: folds 
serg197211: folds 
Uncalled bet ($0.05) returned to Mùúh 22
Mùúh 22 collected $0.05 from pot
Mùúh 22: doesn't show hand 
*** SUMMARY ***
Total pot $0.05 | Rake $0 
Seat 1: Artem23Ka (button) folded before Flop (didn't bet)
Seat 2: Redvin33 (small blind) folded before Flop
Seat 3: serg197211 (big blind) folded before Flop
Seat 4: Mùúh 22 collected ($0.05)
Seat 5: robertomuc folded before Flop (didn't bet)
Seat 6: ArgusLL folded before Flop (didn't bet)
Seat 7: SandroVM folded before Flop (didn't bet)
Seat 8: komarkoff folded before Flop (didn't bet)
Seat 9: VOLOOOODYA folded before Flop (didn't bet)



PokerStars Zoom Hand #172695883565:  Hold'em No Limit ($0.01/$0.02) - 2017/07/06 18:09:41 ET
Table 'McNaught' 9-max Seat #1 is the button
Seat 1: Redvin33 ($1.14 in chips) 
Seat 2: NJoy2Win ($5.29 in chips) 
Seat 3: nightspeaker ($2.04 in chips) 
Seat 4: babaevv0 ($1.26 in chips) 
Seat 5: Gamer577 ($2.20 in chips) 
Seat 6: FidgetyWins ($2.02 in chips) 
Seat 7: Cayoosh16 ($1.91 in chips) 
Seat 8: ta5090 ($2 in chips) 
Seat 9: komarkoff ($2.29 in chips) 
NJoy2Win: posts small blind $0.01
nightspeaker: posts big blind $0.02
*** HOLE CARDS ***
Dealt to Redvin33 [Qc Td]
babaevv0: folds 
Gamer577: folds 
FidgetyWins: folds 
Cayoosh16: folds 
ta5090: raises $0.04 to $0.06
komarkoff: folds 
Redvin33: folds 
NJoy2Win: folds 
nightspeaker: raises $0.14 to $0.20
ta5090: folds 
Uncalled bet ($0.14) returned to nightspeaker
nightspeaker collected $0.13 from pot
nightspeaker: doesn't show hand 
*** SUMMARY ***
Total pot $0.13 | Rake $0 
Seat 1: Redvin33 (button) folded before Flop (didn't bet)
Seat 2: NJoy2Win (small blind) folded before Flop
Seat 3: nightspeaker (big blind) collected ($0.13)
Seat 4: babaevv0 folded before Flop (didn't bet)
Seat 5: Gamer577 folded before Flop (didn't bet)
Seat 6: FidgetyWins folded before Flop (didn't bet)
Seat 7: Cayoosh16 folded before Flop (didn't bet)
Seat 8: ta5090 folded before Flop
Seat 9: komarkoff folded before Flop (didn't bet)



PokerStars Zoom Hand #172695876512:  Hold'em No Limit ($0.01/$0.02) - 2017/07/06 18:09:31 ET
Table 'McNaught' 9-max Seat #1 is the button
Seat 1: Thesmos ($1.05 in chips) 
Seat 2: vanBrog ($0.98 in chips) 
Seat 3: Redvin33 ($1.16 in chips) 
Seat 4: bicho1040 ($4.31 in chips) 
Seat 5: Unconform ($2 in chips) 
Seat 6: MsGriss ($1.79 in chips) 
Seat 7: denzell574 ($2.78 in chips) 
Seat 8: YOHONSON ($2.52 in chips) 
Seat 9: Nikoro309 ($2 in chips) 
vanBrog: posts small blind $0.01
Redvin33: posts big blind $0.02
*** HOLE CARDS ***
Dealt to Redvin33 [Kh 9d]
bicho1040: folds 
Unconform: raises $0.04 to $0.06
MsGriss: folds 
denzell574: folds 
YOHONSON: raises $0.10 to $0.16
Nikoro309: folds 
Thesmos: folds 
vanBrog: folds 
Redvin33: folds 
Unconform: calls $0.10
*** FLOP *** [4h Qd 9s]
Unconform: checks 
YOHONSON: bets $0.19
Unconform: folds 
Uncalled bet ($0.19) returned to YOHONSON
YOHONSON collected $0.34 from pot
YOHONSON: doesn't show hand 
*** SUMMARY ***
Total pot $0.35 | Rake $0.01 
Board [4h Qd 9s]
Seat 1: Thesmos (button) folded before Flop (didn't bet)
Seat 2: vanBrog (small blind) folded before Flop
Seat 3: Redvin33 (big blind) folded before Flop
Seat 4: bicho1040 folded before Flop (didn't bet)
Seat 5: Unconform folded on the Flop
Seat 6: MsGriss folded before Flop (didn't bet)
Seat 7: denzell574 folded before Flop (didn't bet)
Seat 8: YOHONSON collected ($0.34)
Seat 9: Nikoro309 folded before Flop (didn't bet)



PokerStars Zoom Hand #172695903660:  Hold'em No Limit ($0.01/$0.02) - 2017/07/06 18:10:09 ET
Table 'McNaught' 9-max Seat #1 is the button
Seat 1: Manu171077 ($0.23 in chips) 
Seat 2: delete333 ($5.29 in chips) 
Seat 3: alexpolevaja ($2.09 in chips) 
Seat 4: ntr2xit ($2.22 in chips) 
Seat 5: Luiz_Futeco ($0.30 in chips) 
Seat 6: smopuim ($2.60 in chips) 
Seat 7: Artem23Ka ($4.28 in chips) 
Seat 8: Redvin33 ($1.14 in chips) 
Seat 9: serg197211 ($2.47 in chips) 
delete333: posts small blind $0.01
alexpolevaja: posts big blind $0.02
*** HOLE CARDS ***
Dealt to Redvin33 [3h 4s]
ntr2xit: folds 
Luiz_Futeco: folds 
smopuim: folds 
Artem23Ka: folds 
Redvin33: folds 
serg197211: folds 
Manu171077: folds 
delete333: folds 
Uncalled bet ($0.01) returned to alexpolevaja
alexpolevaja collected $0.02 from pot
alexpolevaja: doesn't show hand 
*** SUMMARY ***
Total pot $0.02 | Rake $0 
Seat 1: Manu171077 (button) folded before Flop (didn't bet)
Seat 2: delete333 (small blind) folded before Flop
Seat 3: alexpolevaja (big blind) collected ($0.02)
Seat 4: ntr2xit folded before Flop (didn't bet)
Seat 5: Luiz_Futeco folded before Flop (didn't bet)
Seat 6: smopuim folded before Flop (didn't bet)
Seat 7: Artem23Ka folded before Flop (didn't bet)
Seat 8: Redvin33 folded before Flop (didn't bet)
Seat 9: serg197211 folded before Flop (didn't bet)



PokerStars Zoom Hand #172695900819:  Hold'em No Limit ($0.01/$0.02) - 2017/07/06 18:10:05 ET
Table 'McNaught' 9-max Seat #1 is the button
Seat 1: Cadderly1 ($5.06 in chips) 
Seat 2: Sympathya ($2.73 in chips) 
Seat 3: manowar7771 ($1.51 in chips) 
Seat 4: Haczlo ($5.18 in chips) 
Seat 5: COULEUR7 ($2.03 in chips) 
Seat 6: SandroVM ($1.85 in chips) 
Seat 7: Redvin33 ($1.14 in chips) 
Seat 8: patron5hot ($4.65 in chips) 
Seat 9: Taraba68 ($1.90 in chips) 
Sympathya: posts small blind $0.01
manowar7771: posts big blind $0.02
*** HOLE CARDS ***
Dealt to Redvin33 [7d 3s]
Haczlo: folds 
COULEUR7: folds 
SandroVM: folds 
Redvin33: folds 
patron5hot: folds 
Taraba68: folds 
Cadderly1: raises $0.03 to $0.05
Sympathya: folds 
manowar7771: folds 
Uncalled bet ($0.03) returned to Cadderly1
Cadderly1 collected $0.05 from pot
Cadderly1: doesn't show hand 
*** SUMMARY ***
Total pot $0.05 | Rake $0 
Seat 1: Cadderly1 (button) collected ($0.05)
Seat 2: Sympathya (small blind) folded before Flop
Seat 3: manowar7771 (big blind) folded before Flop
Seat 4: Haczlo folded before Flop (didn't bet)
Seat 5: COULEUR7 folded before Flop (didn't bet)
Seat 6: SandroVM folded before Flop (didn't bet)
Seat 7: Redvin33 folded before Flop (didn't bet)
Seat 8: patron5hot folded before Flop (didn't bet)
Seat 9: Taraba68 folded before Flop (didn't bet)



PokerStars Zoom Hand #172695917694:  Hold'em No Limit ($0.01/$0.02) - 2017/07/06 18:10:29 ET
Table 'McNaught' 9-max Seat #1 is the button
Seat 1: Mùúh 22 ($2.94 in chips) 
Seat 2: Alex75stv ($1.80 in chips) 
Seat 3: Artem23Ka ($5.14 in chips) 
Seat 4: filipov1976 ($3.99 in chips) 
Seat 5: Redvin33 ($1.14 in chips) 
Seat 6: mrmeshuggah ($0.58 in chips) 
Seat 7: jokkers_br ($3.52 in chips) 
Seat 8: delete333 ($2 in chips) 
Seat 9: manowar7771 ($1.88 in chips) 
Alex75stv: posts small blind $0.01
Artem23Ka: posts big blind $0.02
*** HOLE CARDS ***
Dealt to Redvin33 [Tc 7s]
filipov1976: folds 
Redvin33: folds 
mrmeshuggah: folds 
jokkers_br: folds 
delete333: folds 
manowar7771: folds 
Mùúh 22: folds 
Alex75stv: folds 
Uncalled bet ($0.01) returned to Artem23Ka
Artem23Ka collected $0.02 from pot
Artem23Ka: doesn't show hand 
*** SUMMARY ***
Total pot $0.02 | Rake $0 
Seat 1: Mùúh 22 (button) folded before Flop (didn't bet)
Seat 2: Alex75stv (small blind) folded before Flop
Seat 3: Artem23Ka (big blind) collected ($0.02)
Seat 4: filipov1976 folded before Flop (didn't bet)
Seat 5: Redvin33 folded before Flop (didn't bet)
Seat 6: mrmeshuggah folded before Flop (didn't bet)
Seat 7: jokkers_br folded before Flop (didn't bet)
Seat 8: delete333 folded before Flop (didn't bet)
Seat 9: manowar7771 folded before Flop (didn't bet)



PokerStars Zoom Hand #172695919837:  Hold'em No Limit ($0.01/$0.02) - 2017/07/06 18:10:32 ET
Table 'McNaught' 9-max Seat #1 is the button
Seat 1: PANA]ASS ($5.56 in chips) 
Seat 2: qualifire ($2.07 in chips) 
Seat 3: Redvin33 ($1.14 in chips) 
Seat 4: Fr0l0FF ($5.49 in chips) 
Seat 5: goku1212 ($0.91 in chips) 
Seat 6: VOLOOOODYA ($2.31 in chips) 
Seat 7: Taraba68 ($1.81 in chips) 
Seat 8: denzell574 ($2.75 in chips) 
Seat 9: Gorwfwefwed ($3.94 in chips) 
qualifire: posts small blind $0.01
Redvin33: posts big blind $0.02
*** HOLE CARDS ***
Dealt to Redvin33 [8s 7s]
Fr0l0FF: folds 
goku1212: folds 
VOLOOOODYA: folds 
Taraba68: folds 
denzell574: folds 
Gorwfwefwed: folds 
PANA]ASS: folds 
qualifire: folds 
Uncalled bet ($0.01) returned to Redvin33
Redvin33 collected $0.02 from pot
Redvin33: doesn't show hand 
*** SUMMARY ***
Total pot $0.02 | Rake $0 
Seat 1: PANA]ASS (button) folded before Flop (didn't bet)
Seat 2: qualifire (small blind) folded before Flop
Seat 3: Redvin33 (big blind) collected ($0.02)
Seat 4: Fr0l0FF folded before Flop (didn't bet)
Seat 5: goku1212 folded before Flop (didn't bet)
Seat 6: VOLOOOODYA folded before Flop (didn't bet)
Seat 7: Taraba68 folded before Flop (didn't bet)
Seat 8: denzell574 folded before Flop (didn't bet)
Seat 9: Gorwfwefwed folded before Flop (didn't bet)



PokerStars Zoom Hand #172695907047:  Hold'em No Limit ($0.01/$0.02) - 2017/07/06 18:10:14 ET
Table 'McNaught' 9-max Seat #1 is the button
Seat 1: Brucechiou ($2.16 in chips) 
Seat 2: jokkers_br ($3.53 in chips) 
Seat 3: Moltyaninov ($2 in chips) 
Seat 4: Allekccc ($8.64 in chips) 
Seat 5: Xamil666 ($3.70 in chips) 
Seat 6: Redvin33 ($1.14 in chips) 
Seat 7: Spengi84 ($2.03 in chips) 
Seat 8: serg197211 ($2.47 in chips) 
Seat 9: Pokurov ($2.49 in chips) 
jokkers_br: posts small blind $0.01
Moltyaninov: posts big blind $0.02
*** HOLE CARDS ***
Dealt to Redvin33 [Th 8h]
Allekccc: folds 
Xamil666: folds 
Redvin33: folds 
Spengi84: folds 
serg197211: folds 
Pokurov: folds 
Brucechiou: folds 
jokkers_br: folds 
Uncalled bet ($0.01) returned to Moltyaninov
Moltyaninov collected $0.02 from pot
Moltyaninov: doesn't show hand 
*** SUMMARY ***
Total pot $0.02 | Rake $0 
Seat 1: Brucechiou (button) folded before Flop (didn't bet)
Seat 2: jokkers_br (small blind) folded before Flop
Seat 3: Moltyaninov (big blind) collected ($0.02)
Seat 4: Allekccc folded before Flop (didn't bet)
Seat 5: Xamil666 folded before Flop (didn't bet)
Seat 6: Redvin33 folded before Flop (didn't bet)
Seat 7: Spengi84 folded before Flop (didn't bet)
Seat 8: serg197211 folded before Flop (didn't bet)
Seat 9: Pokurov folded before Flop (didn't bet)



PokerStars Zoom Hand #172695909848:  Hold'em No Limit ($0.01/$0.02) - 2017/07/06 18:10:18 ET
Table 'McNaught' 9-max Seat #1 is the button
Seat 1: christina 1989 ($2.92 in chips) 
Seat 2: Trini Garcia ($1.14 in chips) 
Seat 3: DiNiceBoy ($2 in chips) 
Seat 4: Cayoosh16 ($1.91 in chips) 
Seat 5: Redvin33 ($1.14 in chips) 
Seat 6: Mùúh 22 ($2.06 in chips) 
Seat 7: grave_17 ($2.19 in chips) 
Seat 8: colmcc ($1.94 in chips) 
Seat 9: SUPERCARLAO ($5.93 in chips) 
Trini Garcia: posts small blind $0.01
DiNiceBoy: posts big blind $0.02
*** HOLE CARDS ***
Dealt to Redvin33 [7d Kd]
Cayoosh16: folds 
Redvin33: folds 
Mùúh 22: folds 
grave_17: folds 
colmcc: folds 
SUPERCARLAO: folds 
christina 1989: folds 
Trini Garcia: folds 
Uncalled bet ($0.01) returned to DiNiceBoy
DiNiceBoy collected $0.02 from pot
DiNiceBoy: doesn't show hand 
*** SUMMARY ***
Total pot $0.02 | Rake $0 
Seat 1: christina 1989 (button) folded before Flop (didn't bet)
Seat 2: Trini Garcia (small blind) folded before Flop
Seat 3: DiNiceBoy (big blind) collected ($0.02)
Seat 4: Cayoosh16 folded before Flop (didn't bet)
Seat 5: Redvin33 folded before Flop (didn't bet)
Seat 6: Mùúh 22 folded before Flop (didn't bet)
Seat 7: grave_17 folded before Flop (didn't bet)
Seat 8: colmcc folded before Flop (didn't bet)
Seat 9: SUPERCARLAO folded before Flop (didn't bet)



PokerStars Zoom Hand #172695887925:  Hold'em No Limit ($0.01/$0.02) - 2017/07/06 18:09:47 ET
Table 'McNaught' 9-max Seat #1 is the button
Seat 1: Cayoosh16 ($1.91 in chips) 
Seat 2: didier.rouss ($1.64 in chips) 
Seat 3: Gamer577 ($2 in chips) 
Seat 4: serg197211 ($2.48 in chips) 
Seat 5: PANA]ASS ($2.64 in chips) 
Seat 6: Guille1O_O ($2.98 in chips) 
Seat 7: Artem23Ka ($4.68 in chips) 
Seat 8: Lionvodoo ($2 in chips) 
Seat 9: Redvin33 ($1.14 in chips) 
didier.rouss: posts small blind $0.01
Gamer577: posts big blind $0.02
*** HOLE CARDS ***
Dealt to Redvin33 [Ah 5d]
serg197211: folds 
PANA]ASS: raises $0.06 to $0.08
Guille1O_O: folds 
Artem23Ka: folds 
Lionvodoo: folds 
Redvin33: folds 
Cayoosh16: folds 
didier.rouss: raises $0.08 to $0.16
Gamer577: folds 
PANA]ASS: calls $0.08
*** FLOP *** [Td Ts 4h]
didier.rouss: checks 
PANA]ASS: checks 
*** TURN *** [Td Ts 4h] [9s]
didier.rouss: bets $0.10
PANA]ASS: calls $0.10
*** RIVER *** [Td Ts 4h 9s] [9h]
didier.rouss: bets $0.18
PANA]ASS: calls $0.18
*** SHOW DOWN ***
didier.rouss: shows [Th Qc] (a full house, Tens full of Nines)
PANA]ASS: mucks hand 
didier.rouss collected $0.87 from pot
*** SUMMARY ***
Total pot $0.90 | Rake $0.03 
Board [Td Ts 4h 9s 9h]
Seat 1: Cayoosh16 (button) folded before Flop (didn't bet)
Seat 2: didier.rouss (small blind) showed [Th Qc] and won ($0.87) with a full house, Tens full of Nines
Seat 3: Gamer577 (big blind) folded before Flop
Seat 4: serg197211 folded before Flop (didn't bet)
Seat 5: PANA]ASS mucked [As Js]
Seat 6: Guille1O_O folded before Flop (didn't bet)
Seat 7: Artem23Ka folded before Flop (didn't bet)
Seat 8: Lionvodoo folded before Flop (didn't bet)
Seat 9: Redvin33 folded before Flop (didn't bet)



PokerStars Zoom Hand #172695928255:  Hold'em No Limit ($0.01/$0.02) - 2017/07/06 18:10:44 ET
Table 'McNaught' 9-max Seat #1 is the button
Seat 1: W1zard2008 ($2 in chips) 
Seat 2: Taraba68 ($2.02 in chips) 
Seat 3: Artem23Ka ($4.66 in chips) 
Seat 4: Redvin33 ($1.15 in chips) 
Seat 5: TheCoelhao ($2.04 in chips) 
Seat 6: Sympathya ($2.72 in chips) 
Seat 7: delete333 ($2 in chips) 
Seat 8: babka.ru ($2.78 in chips) 
Seat 9: serg197211 ($2.15 in chips) 
Taraba68: posts small blind $0.01
Artem23Ka: posts big blind $0.02
*** HOLE CARDS ***
Dealt to Redvin33 [Kc Kd]
Redvin33: raises $0.03 to $0.05
TheCoelhao: folds 
Sympathya: folds 
delete333: folds 
babka.ru: folds 
serg197211: folds 
W1zard2008: folds 
Taraba68: folds 
Artem23Ka: calls $0.03
*** FLOP *** [2s 8d 2d]
Artem23Ka: checks 
Redvin33: bets $0.04
Artem23Ka: raises $0.08 to $0.12
Redvin33: raises $0.12 to $0.24
Artem23Ka: raises $4.37 to $4.61 and is all-in
Redvin33: calls $0.86 and is all-in
Uncalled bet ($3.51) returned to Artem23Ka
*** TURN *** [2s 8d 2d] [3s]
*** RIVER *** [2s 8d 2d 3s] [Ks]
*** SHOW DOWN ***
Artem23Ka: shows [7s 7h] (two pair, Sevens and Deuces)
Redvin33: shows [Kc Kd] (a full house, Kings full of Deuces)
Redvin33 collected $2.23 from pot
*** SUMMARY ***
Total pot $2.31 | Rake $0.08 
Board [2s 8d 2d 3s Ks]
Seat 1: W1zard2008 (button) folded before Flop (didn't bet)
Seat 2: Taraba68 (small blind) folded before Flop
Seat 3: Artem23Ka (big blind) showed [7s 7h] and lost with two pair, Sevens and Deuces
Seat 4: Redvin33 showed [Kc Kd] and won ($2.23) with a full house, Kings full of Deuces
Seat 5: TheCoelhao folded before Flop (didn't bet)
Seat 6: Sympathya folded before Flop (didn't bet)
Seat 7: delete333 folded before Flop (didn't bet)
Seat 8: babka.ru folded before Flop (didn't bet)
Seat 9: serg197211 folded before Flop (didn't bet)



PokerStars Zoom Hand #172695975668:  Hold'em No Limit ($0.01/$0.02) - 2017/07/06 18:11:51 ET
Table 'McNaught' 9-max Seat #1 is the button
Seat 1: Moltyaninov ($2 in chips) 
Seat 2: WolcharaAP ($4.10 in chips) 
Seat 3: 3thirteen616 ($2.02 in chips) 
Seat 4: SandroVM ($1.98 in chips) 
Seat 5: Unconform ($2.05 in chips) 
Seat 6: ArgusLL ($4.42 in chips) 
Seat 7: solyom217 ($2.08 in chips) 
Seat 8: yayadub ($1.94 in chips) 
Seat 9: Redvin33 ($2.22 in chips) 
WolcharaAP: posts small blind $0.01
3thirteen616: posts big blind $0.02
*** HOLE CARDS ***
Dealt to Redvin33 [Qh 7d]
SandroVM: folds 
Unconform: folds 
ArgusLL: folds 
solyom217: folds 
yayadub: raises $0.04 to $0.06
Redvin33: folds 
Moltyaninov: folds 
WolcharaAP: folds 
3thirteen616: folds 
Uncalled bet ($0.04) returned to yayadub
yayadub collected $0.05 from pot
yayadub: doesn't show hand 
*** SUMMARY ***
Total pot $0.05 | Rake $0 
Seat 1: Moltyaninov (button) folded before Flop (didn't bet)
Seat 2: WolcharaAP (small blind) folded before Flop
Seat 3: 3thirteen616 (big blind) folded before Flop
Seat 4: SandroVM folded before Flop (didn't bet)
Seat 5: Unconform folded before Flop (didn't bet)
Seat 6: ArgusLL folded before Flop (didn't bet)
Seat 7: solyom217 folded before Flop (didn't bet)
Seat 8: yayadub collected ($0.05)
Seat 9: Redvin33 folded before Flop (didn't bet)



PokerStars Zoom Hand #172695972862:  Hold'em No Limit ($0.01/$0.02) - 2017/07/06 18:11:47 ET
Table 'McNaught' 9-max Seat #1 is the button
Seat 1: FidgetyWins ($2.22 in chips) 
Seat 2: Redvin33 ($2.23 in chips) 
Seat 3: Fr0l0FF ($5.44 in chips) 
Seat 4: Sympathya ($2.09 in chips) 
Seat 5: vandenhorst ($3.15 in chips) 
Seat 6: Artem23Ka ($3.51 in chips) 
Seat 7: SUPERCARLAO ($5.85 in chips) 
Seat 8: 3thirteen616 ($2.02 in chips) 
Seat 9: Rishnu Fr ($2.12 in chips) 
Redvin33: posts small blind $0.01
Fr0l0FF: posts big blind $0.02
*** HOLE CARDS ***
Dealt to Redvin33 [4d 5h]
Sympathya: raises $0.03 to $0.05
vandenhorst: folds 
Artem23Ka: folds 
SUPERCARLAO: folds 
3thirteen616: folds 
Rishnu Fr: folds 
FidgetyWins: folds 
Redvin33: folds 
Fr0l0FF: folds 
Uncalled bet ($0.03) returned to Sympathya
Sympathya collected $0.05 from pot
Sympathya: doesn't show hand 
*** SUMMARY ***
Total pot $0.05 | Rake $0 
Seat 1: FidgetyWins (button) folded before Flop (didn't bet)
Seat 2: Redvin33 (small blind) folded before Flop
Seat 3: Fr0l0FF (big blind) folded before Flop
Seat 4: Sympathya collected ($0.05)
Seat 5: vandenhorst folded before Flop (didn't bet)
Seat 6: Artem23Ka folded before Flop (didn't bet)
Seat 7: SUPERCARLAO folded before Flop (didn't bet)
Seat 8: 3thirteen616 folded before Flop (didn't bet)
Seat 9: Rishnu Fr folded before Flop (didn't bet)



PokerStars Zoom Hand #172695978511:  Hold'em No Limit ($0.01/$0.02) - 2017/07/06 18:11:55 ET
Table 'McNaught' 9-max Seat #1 is the button
Seat 1: Redvin33 ($2.22 in chips) 
Seat 2: ArthurStk ($1.39 in chips) 
Seat 3: solyom217 ($2.08 in chips) 
Seat 4: jacrsjsm ($0.83 in chips) 
Seat 5: Zoddoss ($2.15 in chips) 
Seat 6: kidninja888 ($3.56 in chips) 
Seat 7: REISR18 ($13.10 in chips) 
Seat 8: Rishnu Fr ($2.12 in chips) 
Seat 9: mercurio0359 ($1.27 in chips) 
ArthurStk: posts small blind $0.01
solyom217: posts big blind $0.02
*** HOLE CARDS ***
Dealt to Redvin33 [9c As]
jacrsjsm: calls $0.02
Zoddoss: folds 
kidninja888: folds 
REISR18: folds 
Rishnu Fr: folds 
mercurio0359: folds 
Redvin33: raises $0.03 to $0.05
ArthurStk: folds 
solyom217: folds 
jacrsjsm: calls $0.03
*** FLOP *** [Th Kd 2s]
jacrsjsm: checks 
Redvin33: checks 
*** TURN *** [Th Kd 2s] [Jd]
jacrsjsm: checks 
Redvin33: bets $0.04
jacrsjsm: folds 
Uncalled bet ($0.04) returned to Redvin33
Redvin33 collected $0.13 from pot
Redvin33: doesn't show hand 
*** SUMMARY ***
Total pot $0.13 | Rake $0 
Board [Th Kd 2s Jd]
Seat 1: Redvin33 (button) collected ($0.13)
Seat 2: ArthurStk (small blind) folded before Flop
Seat 3: solyom217 (big blind) folded before Flop
Seat 4: jacrsjsm folded on the Turn
Seat 5: Zoddoss folded before Flop (didn't bet)
Seat 6: kidninja888 folded before Flop (didn't bet)
Seat 7: REISR18 folded before Flop (didn't bet)
Seat 8: Rishnu Fr folded before Flop (didn't bet)
Seat 9: mercurio0359 folded before Flop (didn't bet)



PokerStars Zoom Hand #172696003319:  Hold'em No Limit ($0.01/$0.02) - 2017/07/06 18:12:30 ET
Table 'McNaught' 9-max Seat #1 is the button
Seat 1: kidninja888 ($3.32 in chips) 
Seat 2: kwatas kef ($4.87 in chips) 
Seat 3: soldat871501 ($0.70 in chips) 
Seat 4: Haczlo ($2.75 in chips) 
Seat 5: Xamil666 ($4.31 in chips) 
Seat 6: SweetPlay777 ($1.98 in chips) 
Seat 7: Redvin33 ($2.30 in chips) 
Seat 8: Lalla of 221 ($2 in chips) 
Seat 9: Gorwfwefwed ($3.85 in chips) 
kwatas kef: posts small blind $0.01
soldat871501: posts big blind $0.02
*** HOLE CARDS ***
Dealt to Redvin33 [Qh Ad]
Haczlo: folds 
Xamil666: folds 
SweetPlay777: folds 
Redvin33: raises $0.03 to $0.05
Lalla of 221: folds 
Gorwfwefwed: folds 
kidninja888: folds 
kwatas kef: raises $0.03 to $0.08
soldat871501: calls $0.06
Redvin33: calls $0.03
*** FLOP *** [2s 7s Jc]
kwatas kef: bets $0.23
soldat871501: folds 
Redvin33: folds 
Uncalled bet ($0.23) returned to kwatas kef
kwatas kef collected $0.23 from pot
kwatas kef: doesn't show hand 
*** SUMMARY ***
Total pot $0.24 | Rake $0.01 
Board [2s 7s Jc]
Seat 1: kidninja888 (button) folded before Flop (didn't bet)
Seat 2: kwatas kef (small blind) collected ($0.23)
Seat 3: soldat871501 (big blind) folded on the Flop
Seat 4: Haczlo folded before Flop (didn't bet)
Seat 5: Xamil666 folded before Flop (didn't bet)
Seat 6: SweetPlay777 folded before Flop (didn't bet)
Seat 7: Redvin33 folded on the Flop
Seat 8: Lalla of 221 folded before Flop (didn't bet)
Seat 9: Gorwfwefwed folded before Flop (didn't bet)



PokerStars Zoom Hand #172696031533:  Hold'em No Limit ($0.01/$0.02) - 2017/07/06 18:13:10 ET
Table 'McNaught' 9-max Seat #1 is the button
Seat 1: Gamer577 ($4.82 in chips) 
Seat 2: Mùúh 22 ($2.38 in chips) 
Seat 3: Redvin33 ($2.22 in chips) 
Seat 4: jacrsjsm ($0.75 in chips) 
Seat 5: vandenhorst ($3.03 in chips) 
Seat 6: Bugiel ($3.33 in chips) 
Seat 7: Lifecards7 ($2.19 in chips) 
Seat 8: smopuim ($2.60 in chips) 
Seat 9: kidninja888 ($3.31 in chips) 
Mùúh 22: posts small blind $0.01
Redvin33: posts big blind $0.02
*** HOLE CARDS ***
Dealt to Redvin33 [9h Kd]
jacrsjsm: calls $0.02
vandenhorst: folds 
Bugiel: folds 
Lifecards7: folds 
smopuim: folds 
kidninja888: folds 
Gamer577: folds 
Mùúh 22: folds 
Redvin33: raises $0.04 to $0.06
jacrsjsm: calls $0.04
*** FLOP *** [5c Th 2c]
Redvin33: checks 
jacrsjsm: bets $0.13
Redvin33: folds 
Uncalled bet ($0.13) returned to jacrsjsm
jacrsjsm collected $0.13 from pot
jacrsjsm: doesn't show hand 
*** SUMMARY ***
Total pot $0.13 | Rake $0 
Board [5c Th 2c]
Seat 1: Gamer577 (button) folded before Flop (didn't bet)
Seat 2: Mùúh 22 (small blind) folded before Flop
Seat 3: Redvin33 (big blind) folded on the Flop
Seat 4: jacrsjsm collected ($0.13)
Seat 5: vandenhorst folded before Flop (didn't bet)
Seat 6: Bugiel folded before Flop (didn't bet)
Seat 7: Lifecards7 folded before Flop (didn't bet)
Seat 8: smopuim folded before Flop (didn't bet)
Seat 9: kidninja888 folded before Flop (didn't bet)



PokerStars Zoom Hand #172696028735:  Hold'em No Limit ($0.01/$0.02) - 2017/07/06 18:13:06 ET
Table 'McNaught' 9-max Seat #1 is the button
Seat 1: Rishnu Fr ($2 in chips) 
Seat 2: filipov1976 ($3.96 in chips) 
Seat 3: lion.1st ($2 in chips) 
Seat 4: kidninja888 ($3.31 in chips) 
Seat 5: z0p12000 ($0.85 in chips) 
Seat 6: Artem23Ka ($2.32 in chips) 
Seat 7: ntr2xit ($2 in chips) 
Seat 8: Redvin33 ($2.22 in chips) 
Seat 9: colmcc ($1.89 in chips) 
filipov1976: posts small blind $0.01
lion.1st: posts big blind $0.02
*** HOLE CARDS ***
Dealt to Redvin33 [8d 9h]
kidninja888: folds 
z0p12000: folds 
Artem23Ka: folds 
ntr2xit: raises $0.04 to $0.06
Redvin33: folds 
colmcc: folds 
Rishnu Fr: folds 
filipov1976: folds 
lion.1st: calls $0.04
*** FLOP *** [Jc 8s Th]
lion.1st: checks 
ntr2xit: bets $0.09
lion.1st: calls $0.09
*** TURN *** [Jc 8s Th] [Kh]
lion.1st: checks 
ntr2xit: bets $0.19
lion.1st: calls $0.19
*** RIVER *** [Jc 8s Th Kh] [7s]
lion.1st: checks 
ntr2xit: checks 
*** SHOW DOWN ***
lion.1st: shows [Tc Kc] (two pair, Kings and Tens)
ntr2xit: mucks hand 
lion.1st collected $0.67 from pot
*** SUMMARY ***
Total pot $0.69 | Rake $0.02 
Board [Jc 8s Th Kh 7s]
Seat 1: Rishnu Fr (button) folded before Flop (didn't bet)
Seat 2: filipov1976 (small blind) folded before Flop
Seat 3: lion.1st (big blind) showed [Tc Kc] and won ($0.67) with two pair, Kings and Tens
Seat 4: kidninja888 folded before Flop (didn't bet)
Seat 5: z0p12000 folded before Flop (didn't bet)
Seat 6: Artem23Ka folded before Flop (didn't bet)
Seat 7: ntr2xit mucked [Ks As]
Seat 8: Redvin33 folded before Flop (didn't bet)
Seat 9: colmcc folded before Flop (didn't bet)



PokerStars Zoom Hand #172696053314:  Hold'em No Limit ($0.01/$0.02) - 2017/07/06 18:13:41 ET
Table 'McNaught' 9-max Seat #1 is the button
Seat 1: rubino_nick ($2.27 in chips) 
Seat 2: djfloss7 ($2.31 in chips) 
Seat 3: PANA]ASS ($2.17 in chips) 
Seat 4: filipov1976 ($7.29 in chips) 
Seat 5: Piperka777 ($3.08 in chips) 
Seat 6: stel73 ($2.10 in chips) 
Seat 7: COULEUR7 ($2.03 in chips) 
Seat 8: batiraki13 ($2 in chips) 
Seat 9: Redvin33 ($2.16 in chips) 
djfloss7: posts small blind $0.01
PANA]ASS: posts big blind $0.02
*** HOLE CARDS ***
Dealt to Redvin33 [3h 2s]
filipov1976: folds 
Piperka777: folds 
stel73: raises $0.03 to $0.05
COULEUR7: folds 
batiraki13: folds 
Redvin33: folds 
rubino_nick: folds 
djfloss7: folds 
PANA]ASS: folds 
Uncalled bet ($0.03) returned to stel73
stel73 collected $0.05 from pot
stel73: doesn't show hand 
*** SUMMARY ***
Total pot $0.05 | Rake $0 
Seat 1: rubino_nick (button) folded before Flop (didn't bet)
Seat 2: djfloss7 (small blind) folded before Flop
Seat 3: PANA]ASS (big blind) folded before Flop
Seat 4: filipov1976 folded before Flop (didn't bet)
Seat 5: Piperka777 folded before Flop (didn't bet)
Seat 6: stel73 collected ($0.05)
Seat 7: COULEUR7 folded before Flop (didn't bet)
Seat 8: batiraki13 folded before Flop (didn't bet)
Seat 9: Redvin33 folded before Flop (didn't bet)



PokerStars Zoom Hand #172696050452:  Hold'em No Limit ($0.01/$0.02) - 2017/07/06 18:13:37 ET
Table 'McNaught' 9-max Seat #1 is the button
Seat 1: @romario42@ ($2.86 in chips) 
Seat 2: Xamil666 ($3 in chips) 
Seat 3: E-Berta ($0.80 in chips) 
Seat 4: bwellsAA ($1.92 in chips) 
Seat 5: Redvin33 ($2.16 in chips) 
Seat 6: patron5hot ($4.89 in chips) 
Seat 7: naoya1929 ($2.03 in chips) 
Seat 8: Cayoosh16 ($1.66 in chips) 
Seat 9: yaralizeth ($2.86 in chips) 
Xamil666: posts small blind $0.01
E-Berta: posts big blind $0.02
*** HOLE CARDS ***
Dealt to Redvin33 [3h 6h]
bwellsAA: folds 
Redvin33: folds 
patron5hot: folds 
naoya1929: folds 
Cayoosh16: folds 
yaralizeth: folds 
@romario42@: calls $0.02
Xamil666: folds 
E-Berta: checks 
*** FLOP *** [2h Jc 3c]
E-Berta: bets $0.06
@romario42@: folds 
Uncalled bet ($0.06) returned to E-Berta
E-Berta collected $0.05 from pot
E-Berta: doesn't show hand 
*** SUMMARY ***
Total pot $0.05 | Rake $0 
Board [2h Jc 3c]
Seat 1: @romario42@ (button) folded on the Flop
Seat 2: Xamil666 (small blind) folded before Flop
Seat 3: E-Berta (big blind) collected ($0.05)
Seat 4: bwellsAA folded before Flop (didn't bet)
Seat 5: Redvin33 folded before Flop (didn't bet)
Seat 6: patron5hot folded before Flop (didn't bet)
Seat 7: naoya1929 folded before Flop (didn't bet)
Seat 8: Cayoosh16 folded before Flop (didn't bet)
Seat 9: yaralizeth folded before Flop (didn't bet)



PokerStars Zoom Hand #172696056052:  Hold'em No Limit ($0.01/$0.02) - 2017/07/06 18:13:45 ET
Table 'McNaught' 9-max Seat #1 is the button
Seat 1: Piperka777 ($3.08 in chips) 
Seat 2: Redvin33 ($2.16 in chips) 
Seat 3: nicolasriver ($1.91 in chips) 
Seat 4: bellamia26 ($7.24 in chips) 
Seat 5: ArgusLL ($2 in chips) 
Seat 6: nerml000 ($0.86 in chips) 
Seat 7: Tiswah ($1.73 in chips) 
Seat 8: dmitrychuk ($5.01 in chips) 
Seat 9: djfloss7 ($2.30 in chips) 
Redvin33: posts small blind $0.01
nicolasriver: posts big blind $0.02
*** HOLE CARDS ***
Dealt to Redvin33 [6s 4h]
bellamia26: folds 
ArgusLL: folds 
nerml000: raises $0.02 to $0.04
Tiswah: folds 
dmitrychuk: folds 
djfloss7: folds 
Piperka777: folds 
Redvin33: folds 
nicolasriver: folds 
Uncalled bet ($0.02) returned to nerml000
nerml000 collected $0.05 from pot
nerml000: doesn't show hand 
*** SUMMARY ***
Total pot $0.05 | Rake $0 
Seat 1: Piperka777 (button) folded before Flop (didn't bet)
Seat 2: Redvin33 (small blind) folded before Flop
Seat 3: nicolasriver (big blind) folded before Flop
Seat 4: bellamia26 folded before Flop (didn't bet)
Seat 5: ArgusLL folded before Flop (didn't bet)
Seat 6: nerml000 collected ($0.05)
Seat 7: Tiswah folded before Flop (didn't bet)
Seat 8: dmitrychuk folded before Flop (didn't bet)
Seat 9: djfloss7 folded before Flop (didn't bet)



PokerStars Zoom Hand #172696047671:  Hold'em No Limit ($0.01/$0.02) - 2017/07/06 18:13:33 ET
Table 'McNaught' 9-max Seat #1 is the button
Seat 1: setair ($1.98 in chips) 
Seat 2: LaZeReXPeRT ($2.16 in chips) 
Seat 3: kidninja888 ($3.31 in chips) 
Seat 4: JJhatesMe ($2.03 in chips) 
Seat 5: Unconform ($2 in chips) 
Seat 6: Redvin33 ($2.16 in chips) 
Seat 7: FidgetyWins ($2.22 in chips) 
Seat 8: SandroVM ($2.02 in chips) 
Seat 9: KaHcTpykTap ($2 in chips) 
LaZeReXPeRT: posts small blind $0.01
kidninja888: posts big blind $0.02
*** HOLE CARDS ***
Dealt to Redvin33 [9h Tc]
JJhatesMe: folds 
Unconform: folds 
Redvin33: folds 
FidgetyWins: folds 
SandroVM: folds 
KaHcTpykTap: folds 
setair: raises $0.02 to $0.04
LaZeReXPeRT: folds 
kidninja888: calls $0.02
*** FLOP *** [Th 5s Kd]
kidninja888: bets $0.09
setair: folds 
Uncalled bet ($0.09) returned to kidninja888
kidninja888 collected $0.09 from pot
kidninja888: doesn't show hand 
*** SUMMARY ***
Total pot $0.09 | Rake $0 
Board [Th 5s Kd]
Seat 1: setair (button) folded on the Flop
Seat 2: LaZeReXPeRT (small blind) folded before Flop
Seat 3: kidninja888 (big blind) collected ($0.09)
Seat 4: JJhatesMe folded before Flop (didn't bet)
Seat 5: Unconform folded before Flop (didn't bet)
Seat 6: Redvin33 folded before Flop (didn't bet)
Seat 7: FidgetyWins folded before Flop (didn't bet)
Seat 8: SandroVM folded before Flop (didn't bet)
Seat 9: KaHcTpykTap folded before Flop (didn't bet)



PokerStars Zoom Hand #172696059571:  Hold'em No Limit ($0.01/$0.02) - 2017/07/06 18:13:50 ET
Table 'McNaught' 9-max Seat #1 is the button
Seat 1: Redvin33 ($2.15 in chips) 
Seat 2: Thesmos ($0.37 in chips) 
Seat 3: Unconform ($2.05 in chips) 
Seat 4: hapu ($8.40 in chips) 
Seat 5: MACJERSON ($1.05 in chips) 
Seat 6: Taraba68 ($2.03 in chips) 
Seat 7: scorpion2680 ($1.09 in chips) 
Seat 8: aleks118 ($3.26 in chips) 
Seat 9: serg197211 ($2 in chips) 
Thesmos: posts small blind $0.01
Unconform: posts big blind $0.02
*** HOLE CARDS ***
Dealt to Redvin33 [Tc 2h]
hapu: folds 
MACJERSON: folds 
Taraba68: folds 
scorpion2680: folds 
aleks118: raises $0.03 to $0.05
serg197211: folds 
Redvin33: folds 
Thesmos: folds 
Unconform: folds 
Uncalled bet ($0.03) returned to aleks118
aleks118 collected $0.05 from pot
aleks118: doesn't show hand 
*** SUMMARY ***
Total pot $0.05 | Rake $0 
Seat 1: Redvin33 (button) folded before Flop (didn't bet)
Seat 2: Thesmos (small blind) folded before Flop
Seat 3: Unconform (big blind) folded before Flop
Seat 4: hapu folded before Flop (didn't bet)
Seat 5: MACJERSON folded before Flop (didn't bet)
Seat 6: Taraba68 folded before Flop (didn't bet)
Seat 7: scorpion2680 folded before Flop (didn't bet)
Seat 8: aleks118 collected ($0.05)
Seat 9: serg197211 folded before Flop (didn't bet)



PokerStars Zoom Hand #172696063102:  Hold'em No Limit ($0.01/$0.02) - 2017/07/06 18:13:55 ET
Table 'McNaught' 9-max Seat #1 is the button
Seat 1: SweetPlay777 ($2.05 in chips) 
Seat 2: JJhatesMe ($2.03 in chips) 
Seat 3: madin683 ($2 in chips) 
Seat 4: smopuim ($2.66 in chips) 
Seat 5: DiNiceBoy ($3.95 in chips) 
Seat 6: Roman 0992 ($2.78 in chips) 
Seat 7: serg197211 ($2.41 in chips) 
Seat 8: Redvin33 ($2.15 in chips) 
Seat 9: COULEUR7 ($2.03 in chips) 
JJhatesMe: posts small blind $0.01
madin683: posts big blind $0.02
*** HOLE CARDS ***
Dealt to Redvin33 [Jc 7s]
smopuim: folds 
DiNiceBoy: folds 
Roman 0992: folds 
serg197211: folds 
Redvin33: folds 
COULEUR7: folds 
SweetPlay777: folds 
JJhatesMe: folds 
Uncalled bet ($0.01) returned to madin683
madin683 collected $0.02 from pot
madin683: doesn't show hand 
*** SUMMARY ***
Total pot $0.02 | Rake $0 
Seat 1: SweetPlay777 (button) folded before Flop (didn't bet)
Seat 2: JJhatesMe (small blind) folded before Flop
Seat 3: madin683 (big blind) collected ($0.02)
Seat 4: smopuim folded before Flop (didn't bet)
Seat 5: DiNiceBoy folded before Flop (didn't bet)
Seat 6: Roman 0992 folded before Flop (didn't bet)
Seat 7: serg197211 folded before Flop (didn't bet)
Seat 8: Redvin33 folded before Flop (didn't bet)
Seat 9: COULEUR7 folded before Flop (didn't bet)



PokerStars Zoom Hand #172696066006:  Hold'em No Limit ($0.01/$0.02) - 2017/07/06 18:13:59 ET
Table 'McNaught' 9-max Seat #1 is the button
Seat 1: scorpion2680 ($1.09 in chips) 
Seat 2: Guille1O_O ($2.82 in chips) 
Seat 3: Roman 0992 ($2.78 in chips) 
Seat 4: Redvin33 ($2.15 in chips) 
Seat 5: Taraba68 ($1.87 in chips) 
Seat 6: cc717717 ($2.03 in chips) 
Seat 7: W1zard2008 ($2.02 in chips) 
Seat 8: Artem23Ka ($3.42 in chips) 
Seat 9: amper93 ($1.65 in chips) 
Guille1O_O: posts small blind $0.01
Roman 0992: posts big blind $0.02
*** HOLE CARDS ***
Dealt to Redvin33 [2h 7h]
Redvin33: folds 
Taraba68: folds 
cc717717: folds 
W1zard2008: folds 
Artem23Ka: folds 
amper93: folds 
scorpion2680: folds 
Guille1O_O: raises $0.03 to $0.05
Roman 0992: folds 
Uncalled bet ($0.03) returned to Guille1O_O
Guille1O_O collected $0.04 from pot
Guille1O_O: doesn't show hand 
*** SUMMARY ***
Total pot $0.04 | Rake $0 
Seat 1: scorpion2680 (button) folded before Flop (didn't bet)
Seat 2: Guille1O_O (small blind) collected ($0.04)
Seat 3: Roman 0992 (big blind) folded before Flop
Seat 4: Redvin33 folded before Flop (didn't bet)
Seat 5: Taraba68 folded before Flop (didn't bet)
Seat 6: cc717717 folded before Flop (didn't bet)
Seat 7: W1zard2008 folded before Flop (didn't bet)
Seat 8: Artem23Ka folded before Flop (didn't bet)
Seat 9: amper93 folded before Flop (didn't bet)



PokerStars Zoom Hand #172696071520:  Hold'em No Limit ($0.01/$0.02) - 2017/07/06 18:14:07 ET
Table 'McNaught' 9-max Seat #1 is the button
Seat 1: Lionvodoo ($2 in chips) 
Seat 2: viagem ($2.11 in chips) 
Seat 3: ArthurStk ($1.90 in chips) 
Seat 4: KaHcTpykTap ($5.73 in chips) 
Seat 5: Taraba68 ($1.87 in chips) 
Seat 6: Redvin33 ($2.15 in chips) 
Seat 7: O_Atec ($2 in chips) 
Seat 8: jacrsjsm ($0.85 in chips) 
Seat 9: 3thirteen616 ($1.96 in chips) 
viagem: posts small blind $0.01
ArthurStk: posts big blind $0.02
*** HOLE CARDS ***
Dealt to Redvin33 [4s 6s]
KaHcTpykTap: folds 
Taraba68: folds 
Redvin33: folds 
O_Atec: folds 
jacrsjsm: folds 
3thirteen616: folds 
Lionvodoo: folds 
viagem: folds 
Uncalled bet ($0.01) returned to ArthurStk
ArthurStk collected $0.02 from pot
ArthurStk: doesn't show hand 
*** SUMMARY ***
Total pot $0.02 | Rake $0 
Seat 1: Lionvodoo (button) folded before Flop (didn't bet)
Seat 2: viagem (small blind) folded before Flop
Seat 3: ArthurStk (big blind) collected ($0.02)
Seat 4: KaHcTpykTap folded before Flop (didn't bet)
Seat 5: Taraba68 folded before Flop (didn't bet)
Seat 6: Redvin33 folded before Flop (didn't bet)
Seat 7: O_Atec folded before Flop (didn't bet)
Seat 8: jacrsjsm folded before Flop (didn't bet)
Seat 9: 3thirteen616 folded before Flop (didn't bet)



PokerStars Zoom Hand #172696075780:  Hold'em No Limit ($0.01/$0.02) - 2017/07/06 18:14:13 ET
Table 'McNaught' 9-max Seat #1 is the button
Seat 1: JJhatesMe ($2 in chips) 
Seat 2: nightspeaker ($2.78 in chips) 
Seat 3: PoWeRBaRd ($2 in chips) 
Seat 4: scorpion2680 ($1.09 in chips) 
Seat 5: Redvin33 ($2.15 in chips) 
Seat 6: Unconform ($2 in chips) 
Seat 7: Mùúh 22 ($2.94 in chips) 
Seat 8: nsigi ($2.10 in chips) 
Seat 9: cc717717 ($2.85 in chips) 
nightspeaker: posts small blind $0.01
PoWeRBaRd: posts big blind $0.02
*** HOLE CARDS ***
Dealt to Redvin33 [4c 5s]
scorpion2680: folds 
Redvin33: folds 
Unconform: folds 
Mùúh 22: folds 
nsigi: folds 
cc717717: raises $0.04 to $0.06
JJhatesMe: raises $0.12 to $0.18
nightspeaker: folds 
PoWeRBaRd: folds 
cc717717: raises $0.28 to $0.46
JJhatesMe: folds 
Uncalled bet ($0.28) returned to cc717717
cc717717 collected $0.39 from pot
cc717717: doesn't show hand 
*** SUMMARY ***
Total pot $0.39 | Rake $0 
Seat 1: JJhatesMe (button) folded before Flop
Seat 2: nightspeaker (small blind) folded before Flop
Seat 3: PoWeRBaRd (big blind) folded before Flop
Seat 4: scorpion2680 folded before Flop (didn't bet)
Seat 5: Redvin33 folded before Flop (didn't bet)
Seat 6: Unconform folded before Flop (didn't bet)
Seat 7: Mùúh 22 folded before Flop (didn't bet)
Seat 8: nsigi folded before Flop (didn't bet)
Seat 9: cc717717 collected ($0.39)



PokerStars Zoom Hand #172696068784:  Hold'em No Limit ($0.01/$0.02) - 2017/07/06 18:14:03 ET
Table 'McNaught' 9-max Seat #1 is the button
Seat 1: KrPeter ($5.37 in chips) 
Seat 2: naoya1929 ($2.03 in chips) 
Seat 3: bediboy ($5.28 in chips) 
Seat 4: alexpolevaja ($1.90 in chips) 
Seat 5: djfloss7 ($2.30 in chips) 
Seat 6: scorpion2680 ($1.09 in chips) 
Seat 7: Redvin33 ($2.15 in chips) 
Seat 8: colmcc ($1.83 in chips) 
Seat 9: Xamil666 ($5.57 in chips) 
naoya1929: posts small blind $0.01
bediboy: posts big blind $0.02
*** HOLE CARDS ***
Dealt to Redvin33 [4s 3h]
alexpolevaja: raises $0.02 to $0.04
djfloss7: folds 
scorpion2680: folds 
Redvin33: folds 
colmcc: folds 
Xamil666: folds 
KrPeter: calls $0.04
naoya1929: folds 
bediboy: folds 
*** FLOP *** [Qd 5h 4c]
alexpolevaja: checks 
KrPeter: bets $0.04
alexpolevaja: calls $0.04
*** TURN *** [Qd 5h 4c] [Td]
alexpolevaja: checks 
KrPeter: bets $0.04
alexpolevaja: calls $0.04
*** RIVER *** [Qd 5h 4c Td] [Th]
alexpolevaja: bets $0.02
KrPeter: calls $0.02
*** SHOW DOWN ***
alexpolevaja: shows [Qs Jc] (two pair, Queens and Tens)
KrPeter: shows [Kc Qh] (two pair, Queens and Tens - King kicker)
KrPeter collected $0.30 from pot
*** SUMMARY ***
Total pot $0.31 | Rake $0.01 
Board [Qd 5h 4c Td Th]
Seat 1: KrPeter (button) showed [Kc Qh] and won ($0.30) with two pair, Queens and Tens
Seat 2: naoya1929 (small blind) folded before Flop
Seat 3: bediboy (big blind) folded before Flop
Seat 4: alexpolevaja showed [Qs Jc] and lost with two pair, Queens and Tens
Seat 5: djfloss7 folded before Flop (didn't bet)
Seat 6: scorpion2680 folded before Flop (didn't bet)
Seat 7: Redvin33 folded before Flop (didn't bet)
Seat 8: colmcc folded before Flop (didn't bet)
Seat 9: Xamil666 folded before Flop (didn't bet)



PokerStars Zoom Hand #172696078653:  Hold'em No Limit ($0.01/$0.02) - 2017/07/06 18:14:17 ET
Table 'McNaught' 9-max Seat #1 is the button
Seat 1: Allekccc ($8.62 in chips) 
Seat 2: nerml000 ($0.89 in chips) 
Seat 3: Redvin33 ($2.15 in chips) 
Seat 4: batiraki13 ($2 in chips) 
Seat 5: Ksan5979 ($2.05 in chips) 
Seat 6: filon21 ($3.48 in chips) 
Seat 7: hapu ($2.06 in chips) 
Seat 8: Schickariki ($1.56 in chips) 
Seat 9: setair ($1.96 in chips) 
nerml000: posts small blind $0.01
Redvin33: posts big blind $0.02
*** HOLE CARDS ***
Dealt to Redvin33 [Jd Kc]
batiraki13: folds 
Ksan5979: folds 
filon21: raises $0.06 to $0.08
hapu: folds 
Schickariki: folds 
setair: folds 
Allekccc: folds 
nerml000: folds 
Redvin33: calls $0.06
*** FLOP *** [3h Kh 5c]
Redvin33: checks 
filon21: checks 
*** TURN *** [3h Kh 5c] [2h]
Redvin33: bets $0.06
filon21: folds 
Uncalled bet ($0.06) returned to Redvin33
Redvin33 collected $0.16 from pot
Redvin33: doesn't show hand 
*** SUMMARY ***
Total pot $0.17 | Rake $0.01 
Board [3h Kh 5c 2h]
Seat 1: Allekccc (button) folded before Flop (didn't bet)
Seat 2: nerml000 (small blind) folded before Flop
Seat 3: Redvin33 (big blind) collected ($0.16)
Seat 4: batiraki13 folded before Flop (didn't bet)
Seat 5: Ksan5979 folded before Flop (didn't bet)
Seat 6: filon21 folded on the Turn
Seat 7: hapu folded before Flop (didn't bet)
Seat 8: Schickariki folded before Flop (didn't bet)
Seat 9: setair folded before Flop (didn't bet)



PokerStars Zoom Hand #172696114435:  Hold'em No Limit ($0.01/$0.02) - 2017/07/06 18:15:08 ET
Table 'McNaught' 9-max Seat #1 is the button
Seat 1: FidgetyWins ($2.02 in chips) 
Seat 2: SandroVM ($1.80 in chips) 
Seat 3: serg197211 ($2 in chips) 
Seat 4: Lionvodoo ($2 in chips) 
Seat 5: Redvin33 ($2.23 in chips) 
Seat 6: LuisenR29 ($1.08 in chips) 
Seat 7: ntr2xit ($2.03 in chips) 
Seat 8: Gamer577 ($2.41 in chips) 
Seat 9: freeman77222 ($0.81 in chips) 
SandroVM: posts small blind $0.01
serg197211: posts big blind $0.02
*** HOLE CARDS ***
Dealt to Redvin33 [Ac 8s]
Lionvodoo: folds 
Redvin33: raises $0.03 to $0.05
LuisenR29: folds 
ntr2xit: folds 
Gamer577: folds 
freeman77222: folds 
FidgetyWins: folds 
SandroVM: folds 
serg197211: calls $0.03
*** FLOP *** [Qc 6h 5h]
serg197211: checks 
Redvin33: bets $0.04
serg197211: folds 
Uncalled bet ($0.04) returned to Redvin33
Redvin33 collected $0.11 from pot
Redvin33: doesn't show hand 
*** SUMMARY ***
Total pot $0.11 | Rake $0 
Board [Qc 6h 5h]
Seat 1: FidgetyWins (button) folded before Flop (didn't bet)
Seat 2: SandroVM (small blind) folded before Flop
Seat 3: serg197211 (big blind) folded on the Flop
Seat 4: Lionvodoo folded before Flop (didn't bet)
Seat 5: Redvin33 collected ($0.11)
Seat 6: LuisenR29 folded before Flop (didn't bet)
Seat 7: ntr2xit folded before Flop (didn't bet)
Seat 8: Gamer577 folded before Flop (didn't bet)
Seat 9: freeman77222 folded before Flop (didn't bet)



PokerStars Zoom Hand #172696129746:  Hold'em No Limit ($0.01/$0.02) - 2017/07/06 18:15:30 ET
Table 'McNaught' 9-max Seat #1 is the button
Seat 1: PATMODEL ($1.98 in chips) 
Seat 2: Redvin33 ($2.29 in chips) 
Seat 3: Hansepower00 ($3.94 in chips) 
Seat 4: VOLOOOODYA ($2.26 in chips) 
Seat 5: ArgusLL ($2 in chips) 
Seat 6: Cayoosh16 ($2.18 in chips) 
Seat 7: Nikoro309 ($2 in chips) 
Seat 8: W1zard2008 ($2 in chips) 
Seat 9: serg197211 ($2.41 in chips) 
Redvin33: posts small blind $0.01
Hansepower00: posts big blind $0.02
*** HOLE CARDS ***
Dealt to Redvin33 [9s Th]
VOLOOOODYA: folds 
ArgusLL: folds 
Cayoosh16: folds 
Nikoro309: folds 
W1zard2008: folds 
serg197211: folds 
PATMODEL: calls $0.02
Redvin33: calls $0.01
Hansepower00: checks 
*** FLOP *** [Ac Ad 2s]
Redvin33: bets $0.06
Hansepower00: folds 
PATMODEL: folds 
Uncalled bet ($0.06) returned to Redvin33
Redvin33 collected $0.06 from pot
Redvin33: doesn't show hand 
*** SUMMARY ***
Total pot $0.06 | Rake $0 
Board [Ac Ad 2s]
Seat 1: PATMODEL (button) folded on the Flop
Seat 2: Redvin33 (small blind) collected ($0.06)
Seat 3: Hansepower00 (big blind) folded on the Flop
Seat 4: VOLOOOODYA folded before Flop (didn't bet)
Seat 5: ArgusLL folded before Flop (didn't bet)
Seat 6: Cayoosh16 folded before Flop (didn't bet)
Seat 7: Nikoro309 folded before Flop (didn't bet)
Seat 8: W1zard2008 folded before Flop (didn't bet)
Seat 9: serg197211 folded before Flop (didn't bet)



PokerStars Zoom Hand #172696111591:  Hold'em No Limit ($0.01/$0.02) - 2017/07/06 18:15:04 ET
Table 'McNaught' 9-max Seat #1 is the button
Seat 1: AJIEKC ($1.97 in chips) 
Seat 2: filipov1976 ($4.88 in chips) 
Seat 3: Robin872 ($2 in chips) 
Seat 4: hapu ($8.33 in chips) 
Seat 5: jacrsjsm ($1.11 in chips) 
Seat 6: grave_17 ($2.01 in chips) 
Seat 7: Zoddoss ($2.12 in chips) 
Seat 8: Redvin33 ($2.23 in chips) 
Seat 9: fantibastuni ($3.66 in chips) 
filipov1976: posts small blind $0.01
Robin872: posts big blind $0.02
*** HOLE CARDS ***
Dealt to Redvin33 [2d 8s]
hapu: folds 
jacrsjsm: calls $0.02
grave_17: folds 
Zoddoss: folds 
Redvin33: folds 
fantibastuni: calls $0.02
AJIEKC: raises $0.08 to $0.10
filipov1976: folds 
jacrsjsm said, "zzzzzzzzzzzzzz"
Robin872 has timed out
Robin872: folds 
jacrsjsm: calls $0.08
fantibastuni: calls $0.08
*** FLOP *** [6h 3c 6s]
jacrsjsm: checks 
fantibastuni: checks 
AJIEKC: checks 
*** TURN *** [6h 3c 6s] [9h]
jacrsjsm: bets $0.16
fantibastuni: folds 
AJIEKC: folds 
Uncalled bet ($0.16) returned to jacrsjsm
jacrsjsm collected $0.32 from pot
jacrsjsm: doesn't show hand 
*** SUMMARY ***
Total pot $0.33 | Rake $0.01 
Board [6h 3c 6s 9h]
Seat 1: AJIEKC (button) folded on the Turn
Seat 2: filipov1976 (small blind) folded before Flop
Seat 3: Robin872 (big blind) folded before Flop
Seat 4: hapu folded before Flop (didn't bet)
Seat 5: jacrsjsm collected ($0.32)
Seat 6: grave_17 folded before Flop (didn't bet)
Seat 7: Zoddoss folded before Flop (didn't bet)
Seat 8: Redvin33 folded before Flop (didn't bet)
Seat 9: fantibastuni folded on the Turn



PokerStars Zoom Hand #172696153784:  Hold'em No Limit ($0.01/$0.02) - 2017/07/06 18:16:04 ET
Table 'McNaught' 9-max Seat #1 is the button
Seat 1: Redvin33 ($2.33 in chips) 
Seat 2: PoWeRBaRd ($2.34 in chips) 
Seat 3: JJhatesMe ($2.09 in chips) 
Seat 4: Nikoro309 ($2.33 in chips) 
Seat 5: Maxikreker ($1.40 in chips) 
Seat 6: Ujo Gugl ($4.08 in chips) 
Seat 7: DiNiceBoy ($4.17 in chips) 
Seat 8: ArthurStk ($1.63 in chips) 
Seat 9: alaveh ($2.64 in chips) 
PoWeRBaRd: posts small blind $0.01
JJhatesMe: posts big blind $0.02
*** HOLE CARDS ***
Dealt to Redvin33 [Kd 5c]
Nikoro309: folds 
Maxikreker: calls $0.02
Ujo Gugl: calls $0.02
DiNiceBoy: folds 
ArthurStk: folds 
alaveh: folds 
Redvin33: folds 
PoWeRBaRd: folds 
JJhatesMe: checks 
*** FLOP *** [Kh Qh Ts]
JJhatesMe: checks 
Maxikreker: checks 
Ujo Gugl: checks 
*** TURN *** [Kh Qh Ts] [Tc]
JJhatesMe: checks 
Maxikreker: checks 
Ujo Gugl: bets $0.07
JJhatesMe: calls $0.07
Maxikreker: folds 
*** RIVER *** [Kh Qh Ts Tc] [9c]
JJhatesMe: checks 
Ujo Gugl: bets $0.16
JJhatesMe: folds 
Uncalled bet ($0.16) returned to Ujo Gugl
Ujo Gugl collected $0.20 from pot
Ujo Gugl: doesn't show hand 
*** SUMMARY ***
Total pot $0.21 | Rake $0.01 
Board [Kh Qh Ts Tc 9c]
Seat 1: Redvin33 (button) folded before Flop (didn't bet)
Seat 2: PoWeRBaRd (small blind) folded before Flop
Seat 3: JJhatesMe (big blind) folded on the River
Seat 4: Nikoro309 folded before Flop (didn't bet)
Seat 5: Maxikreker folded on the Turn
Seat 6: Ujo Gugl collected ($0.20)
Seat 7: DiNiceBoy folded before Flop (didn't bet)
Seat 8: ArthurStk folded before Flop (didn't bet)
Seat 9: alaveh folded before Flop (didn't bet)



PokerStars Zoom Hand #172696158095:  Hold'em No Limit ($0.01/$0.02) - 2017/07/06 18:16:10 ET
Table 'McNaught' 9-max Seat #1 is the button
Seat 1: mario45648 ($2.73 in chips) 
Seat 2: fuminator ($0.94 in chips) 
Seat 3: lilroo12 ($2 in chips) 
Seat 4: ArgusLL ($2.08 in chips) 
Seat 5: Sympathya ($2.20 in chips) 
Seat 6: 1_koi7a ($1.07 in chips) 
Seat 7: setair ($1.87 in chips) 
Seat 8: Alex75stv ($1.57 in chips) 
Seat 9: Redvin33 ($2.33 in chips) 
fuminator: posts small blind $0.01
lilroo12: posts big blind $0.02
*** HOLE CARDS ***
Dealt to Redvin33 [7s 7d]
ArgusLL: folds 
Sympathya: folds 
1_koi7a: folds 
setair: folds 
Alex75stv: folds 
Redvin33: raises $0.03 to $0.05
mario45648: calls $0.05
fuminator: folds 
lilroo12: calls $0.03
*** FLOP *** [Td 7c 7h]
lilroo12: checks 
Redvin33: bets $0.04
mario45648: calls $0.04
lilroo12: folds 
*** TURN *** [Td 7c 7h] [6s]
Redvin33: bets $0.08
mario45648: folds 
Uncalled bet ($0.08) returned to Redvin33
Redvin33 collected $0.23 from pot
Redvin33: doesn't show hand 
*** SUMMARY ***
Total pot $0.24 | Rake $0.01 
Board [Td 7c 7h 6s]
Seat 1: mario45648 (button) folded on the Turn
Seat 2: fuminator (small blind) folded before Flop
Seat 3: lilroo12 (big blind) folded on the Flop
Seat 4: ArgusLL folded before Flop (didn't bet)
Seat 5: Sympathya folded before Flop (didn't bet)
Seat 6: 1_koi7a folded before Flop (didn't bet)
Seat 7: setair folded before Flop (didn't bet)
Seat 8: Alex75stv folded before Flop (didn't bet)
Seat 9: Redvin33 collected ($0.23)



PokerStars Zoom Hand #172696198710:  Hold'em No Limit ($0.01/$0.02) - 2017/07/06 18:17:08 ET
Table 'McNaught' 9-max Seat #1 is the button
Seat 1: Roman 0992 ($3.39 in chips) 
Seat 2: PJWALL ($1.94 in chips) 
Seat 3: Zoddoss ($2.32 in chips) 
Seat 4: NJoy2Win ($5.75 in chips) 
Seat 5: Bugiel ($3.20 in chips) 
Seat 6: Xamil666 ($5.67 in chips) 
Seat 7: Redvin33 ($2.47 in chips) 
Seat 8: Trini Garcia ($3.50 in chips) 
Seat 9: Robin872 ($2 in chips) 
PJWALL: posts small blind $0.01
Zoddoss: posts big blind $0.02
*** HOLE CARDS ***
Dealt to Redvin33 [3c 7h]
NJoy2Win: folds 
Bugiel: folds 
Xamil666: folds 
Redvin33: folds 
Trini Garcia: raises $0.03 to $0.05
Robin872: folds 
Roman 0992: folds 
PJWALL: folds 
Zoddoss: folds 
Uncalled bet ($0.03) returned to Trini Garcia
Trini Garcia collected $0.05 from pot
Trini Garcia: doesn't show hand 
*** SUMMARY ***
Total pot $0.05 | Rake $0 
Seat 1: Roman 0992 (button) folded before Flop (didn't bet)
Seat 2: PJWALL (small blind) folded before Flop
Seat 3: Zoddoss (big blind) folded before Flop
Seat 4: NJoy2Win folded before Flop (didn't bet)
Seat 5: Bugiel folded before Flop (didn't bet)
Seat 6: Xamil666 folded before Flop (didn't bet)
Seat 7: Redvin33 folded before Flop (didn't bet)
Seat 8: Trini Garcia collected ($0.05)
Seat 9: Robin872 folded before Flop (didn't bet)



PokerStars Zoom Hand #172696207793:  Hold'em No Limit ($0.01/$0.02) - 2017/07/06 18:17:21 ET
Table 'McNaught' 9-max Seat #1 is the button
Seat 1: hapu ($2.11 in chips) 
Seat 2: yayadub ($1.70 in chips) 
Seat 3: komarkoff ($2.38 in chips) 
Seat 4: stel73 ($2.17 in chips) 
Seat 5: lion.1st ($1.94 in chips) 
Seat 6: Allekccc ($8.70 in chips) 
Seat 7: mario45648 ($2.63 in chips) 
Seat 8: jeka2015 ($1.41 in chips) 
Seat 9: Redvin33 ($2.47 in chips) 
yayadub: posts small blind $0.01
komarkoff: posts big blind $0.02
*** HOLE CARDS ***
Dealt to Redvin33 [9c Jd]
stel73: folds 
lion.1st: folds 
Allekccc: folds 
mario45648: folds 
jeka2015: raises $0.04 to $0.06
Redvin33: folds 
hapu: folds 
yayadub: folds 
komarkoff: folds 
Uncalled bet ($0.04) returned to jeka2015
jeka2015 collected $0.05 from pot
jeka2015: doesn't show hand 
*** SUMMARY ***
Total pot $0.05 | Rake $0 
Seat 1: hapu (button) folded before Flop (didn't bet)
Seat 2: yayadub (small blind) folded before Flop
Seat 3: komarkoff (big blind) folded before Flop
Seat 4: stel73 folded before Flop (didn't bet)
Seat 5: lion.1st folded before Flop (didn't bet)
Seat 6: Allekccc folded before Flop (didn't bet)
Seat 7: mario45648 folded before Flop (didn't bet)
Seat 8: jeka2015 collected ($0.05)
Seat 9: Redvin33 folded before Flop (didn't bet)



PokerStars Zoom Hand #172696202202:  Hold'em No Limit ($0.01/$0.02) - 2017/07/06 18:17:13 ET
Table 'McNaught' 9-max Seat #1 is the button
Seat 1: bediboy ($5.26 in chips) 
Seat 2: Unconform ($2 in chips) 
Seat 3: Bugiel ($3.20 in chips) 
Seat 4: YAAJ7 ($0.99 in chips) 
Seat 5: Cayoosh16 ($1.69 in chips) 
Seat 6: Redvin33 ($2.47 in chips) 
Seat 7: Moltyaninov ($2.16 in chips) 
Seat 8: NJoy2Win ($6.27 in chips) 
Seat 9: FidgetyWins ($2.14 in chips) 
Unconform: posts small blind $0.01
Bugiel: posts big blind $0.02
*** HOLE CARDS ***
Dealt to Redvin33 [7c Qc]
YAAJ7: folds 
Cayoosh16: folds 
Redvin33: folds 
Moltyaninov: folds 
NJoy2Win: folds 
FidgetyWins: raises $0.04 to $0.06
bediboy: folds 
Unconform: raises $0.16 to $0.22
Bugiel: folds 
FidgetyWins: folds 
Uncalled bet ($0.16) returned to Unconform
Unconform collected $0.14 from pot
Unconform: doesn't show hand 
*** SUMMARY ***
Total pot $0.14 | Rake $0 
Seat 1: bediboy (button) folded before Flop (didn't bet)
Seat 2: Unconform (small blind) collected ($0.14)
Seat 3: Bugiel (big blind) folded before Flop
Seat 4: YAAJ7 folded before Flop (didn't bet)
Seat 5: Cayoosh16 folded before Flop (didn't bet)
Seat 6: Redvin33 folded before Flop (didn't bet)
Seat 7: Moltyaninov folded before Flop (didn't bet)
Seat 8: NJoy2Win folded before Flop (didn't bet)
Seat 9: FidgetyWins folded before Flop



PokerStars Zoom Hand #172696205008:  Hold'em No Limit ($0.01/$0.02) - 2017/07/06 18:17:17 ET
Table 'McNaught' 9-max Seat #1 is the button
Seat 1: hapu ($8.21 in chips) 
Seat 2: Ksan5979 ($2.01 in chips) 
Seat 3: Gamer577 ($2.45 in chips) 
Seat 4: Redvin33 ($2.47 in chips) 
Seat 5: colmcc ($1.75 in chips) 
Seat 6: mario45648 ($2.63 in chips) 
Seat 7: Allekccc ($8.70 in chips) 
Seat 8: alexpolevaja ($1.24 in chips) 
Seat 9: ntr2xit ($2.03 in chips) 
Ksan5979: posts small blind $0.01
Gamer577: posts big blind $0.02
*** HOLE CARDS ***
Dealt to Redvin33 [3s Th]
Redvin33: folds 
colmcc: folds 
mario45648: folds 
Allekccc: folds 
alexpolevaja: folds 
ntr2xit: raises $0.03 to $0.05
hapu: folds 
Ksan5979: folds 
Gamer577: folds 
Uncalled bet ($0.03) returned to ntr2xit
ntr2xit collected $0.05 from pot
ntr2xit: doesn't show hand 
*** SUMMARY ***
Total pot $0.05 | Rake $0 
Seat 1: hapu (button) folded before Flop (didn't bet)
Seat 2: Ksan5979 (small blind) folded before Flop
Seat 3: Gamer577 (big blind) folded before Flop
Seat 4: Redvin33 folded before Flop (didn't bet)
Seat 5: colmcc folded before Flop (didn't bet)
Seat 6: mario45648 folded before Flop (didn't bet)
Seat 7: Allekccc folded before Flop (didn't bet)
Seat 8: alexpolevaja folded before Flop (didn't bet)
Seat 9: ntr2xit collected ($0.05)



PokerStars Zoom Hand #172696210651:  Hold'em No Limit ($0.01/$0.02) - 2017/07/06 18:17:25 ET
Table 'McNaught' 9-max Seat #1 is the button
Seat 1: ^J0K3RST@RS! ($2.05 in chips) 
Seat 2: Allekccc ($8.70 in chips) 
Seat 3: Redvin33 ($2.47 in chips) 
Seat 4: chtx900326 ($1.91 in chips) 
Seat 5: robertomuc ($2.21 in chips) 
Seat 6: Rishnu Fr ($2 in chips) 
Seat 7: Artem23Ka ($5.40 in chips) 
Seat 8: Haczlo ($2.69 in chips) 
Seat 9: Kagronak.PS ($2 in chips) 
Allekccc: posts small blind $0.01
Redvin33: posts big blind $0.02
*** HOLE CARDS ***
Dealt to Redvin33 [4s Js]
chtx900326: folds 
robertomuc: folds 
Rishnu Fr: folds 
Artem23Ka: folds 
Haczlo: folds 
Kagronak.PS: folds 
^J0K3RST@RS!: raises $0.02 to $0.04
Allekccc: folds 
Redvin33: folds 
Uncalled bet ($0.02) returned to ^J0K3RST@RS!
^J0K3RST@RS! collected $0.05 from pot
^J0K3RST@RS!: doesn't show hand 
*** SUMMARY ***
Total pot $0.05 | Rake $0 
Seat 1: ^J0K3RST@RS! (button) collected ($0.05)
Seat 2: Allekccc (small blind) folded before Flop
Seat 3: Redvin33 (big blind) folded before Flop
Seat 4: chtx900326 folded before Flop (didn't bet)
Seat 5: robertomuc folded before Flop (didn't bet)
Seat 6: Rishnu Fr folded before Flop (didn't bet)
Seat 7: Artem23Ka folded before Flop (didn't bet)
Seat 8: Haczlo folded before Flop (didn't bet)
Seat 9: Kagronak.PS folded before Flop (didn't bet)



PokerStars Zoom Hand #172696236709:  Hold'em No Limit ($0.01/$0.02) - 2017/07/06 18:18:02 ET
Table 'McNaught' 9-max Seat #1 is the button
Seat 1: Gamer577 ($4.73 in chips) 
Seat 2: KaHcTpykTap ($2.50 in chips) 
Seat 3: PoWeRBaRd ($2.30 in chips) 
Seat 4: Rishnu Fr ($4.75 in chips) 
Seat 5: Jaffar999 ($2.47 in chips) 
Seat 6: Unconform ($2 in chips) 
Seat 7: Redvin33 ($2.44 in chips) 
Seat 8: filipov1976 ($4.15 in chips) 
Seat 9: Taraba68 ($2.37 in chips) 
KaHcTpykTap: posts small blind $0.01
PoWeRBaRd: posts big blind $0.02
*** HOLE CARDS ***
Dealt to Redvin33 [6h 9c]
Rishnu Fr: folds 
Jaffar999: folds 
Unconform: folds 
Redvin33: folds 
filipov1976: folds 
Taraba68: folds 
Gamer577: folds 
KaHcTpykTap: folds 
Uncalled bet ($0.01) returned to PoWeRBaRd
PoWeRBaRd collected $0.02 from pot
PoWeRBaRd: doesn't show hand 
*** SUMMARY ***
Total pot $0.02 | Rake $0 
Seat 1: Gamer577 (button) folded before Flop (didn't bet)
Seat 2: KaHcTpykTap (small blind) folded before Flop
Seat 3: PoWeRBaRd (big blind) collected ($0.02)
Seat 4: Rishnu Fr folded before Flop (didn't bet)
Seat 5: Jaffar999 folded before Flop (didn't bet)
Seat 6: Unconform folded before Flop (didn't bet)
Seat 7: Redvin33 folded before Flop (didn't bet)
Seat 8: filipov1976 folded before Flop (didn't bet)
Seat 9: Taraba68 folded before Flop (didn't bet)



PokerStars Zoom Hand #172696231112:  Hold'em No Limit ($0.01/$0.02) - 2017/07/06 18:17:54 ET
Table 'McNaught' 9-max Seat #1 is the button
Seat 1: W1zard2008 ($2 in chips) 
Seat 2: Mùúh 22 ($2.07 in chips) 
Seat 3: DaHure ($2.14 in chips) 
Seat 4: Artem23Ka ($3.78 in chips) 
Seat 5: kwatas kef ($2.17 in chips) 
Seat 6: 335593 ($3.36 in chips) 
Seat 7: PoWeRBaRd ($2.30 in chips) 
Seat 8: Redvin33 ($2.44 in chips) 
Seat 9: O_Atec ($2 in chips) 
Mùúh 22: posts small blind $0.01
DaHure: posts big blind $0.02
*** HOLE CARDS ***
Dealt to Redvin33 [3c Qd]
Artem23Ka: folds 
kwatas kef: calls $0.02
335593: folds 
PoWeRBaRd: folds 
Redvin33: folds 
O_Atec: folds 
W1zard2008: folds 
Mùúh 22: folds 
DaHure: checks 
*** FLOP *** [5d Jh 2s]
DaHure: checks 
kwatas kef: bets $0.08
DaHure: folds 
Uncalled bet ($0.08) returned to kwatas kef
kwatas kef collected $0.05 from pot
kwatas kef: doesn't show hand 
*** SUMMARY ***
Total pot $0.05 | Rake $0 
Board [5d Jh 2s]
Seat 1: W1zard2008 (button) folded before Flop (didn't bet)
Seat 2: Mùúh 22 (small blind) folded before Flop
Seat 3: DaHure (big blind) folded on the Flop
Seat 4: Artem23Ka folded before Flop (didn't bet)
Seat 5: kwatas kef collected ($0.05)
Seat 6: 335593 folded before Flop (didn't bet)
Seat 7: PoWeRBaRd folded before Flop (didn't bet)
Seat 8: Redvin33 folded before Flop (didn't bet)
Seat 9: O_Atec folded before Flop (didn't bet)



PokerStars Zoom Hand #172696226298:  Hold'em No Limit ($0.01/$0.02) - 2017/07/06 18:17:47 ET
Table 'McNaught' 9-max Seat #1 is the button
Seat 1: JJhatesMe ($2.13 in chips) 
Seat 2: Redvin33 ($2.45 in chips) 
Seat 3: Cayoosh16 ($1.80 in chips) 
Seat 4: Unconform ($2 in chips) 
Seat 5: Gamer577 ($4.74 in chips) 
Seat 6: Maxikreker ($1.76 in chips) 
Seat 7: japu2010 ($2.88 in chips) 
Seat 8: Pokurov ($2.62 in chips) 
Seat 9: kidninja888 ($6.31 in chips) 
Redvin33: posts small blind $0.01
Cayoosh16: posts big blind $0.02
*** HOLE CARDS ***
Dealt to Redvin33 [2c 9h]
Unconform: folds 
Gamer577: folds 
Maxikreker: folds 
japu2010: folds 
Pokurov: raises $0.04 to $0.06
kidninja888: raises $0.15 to $0.21
JJhatesMe: folds 
Redvin33: folds 
Cayoosh16: folds 
Pokurov: calls $0.15
*** FLOP *** [Jc 6c 3c]
Pokurov: checks 
kidninja888: bets $0.30
Pokurov: folds 
Uncalled bet ($0.30) returned to kidninja888
kidninja888 collected $0.43 from pot
kidninja888: doesn't show hand 
*** SUMMARY ***
Total pot $0.45 | Rake $0.02 
Board [Jc 6c 3c]
Seat 1: JJhatesMe (button) folded before Flop (didn't bet)
Seat 2: Redvin33 (small blind) folded before Flop
Seat 3: Cayoosh16 (big blind) folded before Flop
Seat 4: Unconform folded before Flop (didn't bet)
Seat 5: Gamer577 folded before Flop (didn't bet)
Seat 6: Maxikreker folded before Flop (didn't bet)
Seat 7: japu2010 folded before Flop (didn't bet)
Seat 8: Pokurov folded on the Flop
Seat 9: kidninja888 collected ($0.43)



PokerStars Zoom Hand #172696223471:  Hold'em No Limit ($0.01/$0.02) - 2017/07/06 18:17:43 ET
Table 'McNaught' 9-max Seat #1 is the button
Seat 1: T9w1n ($2.51 in chips) 
Seat 2: yaralizeth ($3.53 in chips) 
Seat 3: thmsjoyce8 ($1.89 in chips) 
Seat 4: Redvin33 ($2.45 in chips) 
Seat 5: Moltyaninov ($2.16 in chips) 
Seat 6: FidgetyWins ($2.17 in chips) 
Seat 7: Mùúh 22 ($2.07 in chips) 
Seat 8: Allekccc ($8.69 in chips) 
Seat 9: PoWeRBaRd ($2.30 in chips) 
yaralizeth: posts small blind $0.01
thmsjoyce8: posts big blind $0.02
*** HOLE CARDS ***
Dealt to Redvin33 [Qc 7s]
Redvin33: folds 
Moltyaninov: folds 
FidgetyWins: folds 
Mùúh 22: folds 
Allekccc: folds 
PoWeRBaRd: folds 
T9w1n: raises $0.04 to $0.06
yaralizeth: calls $0.05
thmsjoyce8: folds 
*** FLOP *** [7h Tc 7d]
yaralizeth: checks 
T9w1n: checks 
*** TURN *** [7h Tc 7d] [Kd]
yaralizeth: checks 
T9w1n: bets $0.10
yaralizeth: folds 
Uncalled bet ($0.10) returned to T9w1n
T9w1n collected $0.14 from pot
T9w1n: doesn't show hand 
*** SUMMARY ***
Total pot $0.14 | Rake $0 
Board [7h Tc 7d Kd]
Seat 1: T9w1n (button) collected ($0.14)
Seat 2: yaralizeth (small blind) folded on the Turn
Seat 3: thmsjoyce8 (big blind) folded before Flop
Seat 4: Redvin33 folded before Flop (didn't bet)
Seat 5: Moltyaninov folded before Flop (didn't bet)
Seat 6: FidgetyWins folded before Flop (didn't bet)
Seat 7: Mùúh 22 folded before Flop (didn't bet)
Seat 8: Allekccc folded before Flop (didn't bet)
Seat 9: PoWeRBaRd folded before Flop (didn't bet)



PokerStars Zoom Hand #172696233912:  Hold'em No Limit ($0.01/$0.02) - 2017/07/06 18:17:58 ET
Table 'McNaught' 9-max Seat #1 is the button
Seat 1: Jaffar999 ($2.47 in chips) 
Seat 2: Xamil666 ($3.18 in chips) 
Seat 3: Sespirion ($1 in chips) 
Seat 4: Gorwfwefwed ($2.79 in chips) 
Seat 5: Redvin33 ($2.44 in chips) 
Seat 6: sukryss ($2.67 in chips) 
Seat 7: LuisenR29 ($0.97 in chips) 
Seat 8: 3thirteen616 ($1.88 in chips) 
Seat 9: Robin872 ($2.02 in chips) 
Xamil666: posts small blind $0.01
Sespirion: posts big blind $0.02
*** HOLE CARDS ***
Dealt to Redvin33 [2s 5s]
Gorwfwefwed: folds 
Redvin33: folds 
sukryss: folds 
LuisenR29 has timed out
LuisenR29: folds 
3thirteen616: folds 
Robin872: raises $0.04 to $0.06
Jaffar999: folds 
Xamil666: folds 
Sespirion: folds 
Uncalled bet ($0.04) returned to Robin872
Robin872 collected $0.05 from pot
Robin872: doesn't show hand 
*** SUMMARY ***
Total pot $0.05 | Rake $0 
Seat 1: Jaffar999 (button) folded before Flop (didn't bet)
Seat 2: Xamil666 (small blind) folded before Flop
Seat 3: Sespirion (big blind) folded before Flop
Seat 4: Gorwfwefwed folded before Flop (didn't bet)
Seat 5: Redvin33 folded before Flop (didn't bet)
Seat 6: sukryss folded before Flop (didn't bet)
Seat 7: LuisenR29 folded before Flop (didn't bet)
Seat 8: 3thirteen616 folded before Flop (didn't bet)
Seat 9: Robin872 collected ($0.05)



PokerStars Zoom Hand #172696228328:  Hold'em No Limit ($0.01/$0.02) - 2017/07/06 18:17:50 ET
Table 'McNaught' 9-max Seat #1 is the button
Seat 1: Redvin33 ($2.44 in chips) 
Seat 2: Ksan5979 ($2.03 in chips) 
Seat 3: dmitrychuk ($5 in chips) 
Seat 4: serg197211 ($2.01 in chips) 
Seat 5: setair ($1.83 in chips) 
Seat 6: jeka2015 ($1.44 in chips) 
Seat 7: KaHcTpykTap ($2.09 in chips) 
Seat 8: alaveh ($2.49 in chips) 
Seat 9: MsGriss ($1.91 in chips) 
Ksan5979: posts small blind $0.01
dmitrychuk: posts big blind $0.02
*** HOLE CARDS ***
Dealt to Redvin33 [3h Js]
serg197211: folds 
setair: raises $0.04 to $0.06
jeka2015: folds 
KaHcTpykTap: folds 
alaveh: folds 
MsGriss: folds 
Redvin33: folds 
Ksan5979: calls $0.05
dmitrychuk: folds 
*** FLOP *** [5d 4s 2s]
Ksan5979: bets $0.09
setair: calls $0.09
*** TURN *** [5d 4s 2s] [Qh]
Ksan5979: checks 
setair: bets $0.16
Ksan5979: folds 
Uncalled bet ($0.16) returned to setair
setair collected $0.31 from pot
setair: doesn't show hand 
*** SUMMARY ***
Total pot $0.32 | Rake $0.01 
Board [5d 4s 2s Qh]
Seat 1: Redvin33 (button) folded before Flop (didn't bet)
Seat 2: Ksan5979 (small blind) folded on the Turn
Seat 3: dmitrychuk (big blind) folded before Flop
Seat 4: serg197211 folded before Flop (didn't bet)
Seat 5: setair collected ($0.31)
Seat 6: jeka2015 folded before Flop (didn't bet)
Seat 7: KaHcTpykTap folded before Flop (didn't bet)
Seat 8: alaveh folded before Flop (didn't bet)
Seat 9: MsGriss folded before Flop (didn't bet)



PokerStars Zoom Hand #172696241496:  Hold'em No Limit ($0.01/$0.02) - 2017/07/06 18:18:09 ET
Table 'McNaught' 9-max Seat #1 is the button
Seat 1: PJWALL ($1.90 in chips) 
Seat 2: JJhatesMe ($2.13 in chips) 
Seat 3: victordyfox ($2 in chips) 
Seat 4: vycheslav d ($1.48 in chips) 
Seat 5: PoWeRBaRd ($4.44 in chips) 
Seat 6: Redvin33 ($2.44 in chips) 
Seat 7: komarkoff ($2.35 in chips) 
Seat 8: Xamil666 ($4.36 in chips) 
Seat 9: colmcc ($1.90 in chips) 
JJhatesMe: posts small blind $0.01
victordyfox: posts big blind $0.02
*** HOLE CARDS ***
Dealt to Redvin33 [Ks Qd]
vycheslav d: folds 
PoWeRBaRd: raises $0.04 to $0.06
Redvin33: calls $0.06
komarkoff: folds 
Xamil666: folds 
colmcc: folds 
PJWALL: folds 
JJhatesMe: folds 
victordyfox: calls $0.04
*** FLOP *** [Kd 8h As]
victordyfox: checks 
PoWeRBaRd: checks 
Redvin33: bets $0.06
victordyfox: calls $0.06
PoWeRBaRd: calls $0.06
*** TURN *** [Kd 8h As] [2c]
victordyfox: checks 
PoWeRBaRd: checks 
Redvin33: checks 
*** RIVER *** [Kd 8h As 2c] [Jh]
victordyfox: checks 
PoWeRBaRd: checks 
Redvin33: bets $0.09
victordyfox: folds 
PoWeRBaRd: folds 
Uncalled bet ($0.09) returned to Redvin33
Redvin33 collected $0.36 from pot
Redvin33: doesn't show hand 
*** SUMMARY ***
Total pot $0.37 | Rake $0.01 
Board [Kd 8h As 2c Jh]
Seat 1: PJWALL (button) folded before Flop (didn't bet)
Seat 2: JJhatesMe (small blind) folded before Flop
Seat 3: victordyfox (big blind) folded on the River
Seat 4: vycheslav d folded before Flop (didn't bet)
Seat 5: PoWeRBaRd folded on the River
Seat 6: Redvin33 collected ($0.36)
Seat 7: komarkoff folded before Flop (didn't bet)
Seat 8: Xamil666 folded before Flop (didn't bet)
Seat 9: colmcc folded before Flop (didn't bet)



PokerStars Zoom Hand #172696284408:  Hold'em No Limit ($0.01/$0.02) - 2017/07/06 18:19:10 ET
Table 'McNaught' 9-max Seat #1 is the button
Seat 1: Sympathya ($2.37 in chips) 
Seat 2: mirofa ($2.95 in chips) 
Seat 3: dmitrychuk ($2.28 in chips) 
Seat 4: Redvin33 ($2.68 in chips) 
Seat 5: V. Regeis ($2.37 in chips) 
Seat 6: Trini Garcia ($3.64 in chips) 
Seat 7: ^J0K3RST@RS! ($2.05 in chips) 
Seat 8: vagebolle ($1.61 in chips) 
Seat 9: FidgetyWins ($2 in chips) 
mirofa: posts small blind $0.01
dmitrychuk: posts big blind $0.02
*** HOLE CARDS ***
Dealt to Redvin33 [Th As]
Redvin33: raises $0.03 to $0.05
V. Regeis: folds 
Trini Garcia: folds 
^J0K3RST@RS!: folds 
vagebolle: folds 
FidgetyWins: calls $0.05
Sympathya: folds 
mirofa: folds 
dmitrychuk: folds 
*** FLOP *** [2c Js Kc]
Redvin33: checks 
FidgetyWins: checks 
*** TURN *** [2c Js Kc] [3d]
Redvin33: bets $0.07
FidgetyWins: raises $0.13 to $0.20
Redvin33: folds 
Uncalled bet ($0.13) returned to FidgetyWins
FidgetyWins collected $0.26 from pot
FidgetyWins: doesn't show hand 
*** SUMMARY ***
Total pot $0.27 | Rake $0.01 
Board [2c Js Kc 3d]
Seat 1: Sympathya (button) folded before Flop (didn't bet)
Seat 2: mirofa (small blind) folded before Flop
Seat 3: dmitrychuk (big blind) folded before Flop
Seat 4: Redvin33 folded on the Turn
Seat 5: V. Regeis folded before Flop (didn't bet)
Seat 6: Trini Garcia folded before Flop (didn't bet)
Seat 7: ^J0K3RST@RS! folded before Flop (didn't bet)
Seat 8: vagebolle folded before Flop (didn't bet)
Seat 9: FidgetyWins collected ($0.26)



PokerStars Zoom Hand #172696313628:  Hold'em No Limit ($0.01/$0.02) - 2017/07/06 18:19:52 ET
Table 'McNaught' 9-max Seat #1 is the button
Seat 1: viagem ($6.39 in chips) 
Seat 2: Jaffar999 ($1.73 in chips) 
Seat 3: Redvin33 ($2.56 in chips) 
Seat 4: Sespirion ($1 in chips) 
Seat 5: Agares91 ($2 in chips) 
Seat 6: madin683 ($2.50 in chips) 
Seat 7: Ksan5979 ($2 in chips) 
Seat 8: christina 1989 ($3.89 in chips) 
Seat 9: Robin872 ($2 in chips) 
Jaffar999: posts small blind $0.01
Redvin33: posts big blind $0.02
*** HOLE CARDS ***
Dealt to Redvin33 [As 6s]
Sespirion: folds 
Agares91: folds 
madin683: folds 
Ksan5979: raises $0.04 to $0.06
christina 1989: folds 
Robin872: folds 
viagem: folds 
Jaffar999: folds 
Redvin33: calls $0.04
*** FLOP *** [4c 3d 7s]
Redvin33: bets $0.08
Ksan5979: folds 
Uncalled bet ($0.08) returned to Redvin33
Redvin33 collected $0.13 from pot
Redvin33: doesn't show hand 
*** SUMMARY ***
Total pot $0.13 | Rake $0 
Board [4c 3d 7s]
Seat 1: viagem (button) folded before Flop (didn't bet)
Seat 2: Jaffar999 (small blind) folded before Flop
Seat 3: Redvin33 (big blind) collected ($0.13)
Seat 4: Sespirion folded before Flop (didn't bet)
Seat 5: Agares91 folded before Flop (didn't bet)
Seat 6: madin683 folded before Flop (didn't bet)
Seat 7: Ksan5979 folded on the Flop
Seat 8: christina 1989 folded before Flop (didn't bet)
Seat 9: Robin872 folded before Flop (didn't bet)



PokerStars Zoom Hand #172696340633:  Hold'em No Limit ($0.01/$0.02) - 2017/07/06 18:20:31 ET
Table 'McNaught' 9-max Seat #1 is the button
Seat 1: Brucechiou ($3.32 in chips) 
Seat 2: yaralizeth ($3.44 in chips) 
Seat 3: bellamia26 ($7.06 in chips) 
Seat 4: djfloss7 ($1.04 in chips) 
Seat 5: komarkoff ($4.39 in chips) 
Seat 6: ArthurStk ($3.50 in chips) 
Seat 7: olsche74 ($0.76 in chips) 
Seat 8: Redvin33 ($2.63 in chips) 
Seat 9: Cayoosh16 ($1.77 in chips) 
yaralizeth: posts small blind $0.01
bellamia26: posts big blind $0.02
*** HOLE CARDS ***
Dealt to Redvin33 [Tc 6d]
djfloss7: folds 
komarkoff: folds 
ArthurStk: folds 
olsche74: folds 
Redvin33: folds 
Cayoosh16: folds 
Brucechiou: raises $0.04 to $0.06
yaralizeth: calls $0.05
bellamia26: folds 
*** FLOP *** [7s Ks 3h]
yaralizeth: checks 
Brucechiou: bets $0.07
yaralizeth: folds 
Uncalled bet ($0.07) returned to Brucechiou
Brucechiou collected $0.14 from pot
Brucechiou: doesn't show hand 
*** SUMMARY ***
Total pot $0.14 | Rake $0 
Board [7s Ks 3h]
Seat 1: Brucechiou (button) collected ($0.14)
Seat 2: yaralizeth (small blind) folded on the Flop
Seat 3: bellamia26 (big blind) folded before Flop
Seat 4: djfloss7 folded before Flop (didn't bet)
Seat 5: komarkoff folded before Flop (didn't bet)
Seat 6: ArthurStk folded before Flop (didn't bet)
Seat 7: olsche74 folded before Flop (didn't bet)
Seat 8: Redvin33 folded before Flop (didn't bet)
Seat 9: Cayoosh16 folded before Flop (didn't bet)



PokerStars Zoom Hand #172696343391:  Hold'em No Limit ($0.01/$0.02) - 2017/07/06 18:20:35 ET
Table 'McNaught' 9-max Seat #1 is the button
Seat 1: Spengi84 ($4.77 in chips) 
Seat 2: bediboy ($7.53 in chips) 
Seat 3: W1zard2008 ($1.84 in chips) 
Seat 4: komarkoff ($4.39 in chips) 
Seat 5: lion.1st ($2.34 in chips) 
Seat 6: Gorwfwefwed ($2.85 in chips) 
Seat 7: Ksan5979 ($2.05 in chips) 
Seat 8: ntr2xit ($3.79 in chips) 
Seat 9: Redvin33 ($2.63 in chips) 
bediboy: posts small blind $0.01
W1zard2008: posts big blind $0.02
*** HOLE CARDS ***
Dealt to Redvin33 [8c Qh]
komarkoff: folds 
lion.1st: folds 
Gorwfwefwed: folds 
Ksan5979: folds 
ntr2xit: folds 
Redvin33: folds 
Spengi84: folds 
bediboy: folds 
Uncalled bet ($0.01) returned to W1zard2008
W1zard2008 collected $0.02 from pot
W1zard2008: doesn't show hand 
*** SUMMARY ***
Total pot $0.02 | Rake $0 
Seat 1: Spengi84 (button) folded before Flop (didn't bet)
Seat 2: bediboy (small blind) folded before Flop
Seat 3: W1zard2008 (big blind) collected ($0.02)
Seat 4: komarkoff folded before Flop (didn't bet)
Seat 5: lion.1st folded before Flop (didn't bet)
Seat 6: Gorwfwefwed folded before Flop (didn't bet)
Seat 7: Ksan5979 folded before Flop (didn't bet)
Seat 8: ntr2xit folded before Flop (didn't bet)
Seat 9: Redvin33 folded before Flop (didn't bet)



PokerStars Zoom Hand #172696346900:  Hold'em No Limit ($0.01/$0.02) - 2017/07/06 18:20:40 ET
Table 'McNaught' 9-max Seat #1 is the button
Seat 1: lion.1st ($2.34 in chips) 
Seat 2: Redvin33 ($2.63 in chips) 
Seat 3: duartt11 ($1.30 in chips) 
Seat 4: Artem23Ka ($5.56 in chips) 
Seat 5: Unconform ($2.22 in chips) 
Seat 6: lilroo12 ($2.05 in chips) 
Seat 7: Babettka ($2.29 in chips) 
Seat 8: denzell574 ($2.85 in chips) 
Seat 9: mario45648 ($1.62 in chips) 
Redvin33: posts small blind $0.01
duartt11: posts big blind $0.02
*** HOLE CARDS ***
Dealt to Redvin33 [Qd Ks]
Artem23Ka: folds 
Unconform: folds 
lilroo12: folds 
Babettka: folds 
denzell574: folds 
mario45648: folds 
lion.1st: folds 
Redvin33: raises $0.02 to $0.04
duartt11: calls $0.02
*** FLOP *** [7h 7c Ah]
Redvin33: bets $0.04
duartt11: raises $0.04 to $0.08
Redvin33: calls $0.04
*** TURN *** [7h 7c Ah] [Qc]
Redvin33: checks 
duartt11: checks 
*** RIVER *** [7h 7c Ah Qc] [4c]
Redvin33: bets $0.08
duartt11: calls $0.08
*** SHOW DOWN ***
Redvin33: shows [Qd Ks] (two pair, Queens and Sevens)
duartt11: shows [5d As] (two pair, Aces and Sevens)
duartt11 collected $0.39 from pot
*** SUMMARY ***
Total pot $0.40 | Rake $0.01 
Board [7h 7c Ah Qc 4c]
Seat 1: lion.1st (button) folded before Flop (didn't bet)
Seat 2: Redvin33 (small blind) showed [Qd Ks] and lost with two pair, Queens and Sevens
Seat 3: duartt11 (big blind) showed [5d As] and won ($0.39) with two pair, Aces and Sevens
Seat 4: Artem23Ka folded before Flop (didn't bet)
Seat 5: Unconform folded before Flop (didn't bet)
Seat 6: lilroo12 folded before Flop (didn't bet)
Seat 7: Babettka folded before Flop (didn't bet)
Seat 8: denzell574 folded before Flop (didn't bet)
Seat 9: mario45648 folded before Flop (didn't bet)



PokerStars Zoom Hand #172696374957:  Hold'em No Limit ($0.01/$0.02) - 2017/07/06 18:21:21 ET
Table 'McNaught' 9-max Seat #1 is the button
Seat 1: Redvin33 ($2.43 in chips) 
Seat 2: NJoy2Win ($8.62 in chips) 
Seat 3: red13rum ($5.54 in chips) 
Seat 4: Schdoerrchen ($3.23 in chips) 
Seat 5: bicho1040 ($2.08 in chips) 
Seat 6: Gorwfwefwed ($3.89 in chips) 
Seat 7: Svetlana2962 ($2.75 in chips) 
Seat 8: PaRaNoYa01 ($2.34 in chips) 
Seat 9: aleks118 ($1.99 in chips) 
NJoy2Win: posts small blind $0.01
red13rum: posts big blind $0.02
*** HOLE CARDS ***
Dealt to Redvin33 [5h Ts]
Schdoerrchen: folds 
bicho1040: folds 
Gorwfwefwed: folds 
Svetlana2962: folds 
PaRaNoYa01: folds 
aleks118: raises $0.03 to $0.05
Redvin33: folds 
NJoy2Win: folds 
red13rum: folds 
Uncalled bet ($0.03) returned to aleks118
aleks118 collected $0.05 from pot
aleks118: doesn't show hand 
*** SUMMARY ***
Total pot $0.05 | Rake $0 
Seat 1: Redvin33 (button) folded before Flop (didn't bet)
Seat 2: NJoy2Win (small blind) folded before Flop
Seat 3: red13rum (big blind) folded before Flop
Seat 4: Schdoerrchen folded before Flop (didn't bet)
Seat 5: bicho1040 folded before Flop (didn't bet)
Seat 6: Gorwfwefwed folded before Flop (didn't bet)
Seat 7: Svetlana2962 folded before Flop (didn't bet)
Seat 8: PaRaNoYa01 folded before Flop (didn't bet)
Seat 9: aleks118 collected ($0.05)



PokerStars Zoom Hand #172696377708:  Hold'em No Limit ($0.01/$0.02) - 2017/07/06 18:21:25 ET
Table 'McNaught' 9-max Seat #1 is the button
Seat 1: naoya1929 ($1.47 in chips) 
Seat 2: Cayoosh16 ($1.75 in chips) 
Seat 3: ArthurStk ($2.02 in chips) 
Seat 4: O_Atec ($3.52 in chips) 
Seat 5: V. Regeis ($2.46 in chips) 
Seat 6: PoWeRBaRd ($4.26 in chips) 
Seat 7: Rishnu Fr ($2.03 in chips) 
Seat 8: SandroVM ($1.97 in chips) 
Seat 9: Redvin33 ($2.43 in chips) 
Cayoosh16: posts small blind $0.01
ArthurStk: posts big blind $0.02
*** HOLE CARDS ***
Dealt to Redvin33 [9d As]
O_Atec: folds 
V. Regeis: folds 
PoWeRBaRd: folds 
Rishnu Fr: folds 
SandroVM: folds 
Redvin33: calls $0.02
naoya1929: folds 
Cayoosh16: folds 
ArthurStk: raises $0.06 to $0.08
Redvin33: calls $0.06
*** FLOP *** [Ks 8c 2d]
ArthurStk: bets $0.09
Redvin33: folds 
Uncalled bet ($0.09) returned to ArthurStk
ArthurStk collected $0.16 from pot
ArthurStk: doesn't show hand 
*** SUMMARY ***
Total pot $0.17 | Rake $0.01 
Board [Ks 8c 2d]
Seat 1: naoya1929 (button) folded before Flop (didn't bet)
Seat 2: Cayoosh16 (small blind) folded before Flop
Seat 3: ArthurStk (big blind) collected ($0.16)
Seat 4: O_Atec folded before Flop (didn't bet)
Seat 5: V. Regeis folded before Flop (didn't bet)
Seat 6: PoWeRBaRd folded before Flop (didn't bet)
Seat 7: Rishnu Fr folded before Flop (didn't bet)
Seat 8: SandroVM folded before Flop (didn't bet)
Seat 9: Redvin33 folded on the Flop



PokerStars Zoom Hand #172696391532:  Hold'em No Limit ($0.01/$0.02) - 2017/07/06 18:21:45 ET
Table 'McNaught' 9-max Seat #1 is the button
Seat 1: nightspeaker ($1.93 in chips) 
Seat 2: serg197211 ($2.35 in chips) 
Seat 3: morpheus119 ($2 in chips) 
Seat 4: vycheslav d ($1.14 in chips) 
Seat 5: Ksan5979 ($2 in chips) 
Seat 6: AJIEKC ($1.77 in chips) 
Seat 7: Redvin33 ($2.35 in chips) 
Seat 8: olsche74 ($0.71 in chips) 
Seat 9: Jaffar999 ($1.94 in chips) 
serg197211: posts small blind $0.01
morpheus119: posts big blind $0.02
*** HOLE CARDS ***
Dealt to Redvin33 [Qs Qc]
vycheslav d: folds 
Ksan5979: folds 
AJIEKC: folds 
Redvin33: raises $0.03 to $0.05
olsche74: folds 
Jaffar999: folds 
nightspeaker: folds 
serg197211: folds 
morpheus119: folds 
Uncalled bet ($0.03) returned to Redvin33
Redvin33 collected $0.05 from pot
Redvin33: doesn't show hand 
*** SUMMARY ***
Total pot $0.05 | Rake $0 
Seat 1: nightspeaker (button) folded before Flop (didn't bet)
Seat 2: serg197211 (small blind) folded before Flop
Seat 3: morpheus119 (big blind) folded before Flop
Seat 4: vycheslav d folded before Flop (didn't bet)
Seat 5: Ksan5979 folded before Flop (didn't bet)
Seat 6: AJIEKC folded before Flop (didn't bet)
Seat 7: Redvin33 collected ($0.05)
Seat 8: olsche74 folded before Flop (didn't bet)
Seat 9: Jaffar999 folded before Flop (didn't bet)



PokerStars Zoom Hand #172696401990:  Hold'em No Limit ($0.01/$0.02) - 2017/07/06 18:22:00 ET
Table 'McNaught' 9-max Seat #1 is the button
Seat 1: lion.1st ($2.13 in chips) 
Seat 2: Krja000 ($2.64 in chips) 
Seat 3: Redvin33 ($2.38 in chips) 
Seat 4: Thesmos ($0.17 in chips) 
Seat 5: Babettka ($2 in chips) 
Seat 6: Lucas Cremer ($1 in chips) 
Seat 7: Cayoosh16 ($1.87 in chips) 
Seat 8: didier.rouss ($1.07 in chips) 
Seat 9: SandroVM ($1.94 in chips) 
Krja000: posts small blind $0.01
Redvin33: posts big blind $0.02
*** HOLE CARDS ***
Dealt to Redvin33 [As 2c]
Thesmos: folds 
Babettka: folds 
Lucas Cremer: folds 
Cayoosh16: raises $0.04 to $0.06
didier.rouss: folds 
SandroVM: folds 
lion.1st: folds 
Krja000: folds 
Redvin33: calls $0.04
*** FLOP *** [5s 6c 4s]
Redvin33: bets $0.13
Cayoosh16: folds 
Uncalled bet ($0.13) returned to Redvin33
Redvin33 collected $0.13 from pot
Redvin33: doesn't show hand 
*** SUMMARY ***
Total pot $0.13 | Rake $0 
Board [5s 6c 4s]
Seat 1: lion.1st (button) folded before Flop (didn't bet)
Seat 2: Krja000 (small blind) folded before Flop
Seat 3: Redvin33 (big blind) collected ($0.13)
Seat 4: Thesmos folded before Flop (didn't bet)
Seat 5: Babettka folded before Flop (didn't bet)
Seat 6: Lucas Cremer folded before Flop (didn't bet)
Seat 7: Cayoosh16 folded on the Flop
Seat 8: didier.rouss folded before Flop (didn't bet)
Seat 9: SandroVM folded before Flop (didn't bet)



PokerStars Zoom Hand #172696424625:  Hold'em No Limit ($0.01/$0.02) - 2017/07/06 18:22:33 ET
Table 'McNaught' 9-max Seat #1 is the button
Seat 1: ct189 ($0.39 in chips) 
Seat 2: scorpion2680 ($0.99 in chips) 
Seat 3: robertomuc ($2.68 in chips) 
Seat 4: Zoddoss ($2 in chips) 
Seat 5: Redvin33 ($2.45 in chips) 
Seat 6: SUPERCARLAO ($2.03 in chips) 
Seat 7: TheCoelhao ($2.90 in chips) 
Seat 8: daysoflyser ($0.97 in chips) 
Seat 9: Gorwfwefwed ($3.86 in chips) 
scorpion2680: posts small blind $0.01
robertomuc: posts big blind $0.02
*** HOLE CARDS ***
Dealt to Redvin33 [6s Tc]
Zoddoss: folds 
Redvin33: folds 
SUPERCARLAO: folds 
TheCoelhao: folds 
daysoflyser: folds 
Gorwfwefwed: raises $0.04 to $0.06
ct189: raises $0.33 to $0.39 and is all-in
scorpion2680: folds 
robertomuc: folds 
Gorwfwefwed: calls $0.33
*** FLOP *** [Js 7d Qd]
*** TURN *** [Js 7d Qd] [5s]
*** RIVER *** [Js 7d Qd 5s] [5h]
*** SHOW DOWN ***
Gorwfwefwed: shows [Ks Ac] (a pair of Fives)
ct189: shows [Kh Kc] (two pair, Kings and Fives)
ct189 collected $0.78 from pot
*** SUMMARY ***
Total pot $0.81 | Rake $0.03 
Board [Js 7d Qd 5s 5h]
Seat 1: ct189 (button) showed [Kh Kc] and won ($0.78) with two pair, Kings and Fives
Seat 2: scorpion2680 (small blind) folded before Flop
Seat 3: robertomuc (big blind) folded before Flop
Seat 4: Zoddoss folded before Flop (didn't bet)
Seat 5: Redvin33 folded before Flop (didn't bet)
Seat 6: SUPERCARLAO folded before Flop (didn't bet)
Seat 7: TheCoelhao folded before Flop (didn't bet)
Seat 8: daysoflyser folded before Flop (didn't bet)
Seat 9: Gorwfwefwed showed [Ks Ac] and lost with a pair of Fives



PokerStars Zoom Hand #172696435508:  Hold'em No Limit ($0.01/$0.02) - 2017/07/06 18:22:49 ET
Table 'McNaught' 9-max Seat #1 is the button
Seat 1: lion.1st ($2.24 in chips) 
Seat 2: Redvin33 ($2.45 in chips) 
Seat 3: Piperka777 ($2.79 in chips) 
Seat 4: COULEUR7 ($2 in chips) 
Seat 5: mirofa ($4.12 in chips) 
Seat 6: Taraba68 ($2.30 in chips) 
Seat 7: Haczlo ($2.54 in chips) 
Seat 8: denzell574 ($1.80 in chips) 
Seat 9: Xamil666 ($5.12 in chips) 
Redvin33: posts small blind $0.01
Piperka777: posts big blind $0.02
*** HOLE CARDS ***
Dealt to Redvin33 [3c Kd]
COULEUR7: folds 
mirofa: raises $0.04 to $0.06
Taraba68: folds 
Haczlo: folds 
denzell574: folds 
Xamil666: folds 
lion.1st: folds 
Redvin33: folds 
Piperka777: folds 
Uncalled bet ($0.04) returned to mirofa
mirofa collected $0.05 from pot
mirofa: doesn't show hand 
*** SUMMARY ***
Total pot $0.05 | Rake $0 
Seat 1: lion.1st (button) folded before Flop (didn't bet)
Seat 2: Redvin33 (small blind) folded before Flop
Seat 3: Piperka777 (big blind) folded before Flop
Seat 4: COULEUR7 folded before Flop (didn't bet)
Seat 5: mirofa collected ($0.05)
Seat 6: Taraba68 folded before Flop (didn't bet)
Seat 7: Haczlo folded before Flop (didn't bet)
Seat 8: denzell574 folded before Flop (didn't bet)
Seat 9: Xamil666 folded before Flop (didn't bet)



PokerStars Zoom Hand #172696430066:  Hold'em No Limit ($0.01/$0.02) - 2017/07/06 18:22:41 ET
Table 'McNaught' 9-max Seat #1 is the button
Seat 1: mercurio0359 ($1.57 in chips) 
Seat 2: robertomuc ($2.96 in chips) 
Seat 3: aleks118 ($2.14 in chips) 
Seat 4: viagem ($5.42 in chips) 
Seat 5: Dayterius ($2.66 in chips) 
Seat 6: SpaSitelqT ($2.27 in chips) 
Seat 7: Cnopic666 ($4.87 in chips) 
Seat 8: Redvin33 ($2.45 in chips) 
Seat 9: victordyfox ($1.89 in chips) 
robertomuc: posts small blind $0.01
aleks118: posts big blind $0.02
*** HOLE CARDS ***
Dealt to Redvin33 [8c 5c]
viagem: folds 
Dayterius: folds 
SpaSitelqT: folds 
Cnopic666: folds 
Redvin33: folds 
victordyfox: folds 
mercurio0359: raises $0.04 to $0.06
robertomuc: folds 
aleks118: raises $0.13 to $0.19
mercurio0359: folds 
Uncalled bet ($0.13) returned to aleks118
aleks118 collected $0.13 from pot
aleks118: doesn't show hand 
*** SUMMARY ***
Total pot $0.13 | Rake $0 
Seat 1: mercurio0359 (button) folded before Flop
Seat 2: robertomuc (small blind) folded before Flop
Seat 3: aleks118 (big blind) collected ($0.13)
Seat 4: viagem folded before Flop (didn't bet)
Seat 5: Dayterius folded before Flop (didn't bet)
Seat 6: SpaSitelqT folded before Flop (didn't bet)
Seat 7: Cnopic666 folded before Flop (didn't bet)
Seat 8: Redvin33 folded before Flop (didn't bet)
Seat 9: victordyfox folded before Flop (didn't bet)



PokerStars Zoom Hand #172696427339:  Hold'em No Limit ($0.01/$0.02) - 2017/07/06 18:22:37 ET
Table 'McNaught' 9-max Seat #1 is the button
Seat 1: Zoddoss ($2 in chips) 
Seat 2: s.v.armodios ($6.67 in chips) 
Seat 3: ArthurStk ($2.09 in chips) 
Seat 4: W1zard2008 ($1.99 in chips) 
Seat 5: Redvin33 ($2.45 in chips) 
Seat 6: Krja000 ($2.63 in chips) 
Seat 7: SandroVM ($1.97 in chips) 
Seat 8: COULEUR7 ($2 in chips) 
Seat 9: 3thirteen616 ($3.08 in chips) 
s.v.armodios: posts small blind $0.01
ArthurStk: posts big blind $0.02
*** HOLE CARDS ***
Dealt to Redvin33 [Kh 4s]
W1zard2008: folds 
Redvin33: folds 
Krja000: raises $0.04 to $0.06
SandroVM: folds 
COULEUR7: folds 
3thirteen616: folds 
Zoddoss: folds 
s.v.armodios: folds 
ArthurStk: raises $0.12 to $0.18
Krja000: folds 
Uncalled bet ($0.12) returned to ArthurStk
ArthurStk collected $0.13 from pot
ArthurStk: doesn't show hand 
*** SUMMARY ***
Total pot $0.13 | Rake $0 
Seat 1: Zoddoss (button) folded before Flop (didn't bet)
Seat 2: s.v.armodios (small blind) folded before Flop
Seat 3: ArthurStk (big blind) collected ($0.13)
Seat 4: W1zard2008 folded before Flop (didn't bet)
Seat 5: Redvin33 folded before Flop (didn't bet)
Seat 6: Krja000 folded before Flop
Seat 7: SandroVM folded before Flop (didn't bet)
Seat 8: COULEUR7 folded before Flop (didn't bet)
Seat 9: 3thirteen616 folded before Flop (didn't bet)



PokerStars Zoom Hand #172696432798:  Hold'em No Limit ($0.01/$0.02) - 2017/07/06 18:22:45 ET
Table 'McNaught' 9-max Seat #1 is the button
Seat 1: lion.1st ($1.97 in chips) 
Seat 2: JeffersonWd ($1.77 in chips) 
Seat 3: unlea5h ($1.29 in chips) 
Seat 4: Redvin33 ($2.45 in chips) 
Seat 5: SweetPlay777 ($2.05 in chips) 
Seat 6: smopuim ($2.84 in chips) 
Seat 7: Cayoosh16 ($1.33 in chips) 
Seat 8: Grimm Araan ($0.84 in chips) 
Seat 9: Xamil666 ($4.36 in chips) 
JeffersonWd: posts small blind $0.01
unlea5h: posts big blind $0.02
*** HOLE CARDS ***
Dealt to Redvin33 [8s 2s]
Redvin33: folds 
SweetPlay777: raises $0.06 to $0.08
smopuim: folds 
Cayoosh16: folds 
Grimm Araan: calls $0.08
Xamil666: folds 
lion.1st: folds 
JeffersonWd: folds 
unlea5h: calls $0.06
*** FLOP *** [3d 9s 5h]
unlea5h: checks 
SweetPlay777: checks 
Grimm Araan: checks 
*** TURN *** [3d 9s 5h] [Jc]
unlea5h: bets $0.08
SweetPlay777: folds 
Grimm Araan: calls $0.08
*** RIVER *** [3d 9s 5h Jc] [3s]
unlea5h: bets $0.08
Grimm Araan: calls $0.08
*** SHOW DOWN ***
unlea5h: shows [Jh Qs] (two pair, Jacks and Threes)
Grimm Araan: shows [Jd Ac] (two pair, Jacks and Threes - Ace kicker)
Grimm Araan collected $0.55 from pot
*** SUMMARY ***
Total pot $0.57 | Rake $0.02 
Board [3d 9s 5h Jc 3s]
Seat 1: lion.1st (button) folded before Flop (didn't bet)
Seat 2: JeffersonWd (small blind) folded before Flop
Seat 3: unlea5h (big blind) showed [Jh Qs] and lost with two pair, Jacks and Threes
Seat 4: Redvin33 folded before Flop (didn't bet)
Seat 5: SweetPlay777 folded on the Turn
Seat 6: smopuim folded before Flop (didn't bet)
Seat 7: Cayoosh16 folded before Flop (didn't bet)
Seat 8: Grimm Araan showed [Jd Ac] and won ($0.55) with two pair, Jacks and Threes
Seat 9: Xamil666 folded before Flop (didn't bet)



PokerStars Zoom Hand #172696421911:  Hold'em No Limit ($0.01/$0.02) - 2017/07/06 18:22:29 ET
Table 'McNaught' 9-max Seat #1 is the button
Seat 1: Brianezi ($0.82 in chips) 
Seat 2: victordyfox ($0.69 in chips) 
Seat 3: Tsybulya ($7.05 in chips) 
Seat 4: serg197211 ($2 in chips) 
Seat 5: Schdoerrchen ($3.35 in chips) 
Seat 6: Redvin33 ($2.45 in chips) 
Seat 7: REISR18 ($12.35 in chips) 
Seat 8: babaevv0 ($4.92 in chips) 
Seat 9: FidgetyWins ($2.22 in chips) 
victordyfox: posts small blind $0.01
Tsybulya: posts big blind $0.02
*** HOLE CARDS ***
Dealt to Redvin33 [4c Js]
serg197211: folds 
Schdoerrchen: raises $0.04 to $0.06
Redvin33: folds 
REISR18: folds 
babaevv0: folds 
FidgetyWins: folds 
Brianezi: raises $0.06 to $0.12
victordyfox: folds 
Tsybulya: calls $0.10
Schdoerrchen: calls $0.06
*** FLOP *** [4d 6h 5s]
Tsybulya: checks 
Schdoerrchen: checks 
Brianezi: bets $0.18
Tsybulya: raises $0.63 to $0.81
Schdoerrchen: calls $0.81
Brianezi: calls $0.52 and is all-in
*** TURN *** [4d 6h 5s] [8d]
Tsybulya: bets $2.26
Schdoerrchen: calls $2.26
*** RIVER *** [4d 6h 5s 8d] [7s]
Tsybulya: bets $0.02
Schdoerrchen: calls $0.02
*** SHOW DOWN ***
Tsybulya: shows [Jd Jh] (a straight, Four to Eight)
Schdoerrchen: shows [6s 6c] (a straight, Four to Eight)
Tsybulya collected $2.31 from side pot
Schdoerrchen collected $2.31 from side pot
Brianezi: shows [Qc Qs] (a straight, Four to Eight)
Tsybulya collected $0.80 from main pot
Schdoerrchen collected $0.79 from main pot
Brianezi collected $0.79 from main pot
*** SUMMARY ***
Total pot $7.25 Main pot $2.38. Side pot $4.62. | Rake $0.25 
Board [4d 6h 5s 8d 7s]
Seat 1: Brianezi (button) showed [Qc Qs] and won ($0.79) with a straight, Four to Eight
Seat 2: victordyfox (small blind) folded before Flop
Seat 3: Tsybulya (big blind) showed [Jd Jh] and won ($3.11) with a straight, Four to Eight
Seat 4: serg197211 folded before Flop (didn't bet)
Seat 5: Schdoerrchen showed [6s 6c] and won ($3.10) with a straight, Four to Eight
Seat 6: Redvin33 folded before Flop (didn't bet)
Seat 7: REISR18 folded before Flop (didn't bet)
Seat 8: babaevv0 folded before Flop (didn't bet)
Seat 9: FidgetyWins folded before Flop (didn't bet)



PokerStars Zoom Hand #172696438203:  Hold'em No Limit ($0.01/$0.02) - 2017/07/06 18:22:53 ET
Table 'McNaught' 9-max Seat #1 is the button
Seat 1: Redvin33 ($2.44 in chips) 
Seat 2: Strateg99 ($1.02 in chips) 
Seat 3: 3thirteen616 ($2.03 in chips) 
Seat 4: lion.1st ($1.80 in chips) 
Seat 5: FidgetyWins ($2.22 in chips) 
Seat 6: YOHONSON ($2.21 in chips) 
Seat 7: bediboy ($2 in chips) 
Seat 8: leonardosnc ($0.37 in chips) 
Seat 9: red13rum ($5.37 in chips) 
Strateg99: posts small blind $0.01
3thirteen616: posts big blind $0.02
*** HOLE CARDS ***
Dealt to Redvin33 [Tc Qh]
lion.1st: folds 
FidgetyWins: folds 
YOHONSON: folds 
bediboy: folds 
leonardosnc: calls $0.02
red13rum: folds 
Redvin33: raises $0.03 to $0.05
Strateg99: folds 
3thirteen616: folds 
leonardosnc: calls $0.03
*** FLOP *** [6h 5s Td]
leonardosnc: checks 
Redvin33: bets $0.04
leonardosnc: calls $0.04
*** TURN *** [6h 5s Td] [4h]
leonardosnc: checks 
Redvin33: bets $2.35 and is all-in
leonardosnc: folds 
Uncalled bet ($2.35) returned to Redvin33
Redvin33 collected $0.20 from pot
Redvin33: doesn't show hand 
*** SUMMARY ***
Total pot $0.21 | Rake $0.01 
Board [6h 5s Td 4h]
Seat 1: Redvin33 (button) collected ($0.20)
Seat 2: Strateg99 (small blind) folded before Flop
Seat 3: 3thirteen616 (big blind) folded before Flop
Seat 4: lion.1st folded before Flop (didn't bet)
Seat 5: FidgetyWins folded before Flop (didn't bet)
Seat 6: YOHONSON folded before Flop (didn't bet)
Seat 7: bediboy folded before Flop (didn't bet)
Seat 8: leonardosnc folded on the Turn
Seat 9: red13rum folded before Flop (didn't bet)



PokerStars Zoom Hand #172696468522:  Hold'em No Limit ($0.01/$0.02) - 2017/07/06 18:23:37 ET
Table 'McNaught' 9-max Seat #1 is the button
Seat 1: Artem23Ka ($5.32 in chips) 
Seat 2: Lifecards7 ($2 in chips) 
Seat 3: Gamer577 ($2 in chips) 
Seat 4: Ksan5979 ($2.27 in chips) 
Seat 5: Unconform ($2 in chips) 
Seat 6: Redvin33 ($2.55 in chips) 
Seat 7: LUKIANOV777 ($2.61 in chips) 
Seat 8: JeffersonWd ($1.76 in chips) 
Seat 9: colmcc ($3.78 in chips) 
Lifecards7: posts small blind $0.01
Gamer577: posts big blind $0.02
*** HOLE CARDS ***
Dealt to Redvin33 [2c 5d]
Ksan5979: folds 
Unconform: folds 
Redvin33: folds 
LUKIANOV777: folds 
JeffersonWd: folds 
colmcc: raises $0.04 to $0.06
Artem23Ka: raises $0.12 to $0.18
Lifecards7: folds 
Gamer577: folds 
colmcc: folds 
Uncalled bet ($0.12) returned to Artem23Ka
Artem23Ka collected $0.15 from pot
Artem23Ka: doesn't show hand 
*** SUMMARY ***
Total pot $0.15 | Rake $0 
Seat 1: Artem23Ka (button) collected ($0.15)
Seat 2: Lifecards7 (small blind) folded before Flop
Seat 3: Gamer577 (big blind) folded before Flop
Seat 4: Ksan5979 folded before Flop (didn't bet)
Seat 5: Unconform folded before Flop (didn't bet)
Seat 6: Redvin33 folded before Flop (didn't bet)
Seat 7: LUKIANOV777 folded before Flop (didn't bet)
Seat 8: JeffersonWd folded before Flop (didn't bet)
Seat 9: colmcc folded before Flop



PokerStars Zoom Hand #172696471248:  Hold'em No Limit ($0.01/$0.02) - 2017/07/06 18:23:41 ET
Table 'McNaught' 9-max Seat #1 is the button
Seat 1: nightspeaker ($1.89 in chips) 
Seat 2: smopuim ($2.90 in chips) 
Seat 3: Agares91 ($2 in chips) 
Seat 4: tzogos1989 ($4.05 in chips) 
Seat 5: bicho1040 ($2.53 in chips) 
Seat 6: komarkoff ($2.46 in chips) 
Seat 7: Redvin33 ($2.55 in chips) 
Seat 8: Strateg99 ($1.01 in chips) 
Seat 9: japu2010 ($2.32 in chips) 
smopuim: posts small blind $0.01
Agares91: posts big blind $0.02
*** HOLE CARDS ***
Dealt to Redvin33 [Qc 8c]
tzogos1989: raises $0.05 to $0.07
bicho1040: folds 
komarkoff: folds 
Redvin33: folds 
Strateg99: folds 
japu2010: calls $0.07
nightspeaker: raises $0.15 to $0.22
smopuim: folds 
Agares91: folds 
tzogos1989: raises $0.54 to $0.76
japu2010: folds 
nightspeaker: raises $1.13 to $1.89 and is all-in
tzogos1989: calls $1.13
*** FLOP *** [Kd 4d 3h]
*** TURN *** [Kd 4d 3h] [5h]
*** RIVER *** [Kd 4d 3h 5h] [9h]
*** SHOW DOWN ***
tzogos1989: shows [Jd Js] (a pair of Jacks)
nightspeaker: shows [Qh Qs] (a pair of Queens)
nightspeaker collected $3.74 from pot
*** SUMMARY ***
Total pot $3.88 | Rake $0.14 
Board [Kd 4d 3h 5h 9h]
Seat 1: nightspeaker (button) showed [Qh Qs] and won ($3.74) with a pair of Queens
Seat 2: smopuim (small blind) folded before Flop
Seat 3: Agares91 (big blind) folded before Flop
Seat 4: tzogos1989 showed [Jd Js] and lost with a pair of Jacks
Seat 5: bicho1040 folded before Flop (didn't bet)
Seat 6: komarkoff folded before Flop (didn't bet)
Seat 7: Redvin33 folded before Flop (didn't bet)
Seat 8: Strateg99 folded before Flop (didn't bet)
Seat 9: japu2010 folded before Flop



PokerStars Zoom Hand #172696474683:  Hold'em No Limit ($0.01/$0.02) - 2017/07/06 18:23:46 ET
Table 'McNaught' 9-max Seat #1 is the button
Seat 1: Brucechiou ($2.09 in chips) 
Seat 2: ArthurStk ($1.65 in chips) 
Seat 3: Sympathya ($2.73 in chips) 
Seat 4: nerml000 ($1.28 in chips) 
Seat 5: FidgetyWins ($2 in chips) 
Seat 6: filipov1976 ($3.96 in chips) 
Seat 7: madin683 ($2.61 in chips) 
Seat 8: scorpion2680 ($0.95 in chips) 
Seat 9: Redvin33 ($2.55 in chips) 
ArthurStk: posts small blind $0.01
Sympathya: posts big blind $0.02
*** HOLE CARDS ***
Dealt to Redvin33 [7d 7h]
nerml000: folds 
FidgetyWins: folds 
filipov1976: raises $0.06 to $0.08
madin683: folds 
scorpion2680: folds 
Redvin33: calls $0.08
Brucechiou: folds 
ArthurStk: folds 
Sympathya: calls $0.06
*** FLOP *** [Qd 5c Ac]
Sympathya: checks 
filipov1976: checks 
Redvin33: bets $0.10
Sympathya: folds 
filipov1976: calls $0.10
*** TURN *** [Qd 5c Ac] [2d]
filipov1976: checks 
Redvin33: checks 
*** RIVER *** [Qd 5c Ac 2d] [Jd]
filipov1976: checks 
Redvin33: bets $0.20
filipov1976: calls $0.20
*** SHOW DOWN ***
Redvin33: shows [7d 7h] (a pair of Sevens)
filipov1976: shows [Kc Ks] (a pair of Kings)
filipov1976 collected $0.82 from pot
*** SUMMARY ***
Total pot $0.85 | Rake $0.03 
Board [Qd 5c Ac 2d Jd]
Seat 1: Brucechiou (button) folded before Flop (didn't bet)
Seat 2: ArthurStk (small blind) folded before Flop
Seat 3: Sympathya (big blind) folded on the Flop
Seat 4: nerml000 folded before Flop (didn't bet)
Seat 5: FidgetyWins folded before Flop (didn't bet)
Seat 6: filipov1976 showed [Kc Ks] and won ($0.82) with a pair of Kings
Seat 7: madin683 folded before Flop (didn't bet)
Seat 8: scorpion2680 folded before Flop (didn't bet)
Seat 9: Redvin33 showed [7d 7h] and lost with a pair of Sevens



PokerStars Zoom Hand #172696511558:  Hold'em No Limit ($0.01/$0.02) - 2017/07/06 18:24:40 ET
Table 'McNaught' 9-max Seat #1 is the button
Seat 1: ntr2xit ($2 in chips) 
Seat 2: lemeco ($1.93 in chips) 
Seat 3: christina 1989 ($5.33 in chips) 
Seat 4: ArthurStk ($2 in chips) 
Seat 5: Redvin33 ($2.17 in chips) 
Seat 6: serg197211 ($2.86 in chips) 
Seat 7: nerml000 ($2.06 in chips) 
Seat 8: Brucechiou ($3.66 in chips) 
Seat 9: JeffersonWd ($3.66 in chips) 
lemeco: posts small blind $0.01
christina 1989: posts big blind $0.02
*** HOLE CARDS ***
Dealt to Redvin33 [Qs 4s]
ArthurStk: raises $0.04 to $0.06
Redvin33: folds 
serg197211: folds 
nerml000: folds 
Brucechiou: folds 
JeffersonWd: folds 
ntr2xit: folds 
lemeco: folds 
christina 1989: calls $0.04
*** FLOP *** [4c 9d 5c]
christina 1989: checks 
ArthurStk: bets $0.07
christina 1989: folds 
Uncalled bet ($0.07) returned to ArthurStk
ArthurStk collected $0.13 from pot
ArthurStk: doesn't show hand 
*** SUMMARY ***
Total pot $0.13 | Rake $0 
Board [4c 9d 5c]
Seat 1: ntr2xit (button) folded before Flop (didn't bet)
Seat 2: lemeco (small blind) folded before Flop
Seat 3: christina 1989 (big blind) folded on the Flop
Seat 4: ArthurStk collected ($0.13)
Seat 5: Redvin33 folded before Flop (didn't bet)
Seat 6: serg197211 folded before Flop (didn't bet)
Seat 7: nerml000 folded before Flop (didn't bet)
Seat 8: Brucechiou folded before Flop (didn't bet)
Seat 9: JeffersonWd folded before Flop (didn't bet)



PokerStars Zoom Hand #172696514264:  Hold'em No Limit ($0.01/$0.02) - 2017/07/06 18:24:44 ET
Table 'McNaught' 9-max Seat #1 is the button
Seat 1: didier.rouss ($0.88 in chips) 
Seat 2: dmitrychuk ($2.09 in chips) 
Seat 3: Redvin33 ($2.17 in chips) 
Seat 4: deichgraf000 ($6.57 in chips) 
Seat 5: leloloco100 ($0.81 in chips) 
Seat 6: MACJERSON ($0.37 in chips) 
Seat 7: FidgetyWins ($2.08 in chips) 
Seat 8: batiraki13 ($2.08 in chips) 
Seat 9: Sympathya ($2.77 in chips) 
dmitrychuk: posts small blind $0.01
Redvin33: posts big blind $0.02
*** HOLE CARDS ***
Dealt to Redvin33 [2s 4s]
deichgraf000: folds 
leloloco100: folds 
MACJERSON: folds 
FidgetyWins: folds 
batiraki13: folds 
Sympathya: raises $0.04 to $0.06
didier.rouss: calls $0.06
dmitrychuk: folds 
Redvin33: folds 
*** FLOP *** [8h Td 5c]
Sympathya: bets $0.07
didier.rouss: calls $0.07
*** TURN *** [8h Td 5c] [As]
Sympathya: bets $0.16
didier.rouss: calls $0.16
*** RIVER *** [8h Td 5c As] [5d]
Sympathya: checks 
didier.rouss: checks 
*** SHOW DOWN ***
Sympathya: shows [Kh Jh] (a pair of Fives)
didier.rouss: shows [8s Ks] (two pair, Eights and Fives)
didier.rouss collected $0.59 from pot
*** SUMMARY ***
Total pot $0.61 | Rake $0.02 
Board [8h Td 5c As 5d]
Seat 1: didier.rouss (button) showed [8s Ks] and won ($0.59) with two pair, Eights and Fives
Seat 2: dmitrychuk (small blind) folded before Flop
Seat 3: Redvin33 (big blind) folded before Flop
Seat 4: deichgraf000 folded before Flop (didn't bet)
Seat 5: leloloco100 folded before Flop (didn't bet)
Seat 6: MACJERSON folded before Flop (didn't bet)
Seat 7: FidgetyWins folded before Flop (didn't bet)
Seat 8: batiraki13 folded before Flop (didn't bet)
Seat 9: Sympathya showed [Kh Jh] and lost with a pair of Fives



PokerStars Zoom Hand #172696520332:  Hold'em No Limit ($0.01/$0.02) - 2017/07/06 18:24:53 ET
Table 'McNaught' 9-max Seat #1 is the button
Seat 1: Gamer577 ($2 in chips) 
Seat 2: Redvin33 ($2.15 in chips) 
Seat 3: Fr0l0FF ($1 in chips) 
Seat 4: VOLOOOODYA ($7.87 in chips) 
Seat 5: batiraki13 ($2 in chips) 
Seat 6: Brucechiou ($3.66 in chips) 
Seat 7: KaHcTpykTap ($2.49 in chips) 
Seat 8: 3thirteen616 ($2 in chips) 
Seat 9: smopuim ($2.84 in chips) 
Redvin33: posts small blind $0.01
Fr0l0FF: posts big blind $0.02
*** HOLE CARDS ***
Dealt to Redvin33 [As Js]
VOLOOOODYA: folds 
batiraki13: folds 
Brucechiou: raises $0.04 to $0.06
KaHcTpykTap: folds 
3thirteen616: folds 
smopuim: folds 
Gamer577: folds 
Redvin33: calls $0.05
Fr0l0FF: folds 
*** FLOP *** [9s 4d 7c]
Redvin33: bets $0.07
Brucechiou: calls $0.07
*** TURN *** [9s 4d 7c] [Td]
Redvin33: bets $0.06
Brucechiou: raises $0.26 to $0.32
Redvin33: folds 
Uncalled bet ($0.26) returned to Brucechiou
Brucechiou collected $0.39 from pot
Brucechiou: doesn't show hand 
*** SUMMARY ***
Total pot $0.40 | Rake $0.01 
Board [9s 4d 7c Td]
Seat 1: Gamer577 (button) folded before Flop (didn't bet)
Seat 2: Redvin33 (small blind) folded on the Turn
Seat 3: Fr0l0FF (big blind) folded before Flop
Seat 4: VOLOOOODYA folded before Flop (didn't bet)
Seat 5: batiraki13 folded before Flop (didn't bet)
Seat 6: Brucechiou collected ($0.39)
Seat 7: KaHcTpykTap folded before Flop (didn't bet)
Seat 8: 3thirteen616 folded before Flop (didn't bet)
Seat 9: smopuim folded before Flop (didn't bet)



PokerStars Zoom Hand #172696544882:  Hold'em No Limit ($0.01/$0.02) - 2017/07/06 18:25:29 ET
Table 'McNaught' 9-max Seat #1 is the button
Seat 1: W1zard2008 ($1.62 in chips) 
Seat 2: ntr2xit ($2 in chips) 
Seat 3: QuasarGP ($1.88 in chips) 
Seat 4: denzell574 ($2.25 in chips) 
Seat 5: 3thirteen616 ($3.02 in chips) 
Seat 6: bediboy ($2.01 in chips) 
Seat 7: duartt11 ($1.37 in chips) 
Seat 8: Redvin33 ($1.96 in chips) 
Seat 9: Gamer577 ($2 in chips) 
ntr2xit: posts small blind $0.01
QuasarGP: posts big blind $0.02
*** HOLE CARDS ***
Dealt to Redvin33 [8c 6c]
denzell574: folds 
3thirteen616: folds 
bediboy: raises $0.06 to $0.08
duartt11: folds 
Redvin33: folds 
Gamer577: folds 
W1zard2008: folds 
ntr2xit: folds 
QuasarGP: folds 
Uncalled bet ($0.06) returned to bediboy
bediboy collected $0.05 from pot
bediboy: doesn't show hand 
*** SUMMARY ***
Total pot $0.05 | Rake $0 
Seat 1: W1zard2008 (button) folded before Flop (didn't bet)
Seat 2: ntr2xit (small blind) folded before Flop
Seat 3: QuasarGP (big blind) folded before Flop
Seat 4: denzell574 folded before Flop (didn't bet)
Seat 5: 3thirteen616 folded before Flop (didn't bet)
Seat 6: bediboy collected ($0.05)
Seat 7: duartt11 folded before Flop (didn't bet)
Seat 8: Redvin33 folded before Flop (didn't bet)
Seat 9: Gamer577 folded before Flop (didn't bet)



PokerStars Zoom Hand #172696547659:  Hold'em No Limit ($0.01/$0.02) - 2017/07/06 18:25:33 ET
Table 'McNaught' 9-max Seat #1 is the button
Seat 1: ArgusLL ($2.07 in chips) 
Seat 2: MACJERSON ($0.38 in chips) 
Seat 3: Xamil666 ($3.02 in chips) 
Seat 4: olsche74 ($1.31 in chips) 
Seat 5: TeamTrousers ($0.96 in chips) 
Seat 6: Gorwfwefwed ($3.52 in chips) 
Seat 7: Redvin33 ($1.96 in chips) 
Seat 8: SandroVM ($1.97 in chips) 
Seat 9: scorpion2680 ($1.01 in chips) 
MACJERSON: posts small blind $0.01
Xamil666: posts big blind $0.02
*** HOLE CARDS ***
Dealt to Redvin33 [7d Kh]
olsche74: folds 
TeamTrousers: folds 
Gorwfwefwed: folds 
Redvin33: folds 
SandroVM: folds 
scorpion2680: raises $0.04 to $0.06
ArgusLL: folds 
MACJERSON: folds 
Xamil666: folds 
Uncalled bet ($0.04) returned to scorpion2680
scorpion2680 collected $0.05 from pot
scorpion2680: doesn't show hand 
*** SUMMARY ***
Total pot $0.05 | Rake $0 
Seat 1: ArgusLL (button) folded before Flop (didn't bet)
Seat 2: MACJERSON (small blind) folded before Flop
Seat 3: Xamil666 (big blind) folded before Flop
Seat 4: olsche74 folded before Flop (didn't bet)
Seat 5: TeamTrousers folded before Flop (didn't bet)
Seat 6: Gorwfwefwed folded before Flop (didn't bet)
Seat 7: Redvin33 folded before Flop (didn't bet)
Seat 8: SandroVM folded before Flop (didn't bet)
Seat 9: scorpion2680 collected ($0.05)



PokerStars Zoom Hand #172696558508:  Hold'em No Limit ($0.01/$0.02) - 2017/07/06 18:25:49 ET
Table 'McNaught' 9-max Seat #1 is the button
Seat 1: deichgraf000 ($6.54 in chips) 
Seat 2: nightspeaker ($3.42 in chips) 
Seat 3: Redvin33 ($1.96 in chips) 
Seat 4: fuminator ($0.72 in chips) 
Seat 5: grave_17 ($2.39 in chips) 
Seat 6: Ksan5979 ($2 in chips) 
Seat 7: Haczlo ($2.43 in chips) 
Seat 8: daysoflyser ($1.02 in chips) 
Seat 9: LUKIANOV777 ($5.23 in chips) 
nightspeaker: posts small blind $0.01
Redvin33: posts big blind $0.02
*** HOLE CARDS ***
Dealt to Redvin33 [4d 7h]
fuminator: calls $0.02
grave_17: folds 
Ksan5979: folds 
Haczlo: folds 
daysoflyser: folds 
LUKIANOV777: raises $0.04 to $0.06
deichgraf000: folds 
nightspeaker: folds 
Redvin33: folds 
fuminator: calls $0.04
*** FLOP *** [6d Ks Ts]
fuminator: checks 
LUKIANOV777: checks 
*** TURN *** [6d Ks Ts] [8c]
fuminator: checks 
LUKIANOV777: checks 
*** RIVER *** [6d Ks Ts 8c] [2c]
fuminator: checks 
LUKIANOV777: checks 
*** SHOW DOWN ***
fuminator: shows [Js 8s] (a pair of Eights)
LUKIANOV777: mucks hand 
fuminator collected $0.14 from pot
*** SUMMARY ***
Total pot $0.15 | Rake $0.01 
Board [6d Ks Ts 8c 2c]
Seat 1: deichgraf000 (button) folded before Flop (didn't bet)
Seat 2: nightspeaker (small blind) folded before Flop
Seat 3: Redvin33 (big blind) folded before Flop
Seat 4: fuminator showed [Js 8s] and won ($0.14) with a pair of Eights
Seat 5: grave_17 folded before Flop (didn't bet)
Seat 6: Ksan5979 folded before Flop (didn't bet)
Seat 7: Haczlo folded before Flop (didn't bet)
Seat 8: daysoflyser folded before Flop (didn't bet)
Seat 9: LUKIANOV777 mucked [7c 7d]



PokerStars Zoom Hand #172696566742:  Hold'em No Limit ($0.01/$0.02) - 2017/07/06 18:26:01 ET
Table 'McNaught' 9-max Seat #1 is the button
Seat 1: KarlMarx18 ($2 in chips) 
Seat 2: FredFlush777 ($3.18 in chips) 
Seat 3: Alex75stv ($1.80 in chips) 
Seat 4: denzell574 ($2.24 in chips) 
Seat 5: Redvin33 ($1.94 in chips) 
Seat 6: FidgetyWins ($2.16 in chips) 
Seat 7: edskifrench ($0.97 in chips) 
Seat 8: Artem23Ka ($2.01 in chips) 
Seat 9: ArthurStk ($2.43 in chips) 
FredFlush777: posts small blind $0.01
Alex75stv: posts big blind $0.02
*** HOLE CARDS ***
Dealt to Redvin33 [Ks 5c]
denzell574: folds 
Redvin33: folds 
FidgetyWins: folds 
edskifrench: folds 
Artem23Ka: folds 
ArthurStk: raises $0.04 to $0.06
KarlMarx18: folds 
FredFlush777: folds 
Alex75stv: folds 
Uncalled bet ($0.04) returned to ArthurStk
ArthurStk collected $0.05 from pot
ArthurStk: doesn't show hand 
*** SUMMARY ***
Total pot $0.05 | Rake $0 
Seat 1: KarlMarx18 (button) folded before Flop (didn't bet)
Seat 2: FredFlush777 (small blind) folded before Flop
Seat 3: Alex75stv (big blind) folded before Flop
Seat 4: denzell574 folded before Flop (didn't bet)
Seat 5: Redvin33 folded before Flop (didn't bet)
Seat 6: FidgetyWins folded before Flop (didn't bet)
Seat 7: edskifrench folded before Flop (didn't bet)
Seat 8: Artem23Ka folded before Flop (didn't bet)
Seat 9: ArthurStk collected ($0.05)



PokerStars Zoom Hand #172696550377:  Hold'em No Limit ($0.01/$0.02) - 2017/07/06 18:25:37 ET
Table 'McNaught' 9-max Seat #1 is the button
Seat 1: Redvin33 ($1.96 in chips) 
Seat 2: Gorwfwefwed ($3.52 in chips) 
Seat 3: ArthurStk ($3.59 in chips) 
Seat 4: japu2010 ($4 in chips) 
Seat 5: olsche74 ($1.31 in chips) 
Seat 6: deichgraf000 ($6.55 in chips) 
Seat 7: Maxikreker ($4.17 in chips) 
Seat 8: karvinus595 ($1.69 in chips) 
Seat 9: Brucechiou ($3.86 in chips) 
Gorwfwefwed: posts small blind $0.01
ArthurStk: posts big blind $0.02
*** HOLE CARDS ***
Dealt to Redvin33 [Qh 8h]
japu2010: folds 
olsche74: folds 
deichgraf000: folds 
Maxikreker: folds 
karvinus595: folds 
Brucechiou: raises $0.04 to $0.06
Redvin33: folds 
Gorwfwefwed: folds 
ArthurStk: calls $0.04
*** FLOP *** [3c 4c 3d]
ArthurStk: checks 
Brucechiou: checks 
*** TURN *** [3c 4c 3d] [8d]
ArthurStk: checks 
Brucechiou: bets $0.04
ArthurStk: calls $0.04
*** RIVER *** [3c 4c 3d 8d] [Th]
ArthurStk: checks 
Brucechiou: bets $0.40
ArthurStk: folds 
Uncalled bet ($0.40) returned to Brucechiou
Brucechiou collected $0.20 from pot
Brucechiou: doesn't show hand 
*** SUMMARY ***
Total pot $0.21 | Rake $0.01 
Board [3c 4c 3d 8d Th]
Seat 1: Redvin33 (button) folded before Flop (didn't bet)
Seat 2: Gorwfwefwed (small blind) folded before Flop
Seat 3: ArthurStk (big blind) folded on the River
Seat 4: japu2010 folded before Flop (didn't bet)
Seat 5: olsche74 folded before Flop (didn't bet)
Seat 6: deichgraf000 folded before Flop (didn't bet)
Seat 7: Maxikreker folded before Flop (didn't bet)
Seat 8: karvinus595 folded before Flop (didn't bet)
Seat 9: Brucechiou collected ($0.20)



PokerStars Zoom Hand #172696569500:  Hold'em No Limit ($0.01/$0.02) - 2017/07/06 18:26:05 ET
Table 'McNaught' 9-max Seat #1 is the button
Seat 1: manowar7771 ($2.38 in chips) 
Seat 2: batiraki13 ($2 in chips) 
Seat 3: MACJERSON ($0.37 in chips) 
Seat 4: KarlMarx18 ($2 in chips) 
Seat 5: DiNiceBoy ($4.32 in chips) 
Seat 6: Redvin33 ($1.94 in chips) 
Seat 7: Sespirion ($1 in chips) 
Seat 8: hapu ($1.46 in chips) 
Seat 9: SUPERCARLAO ($2.89 in chips) 
batiraki13: posts small blind $0.01
MACJERSON: posts big blind $0.02
*** HOLE CARDS ***
Dealt to Redvin33 [Ks Qh]
KarlMarx18: folds 
DiNiceBoy has timed out
DiNiceBoy: folds 
Redvin33: calls $0.02
Sespirion: folds 
hapu: folds 
SUPERCARLAO: folds 
manowar7771: folds 
batiraki13: folds 
MACJERSON: checks 
*** FLOP *** [8s Kh Jc]
MACJERSON: checks 
Redvin33: bets $0.02
MACJERSON: folds 
Uncalled bet ($0.02) returned to Redvin33
Redvin33 collected $0.05 from pot
Redvin33: doesn't show hand 
*** SUMMARY ***
Total pot $0.05 | Rake $0 
Board [8s Kh Jc]
Seat 1: manowar7771 (button) folded before Flop (didn't bet)
Seat 2: batiraki13 (small blind) folded before Flop
Seat 3: MACJERSON (big blind) folded on the Flop
Seat 4: KarlMarx18 folded before Flop (didn't bet)
Seat 5: DiNiceBoy folded before Flop (didn't bet)
Seat 6: Redvin33 collected ($0.05)
Seat 7: Sespirion folded before Flop (didn't bet)
Seat 8: hapu folded before Flop (didn't bet)
Seat 9: SUPERCARLAO folded before Flop (didn't bet)



PokerStars Zoom Hand #172696596739:  Hold'em No Limit ($0.01/$0.02) - 2017/07/06 18:26:45 ET
Table 'McNaught' 9-max Seat #1 is the button
Seat 1: Pokurov ($2.01 in chips) 
Seat 2: serg197211 ($2.26 in chips) 
Seat 3: komarkoff ($3.53 in chips) 
Seat 4: Weatherguy1 ($2.02 in chips) 
Seat 5: Manu171077 ($0.18 in chips) 
Seat 6: SweetPlay777 ($2.13 in chips) 
Seat 7: Ksan5979 ($2.07 in chips) 
Seat 8: Jaffar999 ($2.10 in chips) 
Seat 9: Redvin33 ($1.97 in chips) 
serg197211: posts small blind $0.01
komarkoff: posts big blind $0.02
*** HOLE CARDS ***
Dealt to Redvin33 [2d Ks]
Weatherguy1: folds 
Manu171077: folds 
SweetPlay777: folds 
Ksan5979: folds 
Jaffar999: folds 
Redvin33: folds 
Pokurov: folds 
serg197211: raises $0.04 to $0.06
komarkoff: folds 
Uncalled bet ($0.04) returned to serg197211
serg197211 collected $0.04 from pot
serg197211: doesn't show hand 
*** SUMMARY ***
Total pot $0.04 | Rake $0 
Seat 1: Pokurov (button) folded before Flop (didn't bet)
Seat 2: serg197211 (small blind) collected ($0.04)
Seat 3: komarkoff (big blind) folded before Flop
Seat 4: Weatherguy1 folded before Flop (didn't bet)
Seat 5: Manu171077 folded before Flop (didn't bet)
Seat 6: SweetPlay777 folded before Flop (didn't bet)
Seat 7: Ksan5979 folded before Flop (didn't bet)
Seat 8: Jaffar999 folded before Flop (didn't bet)
Seat 9: Redvin33 folded before Flop (didn't bet)



PokerStars Zoom Hand #172696602821:  Hold'em No Limit ($0.01/$0.02) - 2017/07/06 18:26:54 ET
Table 'McNaught' 9-max Seat #1 is the button
Seat 1: Ksan5979 ($2.02 in chips) 
Seat 2: Nikoro309 ($2 in chips) 
Seat 3: Artem23Ka ($4.21 in chips) 
Seat 4: Unconform ($2.19 in chips) 
Seat 5: SweetPlay777 ($2.13 in chips) 
Seat 6: ct189 ($0.93 in chips) 
Seat 7: rokirov ($2.27 in chips) 
Seat 8: Redvin33 ($1.97 in chips) 
Seat 9: lion.1st ($1.98 in chips) 
Nikoro309: posts small blind $0.01
Artem23Ka: posts big blind $0.02
*** HOLE CARDS ***
Dealt to Redvin33 [7c 5d]
Unconform: folds 
SweetPlay777: folds 
ct189: folds 
rokirov: folds 
Redvin33: folds 
lion.1st: folds 
Ksan5979: folds 
Nikoro309: folds 
Uncalled bet ($0.01) returned to Artem23Ka
Artem23Ka collected $0.02 from pot
Artem23Ka: doesn't show hand 
*** SUMMARY ***
Total pot $0.02 | Rake $0 
Seat 1: Ksan5979 (button) folded before Flop (didn't bet)
Seat 2: Nikoro309 (small blind) folded before Flop
Seat 3: Artem23Ka (big blind) collected ($0.02)
Seat 4: Unconform folded before Flop (didn't bet)
Seat 5: SweetPlay777 folded before Flop (didn't bet)
Seat 6: ct189 folded before Flop (didn't bet)
Seat 7: rokirov folded before Flop (didn't bet)
Seat 8: Redvin33 folded before Flop (didn't bet)
Seat 9: lion.1st folded before Flop (didn't bet)



PokerStars Zoom Hand #172696605599:  Hold'em No Limit ($0.01/$0.02) - 2017/07/06 18:26:58 ET
Table 'McNaught' 9-max Seat #1 is the button
Seat 1: MrSchnuff ($2.87 in chips) 
Seat 2: Redvin33 ($1.97 in chips) 
Seat 3: Zoddoss ($2 in chips) 
Seat 4: I gendos ($1.86 in chips) 
Seat 5: Fr0l0FF ($2.24 in chips) 
Seat 6: filipov1976 ($4.37 in chips) 
Seat 7: jip347 ($0.93 in chips) 
Seat 8: Rishnu Fr ($4.71 in chips) 
Seat 9: ostap07 ($4.01 in chips) 
Redvin33: posts small blind $0.01
Zoddoss: posts big blind $0.02
*** HOLE CARDS ***
Dealt to Redvin33 [Qd Jd]
I gendos: folds 
Fr0l0FF: folds 
filipov1976: raises $0.04 to $0.06
jip347: folds 
Rishnu Fr: folds 
ostap07: folds 
MrSchnuff: folds 
Redvin33: calls $0.05
Zoddoss: folds 
*** FLOP *** [8c 7c 8s]
Redvin33: bets $0.10
filipov1976: calls $0.10
*** TURN *** [8c 7c 8s] [3d]
Redvin33: checks 
filipov1976: bets $0.17
Redvin33: folds 
Uncalled bet ($0.17) returned to filipov1976
filipov1976 collected $0.33 from pot
filipov1976: doesn't show hand 
*** SUMMARY ***
Total pot $0.34 | Rake $0.01 
Board [8c 7c 8s 3d]
Seat 1: MrSchnuff (button) folded before Flop (didn't bet)
Seat 2: Redvin33 (small blind) folded on the Turn
Seat 3: Zoddoss (big blind) folded before Flop
Seat 4: I gendos folded before Flop (didn't bet)
Seat 5: Fr0l0FF folded before Flop (didn't bet)
Seat 6: filipov1976 collected ($0.33)
Seat 7: jip347 folded before Flop (didn't bet)
Seat 8: Rishnu Fr folded before Flop (didn't bet)
Seat 9: ostap07 folded before Flop (didn't bet)



PokerStars Zoom Hand #172696599474:  Hold'em No Limit ($0.01/$0.02) - 2017/07/06 18:26:49 ET
Table 'McNaught' 9-max Seat #1 is the button
Seat 1: Cayoosh16 ($2.03 in chips) 
Seat 2: naoya1929 ($1.10 in chips) 
Seat 3: filipov1976 ($4.39 in chips) 
Seat 4: Redvin33 ($1.97 in chips) 
Seat 5: Tilted279 ($2.03 in chips) 
Seat 6: ct189 ($0.93 in chips) 
Seat 7: nightspeaker ($3.49 in chips) 
Seat 8: ArthurStk ($3.48 in chips) 
Seat 9: VOLOOOODYA ($2.01 in chips) 
naoya1929: posts small blind $0.01
filipov1976: posts big blind $0.02
*** HOLE CARDS ***
Dealt to Redvin33 [7d Qs]
Redvin33: folds 
Tilted279: folds 
ct189: folds 
nightspeaker: raises $0.04 to $0.06
ArthurStk: raises $0.12 to $0.18
VOLOOOODYA: folds 
Cayoosh16: folds 
naoya1929: folds 
filipov1976: folds 
nightspeaker: calls $0.12
*** FLOP *** [Qc Kc As]
nightspeaker: checks 
ArthurStk: bets $0.25
nightspeaker: raises $0.45 to $0.70
ArthurStk: raises $2.60 to $3.30 and is all-in
nightspeaker: folds 
Uncalled bet ($2.60) returned to ArthurStk
ArthurStk collected $1.73 from pot
ArthurStk: doesn't show hand 
*** SUMMARY ***
Total pot $1.79 | Rake $0.06 
Board [Qc Kc As]
Seat 1: Cayoosh16 (button) folded before Flop (didn't bet)
Seat 2: naoya1929 (small blind) folded before Flop
Seat 3: filipov1976 (big blind) folded before Flop
Seat 4: Redvin33 folded before Flop (didn't bet)
Seat 5: Tilted279 folded before Flop (didn't bet)
Seat 6: ct189 folded before Flop (didn't bet)
Seat 7: nightspeaker folded on the Flop
Seat 8: ArthurStk collected ($1.73)
Seat 9: VOLOOOODYA folded before Flop (didn't bet)



PokerStars Zoom Hand #172696625985:  Hold'em No Limit ($0.01/$0.02) - 2017/07/06 18:27:28 ET
Table 'McNaught' 9-max Seat #1 is the button
Seat 1: JeffersonWd ($1.65 in chips) 
Seat 2: Unconform ($2.38 in chips) 
Seat 3: SweetPlay777 ($2 in chips) 
Seat 4: Fons Vitae ($1.82 in chips) 
Seat 5: Alex75stv ($2.09 in chips) 
Seat 6: Redvin33 ($1.81 in chips) 
Seat 7: Nikoro309 ($2 in chips) 
Seat 8: KennYLance ($2.74 in chips) 
Seat 9: TheCoelhao ($2.07 in chips) 
Unconform: posts small blind $0.01
SweetPlay777: posts big blind $0.02
*** HOLE CARDS ***
Dealt to Redvin33 [5s 5c]
Fons Vitae: folds 
Alex75stv: folds 
Redvin33: raises $0.03 to $0.05
Nikoro309: folds 
KennYLance: folds 
TheCoelhao: folds 
JeffersonWd: folds 
Unconform: folds 
SweetPlay777: folds 
Uncalled bet ($0.03) returned to Redvin33
Redvin33 collected $0.05 from pot
Redvin33: doesn't show hand 
*** SUMMARY ***
Total pot $0.05 | Rake $0 
Seat 1: JeffersonWd (button) folded before Flop (didn't bet)
Seat 2: Unconform (small blind) folded before Flop
Seat 3: SweetPlay777 (big blind) folded before Flop
Seat 4: Fons Vitae folded before Flop (didn't bet)
Seat 5: Alex75stv folded before Flop (didn't bet)
Seat 6: Redvin33 collected ($0.05)
Seat 7: Nikoro309 folded before Flop (didn't bet)
Seat 8: KennYLance folded before Flop (didn't bet)
Seat 9: TheCoelhao folded before Flop (didn't bet)



PokerStars Zoom Hand #172696646016:  Hold'em No Limit ($0.01/$0.02) - 2017/07/06 18:27:52 ET
Table 'McNaught' 9-max Seat #1 is the button
Seat 1: Nille20 ($2.03 in chips) 
Seat 2: SandroVM ($1.98 in chips) 
Seat 3: limonguen ($0.99 in chips) 
Seat 4: Redvin33 ($1.84 in chips) 
Seat 5: arsen99 ($2 in chips) 
Seat 6: ostap07 ($3.96 in chips) 
Seat 7: Zoddoss ($2 in chips) 
Seat 8: Xamil666 ($5.06 in chips) 
Seat 9: Kilativ1972 ($2.04 in chips) 
SandroVM: posts small blind $0.01
limonguen: posts big blind $0.02
*** HOLE CARDS ***
Dealt to Redvin33 [Ts Ad]
Redvin33: raises $0.03 to $0.05
arsen99: folds 
ostap07: folds 
Zoddoss: folds 
Xamil666: folds 
Kilativ1972: folds 
Nille20: folds 
SandroVM: folds 
limonguen: folds 
Uncalled bet ($0.03) returned to Redvin33
Redvin33 collected $0.05 from pot
Redvin33: doesn't show hand 
*** SUMMARY ***
Total pot $0.05 | Rake $0 
Seat 1: Nille20 (button) folded before Flop (didn't bet)
Seat 2: SandroVM (small blind) folded before Flop
Seat 3: limonguen (big blind) folded before Flop
Seat 4: Redvin33 collected ($0.05)
Seat 5: arsen99 folded before Flop (didn't bet)
Seat 6: ostap07 folded before Flop (didn't bet)
Seat 7: Zoddoss folded before Flop (didn't bet)
Seat 8: Xamil666 folded before Flop (didn't bet)
Seat 9: Kilativ1972 folded before Flop (didn't bet)



PokerStars Zoom Hand #172696654915:  Hold'em No Limit ($0.01/$0.02) - 2017/07/06 18:28:05 ET
Table 'McNaught' 9-max Seat #1 is the button
Seat 1: Redvin33 ($1.87 in chips) 
Seat 2: Zoddoss ($2 in chips) 
Seat 3: wexie ($1.36 in chips) 
Seat 4: LUKIANOV777 ($2 in chips) 
Seat 5: Schdoerrchen ($3.04 in chips) 
Seat 6: olsche74 ($1.20 in chips) 
Seat 7: manowar7771 ($1.95 in chips) 
Seat 8: yayadub ($1.38 in chips) 
Seat 9: Cayoosh16 ($1.59 in chips) 
Zoddoss: posts small blind $0.01
wexie: posts big blind $0.02
*** HOLE CARDS ***
Dealt to Redvin33 [6h 2s]
LUKIANOV777: folds 
Schdoerrchen: folds 
olsche74: raises $0.02 to $0.04
manowar7771: folds 
yayadub: folds 
Cayoosh16: folds 
Redvin33: folds 
Zoddoss: folds 
wexie: calls $0.02
*** FLOP *** [7s 3d 4h]
wexie: checks 
olsche74: bets $0.05
wexie: folds 
Uncalled bet ($0.05) returned to olsche74
olsche74 collected $0.09 from pot
olsche74: doesn't show hand 
*** SUMMARY ***
Total pot $0.09 | Rake $0 
Board [7s 3d 4h]
Seat 1: Redvin33 (button) folded before Flop (didn't bet)
Seat 2: Zoddoss (small blind) folded before Flop
Seat 3: wexie (big blind) folded on the Flop
Seat 4: LUKIANOV777 folded before Flop (didn't bet)
Seat 5: Schdoerrchen folded before Flop (didn't bet)
Seat 6: olsche74 collected ($0.09)
Seat 7: manowar7771 folded before Flop (didn't bet)
Seat 8: yayadub folded before Flop (didn't bet)
Seat 9: Cayoosh16 folded before Flop (didn't bet)



PokerStars Zoom Hand #172696660990:  Hold'em No Limit ($0.01/$0.02) - 2017/07/06 18:28:14 ET
Table 'McNaught' 9-max Seat #1 is the button
Seat 1: denzell574 ($1.98 in chips) 
Seat 2: arsen99 ($2 in chips) 
Seat 3: 3thirteen616 ($1.23 in chips) 
Seat 4: ostap07 ($2 in chips) 
Seat 5: jip347 ($0.88 in chips) 
Seat 6: Lifecards7 ($1.94 in chips) 
Seat 7: Redvin33 ($1.87 in chips) 
Seat 8: serg197211 ($2.26 in chips) 
Seat 9: Clarence Jr ($2.51 in chips) 
arsen99: posts small blind $0.01
3thirteen616: posts big blind $0.02
*** HOLE CARDS ***
Dealt to Redvin33 [Kc 8s]
ostap07: folds 
jip347: calls $0.02
Lifecards7: folds 
Redvin33: folds 
serg197211: folds 
Clarence Jr: folds 
denzell574: folds 
arsen99: folds 
3thirteen616: checks 
*** FLOP *** [6h 3c 4h]
3thirteen616: checks 
jip347: checks 
*** TURN *** [6h 3c 4h] [2d]
3thirteen616: checks 
jip347: bets $0.03
3thirteen616: folds 
Uncalled bet ($0.03) returned to jip347
jip347 collected $0.05 from pot
jip347: doesn't show hand 
*** SUMMARY ***
Total pot $0.05 | Rake $0 
Board [6h 3c 4h 2d]
Seat 1: denzell574 (button) folded before Flop (didn't bet)
Seat 2: arsen99 (small blind) folded before Flop
Seat 3: 3thirteen616 (big blind) folded on the Turn
Seat 4: ostap07 folded before Flop (didn't bet)
Seat 5: jip347 collected ($0.05)
Seat 6: Lifecards7 folded before Flop (didn't bet)
Seat 7: Redvin33 folded before Flop (didn't bet)
Seat 8: serg197211 folded before Flop (didn't bet)
Seat 9: Clarence Jr folded before Flop (didn't bet)



PokerStars Zoom Hand #172696658336:  Hold'em No Limit ($0.01/$0.02) - 2017/07/06 18:28:10 ET
Table 'McNaught' 9-max Seat #1 is the button
Seat 1: toluschev ($1.77 in chips) 
Seat 2: Agares91 ($2.76 in chips) 
Seat 3: nsigi ($3.31 in chips) 
Seat 4: Redvin33 ($1.87 in chips) 
Seat 5: Haczlo ($2.52 in chips) 
Seat 6: lion.1st ($2.66 in chips) 
Seat 7: filipov1976 ($5.12 in chips) 
Seat 8: REISR18 ($3.95 in chips) 
Seat 9: aleks118 ($1.93 in chips) 
Agares91: posts small blind $0.01
nsigi: posts big blind $0.02
*** HOLE CARDS ***
Dealt to Redvin33 [6h Kd]
Redvin33: folds 
Haczlo: folds 
lion.1st: folds 
filipov1976: raises $0.04 to $0.06
REISR18: folds 
aleks118: folds 
toluschev: folds 
Agares91: folds 
nsigi: calls $0.04
*** FLOP *** [6s 9h Jh]
nsigi: checks 
filipov1976: checks 
*** TURN *** [6s 9h Jh] [2d]
nsigi: bets $0.06
filipov1976: folds 
Uncalled bet ($0.06) returned to nsigi
nsigi collected $0.13 from pot
nsigi: doesn't show hand 
*** SUMMARY ***
Total pot $0.13 | Rake $0 
Board [6s 9h Jh 2d]
Seat 1: toluschev (button) folded before Flop (didn't bet)
Seat 2: Agares91 (small blind) folded before Flop
Seat 3: nsigi (big blind) collected ($0.13)
Seat 4: Redvin33 folded before Flop (didn't bet)
Seat 5: Haczlo folded before Flop (didn't bet)
Seat 6: lion.1st folded before Flop (didn't bet)
Seat 7: filipov1976 folded on the Turn
Seat 8: REISR18 folded before Flop (didn't bet)
Seat 9: aleks118 folded before Flop (didn't bet)



PokerStars Zoom Hand #172696663699:  Hold'em No Limit ($0.01/$0.02) - 2017/07/06 18:28:18 ET
Table 'McNaught' 9-max Seat #1 is the button
Seat 1: Brucechiou ($5.61 in chips) 
Seat 2: dorlo ($1.60 in chips) 
Seat 3: Brianezi ($1.08 in chips) 
Seat 4: bediboy ($5.01 in chips) 
Seat 5: rnxbocker ($1.71 in chips) 
Seat 6: denzell574 ($1.98 in chips) 
Seat 7: kwatas kef ($5.26 in chips) 
Seat 8: bellamia26 ($7.32 in chips) 
Seat 9: Redvin33 ($1.87 in chips) 
dorlo: posts small blind $0.01
Brianezi: posts big blind $0.02
*** HOLE CARDS ***
Dealt to Redvin33 [Qc 7h]
bediboy: folds 
rnxbocker: calls $0.02
denzell574: raises $0.07 to $0.09
kwatas kef: calls $0.09
bellamia26: folds 
Redvin33: folds 
Brucechiou: folds 
dorlo: folds 
Brianezi: folds 
rnxbocker: calls $0.07
*** FLOP *** [2c Kd Td]
rnxbocker: checks 
denzell574: bets $0.17
kwatas kef: raises $0.17 to $0.34
rnxbocker: folds 
denzell574: folds 
Uncalled bet ($0.17) returned to kwatas kef
kwatas kef collected $0.62 from pot
kwatas kef: doesn't show hand 
*** SUMMARY ***
Total pot $0.64 | Rake $0.02 
Board [2c Kd Td]
Seat 1: Brucechiou (button) folded before Flop (didn't bet)
Seat 2: dorlo (small blind) folded before Flop
Seat 3: Brianezi (big blind) folded before Flop
Seat 4: bediboy folded before Flop (didn't bet)
Seat 5: rnxbocker folded on the Flop
Seat 6: denzell574 folded on the Flop
Seat 7: kwatas kef collected ($0.62)
Seat 8: bellamia26 folded before Flop (didn't bet)
Seat 9: Redvin33 folded before Flop (didn't bet)



PokerStars Zoom Hand #172696666522:  Hold'em No Limit ($0.01/$0.02) - 2017/07/06 18:28:22 ET
Table 'McNaught' 9-max Seat #1 is the button
Seat 1: negrutsenior ($1.42 in chips) 
Seat 2: toluschev ($2.24 in chips) 
Seat 3: Kenshiro*969 ($2 in chips) 
Seat 4: W1zard2008 ($1.91 in chips) 
Seat 5: Redvin33 ($1.87 in chips) 
Seat 6: Nille20 ($2.12 in chips) 
Seat 7: RayHub ($2.04 in chips) 
Seat 8: fuminator ($0.74 in chips) 
Seat 9: SandroVM ($2 in chips) 
toluschev: posts small blind $0.01
Kenshiro*969: posts big blind $0.02
*** HOLE CARDS ***
Dealt to Redvin33 [Jh Jd]
W1zard2008: folds 
Redvin33: raises $0.03 to $0.05
Nille20: raises $0.11 to $0.16
RayHub: folds 
fuminator: folds 
SandroVM: folds 
negrutsenior: calls $0.16
toluschev: folds 
Kenshiro*969: folds 
Redvin33: calls $0.11
*** FLOP *** [3s 5s 7s]
Redvin33: checks 
Nille20: checks 
negrutsenior: bets $0.08
Redvin33: raises $0.14 to $0.22
Nille20: folds 
negrutsenior: folds 
Uncalled bet ($0.14) returned to Redvin33
Redvin33 collected $0.65 from pot
Redvin33: doesn't show hand 
*** SUMMARY ***
Total pot $0.67 | Rake $0.02 
Board [3s 5s 7s]
Seat 1: negrutsenior (button) folded on the Flop
Seat 2: toluschev (small blind) folded before Flop
Seat 3: Kenshiro*969 (big blind) folded before Flop
Seat 4: W1zard2008 folded before Flop (didn't bet)
Seat 5: Redvin33 collected ($0.65)
Seat 6: Nille20 folded on the Flop
Seat 7: RayHub folded before Flop (didn't bet)
Seat 8: fuminator folded before Flop (didn't bet)
Seat 9: SandroVM folded before Flop (didn't bet)



PokerStars Zoom Hand #172696699861:  Hold'em No Limit ($0.01/$0.02) - 2017/07/06 18:29:11 ET
Table 'McNaught' 9-max Seat #1 is the button
Seat 1: stel73 ($3.60 in chips) 
Seat 2: W1zard2008 ($2 in chips) 
Seat 3: Redvin33 ($2.28 in chips) 
Seat 4: nerml000 ($0.96 in chips) 
Seat 5: Nikoro309 ($2.70 in chips) 
Seat 6: eviljanne ($2.22 in chips) 
Seat 7: 3thirteen616 ($1.20 in chips) 
Seat 8: ostap07 ($3.93 in chips) 
Seat 9: Mùúh 22 ($2.96 in chips) 
W1zard2008: posts small blind $0.01
Redvin33: posts big blind $0.02
*** HOLE CARDS ***
Dealt to Redvin33 [Qc 8c]
nerml000: folds 
Nikoro309: folds 
eviljanne: folds 
3thirteen616: folds 
ostap07: folds 
Mùúh 22: folds 
stel73: raises $0.03 to $0.05
W1zard2008: folds 
Redvin33: calls $0.03
*** FLOP *** [Ah 7d 6d]
Redvin33: checks 
stel73: bets $0.05
Redvin33: folds 
Uncalled bet ($0.05) returned to stel73
stel73 collected $0.11 from pot
stel73: doesn't show hand 
*** SUMMARY ***
Total pot $0.11 | Rake $0 
Board [Ah 7d 6d]
Seat 1: stel73 (button) collected ($0.11)
Seat 2: W1zard2008 (small blind) folded before Flop
Seat 3: Redvin33 (big blind) folded on the Flop
Seat 4: nerml000 folded before Flop (didn't bet)
Seat 5: Nikoro309 folded before Flop (didn't bet)
Seat 6: eviljanne folded before Flop (didn't bet)
Seat 7: 3thirteen616 folded before Flop (didn't bet)
Seat 8: ostap07 folded before Flop (didn't bet)
Seat 9: Mùúh 22 folded before Flop (didn't bet)



PokerStars Zoom Hand #172696722176:  Hold'em No Limit ($0.01/$0.02) - 2017/07/06 18:29:44 ET
Table 'McNaught' 9-max Seat #1 is the button
Seat 1: mamiladi1971 ($1.97 in chips) 
Seat 2: Quijotelito ($2.59 in chips) 
Seat 3: ct189 ($0.72 in chips) 
Seat 4: ArgusLL ($2 in chips) 
Seat 5: Taraba68 ($2.40 in chips) 
Seat 6: KaHcTpykTap ($4.30 in chips) 
Seat 7: nightspeaker ($2.85 in chips) 
Seat 8: Redvin33 ($2.23 in chips) 
Seat 9: Lucas Cremer ($1.38 in chips) 
Quijotelito: posts small blind $0.01
ct189: posts big blind $0.02
*** HOLE CARDS ***
Dealt to Redvin33 [Js 3c]
ArgusLL: folds 
Taraba68: folds 
KaHcTpykTap: folds 
nightspeaker: folds 
Redvin33: folds 
Lucas Cremer: folds 
mamiladi1971: folds 
Quijotelito: folds 
Uncalled bet ($0.01) returned to ct189
ct189 collected $0.02 from pot
ct189: doesn't show hand 
*** SUMMARY ***
Total pot $0.02 | Rake $0 
Seat 1: mamiladi1971 (button) folded before Flop (didn't bet)
Seat 2: Quijotelito (small blind) folded before Flop
Seat 3: ct189 (big blind) collected ($0.02)
Seat 4: ArgusLL folded before Flop (didn't bet)
Seat 5: Taraba68 folded before Flop (didn't bet)
Seat 6: KaHcTpykTap folded before Flop (didn't bet)
Seat 7: nightspeaker folded before Flop (didn't bet)
Seat 8: Redvin33 folded before Flop (didn't bet)
Seat 9: Lucas Cremer folded before Flop (didn't bet)



PokerStars Zoom Hand #172696724843:  Hold'em No Limit ($0.01/$0.02) - 2017/07/06 18:29:48 ET
Table 'McNaught' 9-max Seat #1 is the button
Seat 1: Zoddoss ($2 in chips) 
Seat 2: Redvin33 ($2.23 in chips) 
Seat 3: dmitrychuk ($2 in chips) 
Seat 4: filon21 ($3.12 in chips) 
Seat 5: Mùúh 22 ($3.26 in chips) 
Seat 6: Schdoerrchen ($2.92 in chips) 
Seat 7: V. Regeis ($2 in chips) 
Seat 8: Kenshiro*969 ($2 in chips) 
Seat 9: DiNiceBoy ($3.74 in chips) 
Redvin33: posts small blind $0.01
dmitrychuk: posts big blind $0.02
*** HOLE CARDS ***
Dealt to Redvin33 [Ks Kc]
filon21: folds 
Mùúh 22: folds 
Schdoerrchen: folds 
V. Regeis: folds 
Kenshiro*969: folds 
DiNiceBoy: raises $0.03 to $0.05
Zoddoss: folds 
Redvin33: raises $0.05 to $0.10
dmitrychuk: folds 
DiNiceBoy: folds 
Uncalled bet ($0.05) returned to Redvin33
Redvin33 collected $0.12 from pot
Redvin33: doesn't show hand 
*** SUMMARY ***
Total pot $0.12 | Rake $0 
Seat 1: Zoddoss (button) folded before Flop (didn't bet)
Seat 2: Redvin33 (small blind) collected ($0.12)
Seat 3: dmitrychuk (big blind) folded before Flop
Seat 4: filon21 folded before Flop (didn't bet)
Seat 5: Mùúh 22 folded before Flop (didn't bet)
Seat 6: Schdoerrchen folded before Flop (didn't bet)
Seat 7: V. Regeis folded before Flop (didn't bet)
Seat 8: Kenshiro*969 folded before Flop (didn't bet)
Seat 9: DiNiceBoy folded before Flop



PokerStars Zoom Hand #172696719419:  Hold'em No Limit ($0.01/$0.02) - 2017/07/06 18:29:40 ET
Table 'McNaught' 9-max Seat #1 is the button
Seat 1: japu2010 ($2.15 in chips) 
Seat 2: wellgardiano ($1.98 in chips) 
Seat 3: filipov1976 ($5.05 in chips) 
Seat 4: Tsybulya ($6.59 in chips) 
Seat 5: Fr0l0FF ($2.27 in chips) 
Seat 6: Redvin33 ($2.23 in chips) 
Seat 7: Dulaper ($1.83 in chips) 
Seat 8: Henman3000 ($1.93 in chips) 
Seat 9: Unconform ($2.57 in chips) 
wellgardiano: posts small blind $0.01
filipov1976: posts big blind $0.02
*** HOLE CARDS ***
Dealt to Redvin33 [6d 7d]
Tsybulya: folds 
Fr0l0FF: folds 
Redvin33: folds 
Dulaper: raises $0.04 to $0.06
Henman3000: folds 
Unconform: folds 
japu2010: calls $0.06
wellgardiano: folds 
filipov1976: folds 
*** FLOP *** [2c 5d 7c]
Dulaper: checks 
japu2010: bets $0.09
Dulaper: folds 
Uncalled bet ($0.09) returned to japu2010
japu2010 collected $0.14 from pot
japu2010: doesn't show hand 
*** SUMMARY ***
Total pot $0.15 | Rake $0.01 
Board [2c 5d 7c]
Seat 1: japu2010 (button) collected ($0.14)
Seat 2: wellgardiano (small blind) folded before Flop
Seat 3: filipov1976 (big blind) folded before Flop
Seat 4: Tsybulya folded before Flop (didn't bet)
Seat 5: Fr0l0FF folded before Flop (didn't bet)
Seat 6: Redvin33 folded before Flop (didn't bet)
Seat 7: Dulaper folded on the Flop
Seat 8: Henman3000 folded before Flop (didn't bet)
Seat 9: Unconform folded before Flop (didn't bet)



PokerStars Zoom Hand #172696744005:  Hold'em No Limit ($0.01/$0.02) - 2017/07/06 18:30:16 ET
Table 'McNaught' 9-max Seat #1 is the button
Seat 1: colmcc ($1.97 in chips) 
Seat 2: yohyoxyd ($6.58 in chips) 
Seat 3: robertomuc ($2.66 in chips) 
Seat 4: E-Berta ($0.48 in chips) 
Seat 5: Redvin33 ($2.30 in chips) 
Seat 6: filipov1976 ($4.85 in chips) 
Seat 7: mamiladi1971 ($1.97 in chips) 
Seat 8: mirofa ($3.75 in chips) 
Seat 9: nerml000 ($1.29 in chips) 
yohyoxyd: posts small blind $0.01
robertomuc: posts big blind $0.02
*** HOLE CARDS ***
Dealt to Redvin33 [As Qc]
E-Berta: folds 
Redvin33: raises $0.03 to $0.05
filipov1976: folds 
mamiladi1971: folds 
mirofa: raises $0.05 to $0.10
nerml000: folds 
colmcc: folds 
yohyoxyd: folds 
robertomuc: folds 
Redvin33: calls $0.05
*** FLOP *** [2s 5s 2d]
Redvin33: bets $0.10
mirofa: raises $0.10 to $0.20
Redvin33: folds 
Uncalled bet ($0.10) returned to mirofa
mirofa collected $0.41 from pot
mirofa: doesn't show hand 
*** SUMMARY ***
Total pot $0.43 | Rake $0.02 
Board [2s 5s 2d]
Seat 1: colmcc (button) folded before Flop (didn't bet)
Seat 2: yohyoxyd (small blind) folded before Flop
Seat 3: robertomuc (big blind) folded before Flop
Seat 4: E-Berta folded before Flop (didn't bet)
Seat 5: Redvin33 folded on the Flop
Seat 6: filipov1976 folded before Flop (didn't bet)
Seat 7: mamiladi1971 folded before Flop (didn't bet)
Seat 8: mirofa collected ($0.41)
Seat 9: nerml000 folded before Flop (didn't bet)



PokerStars Zoom Hand #172696761427:  Hold'em No Limit ($0.01/$0.02) - 2017/07/06 18:30:42 ET
Table 'McNaught' 9-max Seat #1 is the button
Seat 1: Redvin33 ($2.10 in chips) 
Seat 2: batiraki13 ($2.05 in chips) 
Seat 3: SweetPlay777 ($1.96 in chips) 
Seat 4: lemeco ($2.09 in chips) 
Seat 5: 3thirteen616 ($5.42 in chips) 
Seat 6: LicGuapo ($2 in chips) 
Seat 7: colmcc ($2 in chips) 
Seat 8: Jaffar999 ($2.24 in chips) 
Seat 9: ct189 ($0.76 in chips) 
batiraki13: posts small blind $0.01
SweetPlay777: posts big blind $0.02
*** HOLE CARDS ***
Dealt to Redvin33 [8h Tc]
lemeco: folds 
3thirteen616: folds 
LicGuapo: folds 
colmcc: folds 
Jaffar999: folds 
ct189: raises $0.02 to $0.04
Redvin33: folds 
batiraki13: folds 
SweetPlay777: folds 
Uncalled bet ($0.02) returned to ct189
ct189 collected $0.05 from pot
ct189: doesn't show hand 
*** SUMMARY ***
Total pot $0.05 | Rake $0 
Seat 1: Redvin33 (button) folded before Flop (didn't bet)
Seat 2: batiraki13 (small blind) folded before Flop
Seat 3: SweetPlay777 (big blind) folded before Flop
Seat 4: lemeco folded before Flop (didn't bet)
Seat 5: 3thirteen616 folded before Flop (didn't bet)
Seat 6: LicGuapo folded before Flop (didn't bet)
Seat 7: colmcc folded before Flop (didn't bet)
Seat 8: Jaffar999 folded before Flop (didn't bet)
Seat 9: ct189 collected ($0.05)



PokerStars Zoom Hand #172696769324:  Hold'em No Limit ($0.01/$0.02) - 2017/07/06 18:30:54 ET
Table 'McNaught' 9-max Seat #1 is the button
Seat 1: lion.1st ($2.09 in chips) 
Seat 2: arsen99 ($2.07 in chips) 
Seat 3: Redvin33 ($2.10 in chips) 
Seat 4: Schdoerrchen ($2.90 in chips) 
Seat 5: ntr2xit ($2.03 in chips) 
Seat 6: Agares91 ($2 in chips) 
Seat 7: W1zard2008 ($2 in chips) 
Seat 8: vycheslav d ($1.67 in chips) 
Seat 9: grave_17 ($2.52 in chips) 
arsen99: posts small blind $0.01
Redvin33: posts big blind $0.02
*** HOLE CARDS ***
Dealt to Redvin33 [4c 5s]
Schdoerrchen: folds 
ntr2xit: folds 
Agares91: folds 
W1zard2008: folds 
vycheslav d: folds 
grave_17: folds 
lion.1st: folds 
arsen99: raises $0.02 to $0.04
Redvin33: folds 
Uncalled bet ($0.02) returned to arsen99
arsen99 collected $0.04 from pot
arsen99: doesn't show hand 
*** SUMMARY ***
Total pot $0.04 | Rake $0 
Seat 1: lion.1st (button) folded before Flop (didn't bet)
Seat 2: arsen99 (small blind) collected ($0.04)
Seat 3: Redvin33 (big blind) folded before Flop
Seat 4: Schdoerrchen folded before Flop (didn't bet)
Seat 5: ntr2xit folded before Flop (didn't bet)
Seat 6: Agares91 folded before Flop (didn't bet)
Seat 7: W1zard2008 folded before Flop (didn't bet)
Seat 8: vycheslav d folded before Flop (didn't bet)
Seat 9: grave_17 folded before Flop (didn't bet)



PokerStars Zoom Hand #172696764046:  Hold'em No Limit ($0.01/$0.02) - 2017/07/06 18:30:46 ET
Table 'McNaught' 9-max Seat #1 is the button
Seat 1: dmitrychuk ($1.71 in chips) 
Seat 2: valera_9696@ ($2.07 in chips) 
Seat 3: hapu ($7.43 in chips) 
Seat 4: Kenshiro*969 ($2.08 in chips) 
Seat 5: Schdoerrchen ($2.90 in chips) 
Seat 6: COULEUR7 ($2.08 in chips) 
Seat 7: nerml000 ($2.17 in chips) 
Seat 8: Redvin33 ($2.10 in chips) 
Seat 9: vycheslav d ($1.67 in chips) 
valera_9696@: posts small blind $0.01
hapu: posts big blind $0.02
*** HOLE CARDS ***
Dealt to Redvin33 [Jd 8s]
Kenshiro*969: folds 
Schdoerrchen: folds 
COULEUR7: folds 
nerml000: folds 
Redvin33: folds 
vycheslav d: folds 
dmitrychuk: raises $0.02 to $0.04
valera_9696@: raises $0.08 to $0.12
hapu: folds 
dmitrychuk: folds 
Uncalled bet ($0.08) returned to valera_9696@
valera_9696@ collected $0.10 from pot
valera_9696@: doesn't show hand 
*** SUMMARY ***
Total pot $0.10 | Rake $0 
Seat 1: dmitrychuk (button) folded before Flop
Seat 2: valera_9696@ (small blind) collected ($0.10)
Seat 3: hapu (big blind) folded before Flop
Seat 4: Kenshiro*969 folded before Flop (didn't bet)
Seat 5: Schdoerrchen folded before Flop (didn't bet)
Seat 6: COULEUR7 folded before Flop (didn't bet)
Seat 7: nerml000 folded before Flop (didn't bet)
Seat 8: Redvin33 folded before Flop (didn't bet)
Seat 9: vycheslav d folded before Flop (didn't bet)



PokerStars Zoom Hand #172696776816:  Hold'em No Limit ($0.01/$0.02) - 2017/07/06 18:31:05 ET
Table 'McNaught' 9-max Seat #1 is the button
Seat 1: amergedon ($2 in chips) 
Seat 2: pIay2kiLL ($1.98 in chips) 
Seat 3: PJWALL ($2 in chips) 
Seat 4: ct189 ($0.79 in chips) 
Seat 5: aleks118 ($1.84 in chips) 
Seat 6: Gamer577 ($2 in chips) 
Seat 7: Redvin33 ($2.08 in chips) 
Seat 8: smiechtje ($2.26 in chips) 
Seat 9: nicolasriver ($2.57 in chips) 
pIay2kiLL: posts small blind $0.01
PJWALL: posts big blind $0.02
*** HOLE CARDS ***
Dealt to Redvin33 [Ad 3d]
ct189: folds 
aleks118: folds 
Gamer577: folds 
Redvin33: raises $0.03 to $0.05
smiechtje: folds 
nicolasriver: calls $0.05
amergedon: folds 
pIay2kiLL: folds 
PJWALL: folds 
*** FLOP *** [3c 4s 6c]
Redvin33: bets $0.04
nicolasriver: calls $0.04
*** TURN *** [3c 4s 6c] [Qd]
Redvin33: bets $0.06
nicolasriver: folds 
Uncalled bet ($0.06) returned to Redvin33
Redvin33 collected $0.20 from pot
Redvin33: doesn't show hand 
*** SUMMARY ***
Total pot $0.21 | Rake $0.01 
Board [3c 4s 6c Qd]
Seat 1: amergedon (button) folded before Flop (didn't bet)
Seat 2: pIay2kiLL (small blind) folded before Flop
Seat 3: PJWALL (big blind) folded before Flop
Seat 4: ct189 folded before Flop (didn't bet)
Seat 5: aleks118 folded before Flop (didn't bet)
Seat 6: Gamer577 folded before Flop (didn't bet)
Seat 7: Redvin33 collected ($0.20)
Seat 8: smiechtje folded before Flop (didn't bet)
Seat 9: nicolasriver folded on the Turn



PokerStars Zoom Hand #172696766674:  Hold'em No Limit ($0.01/$0.02) - 2017/07/06 18:30:50 ET
Table 'McNaught' 9-max Seat #1 is the button
Seat 1: VOLOOOODYA ($1.99 in chips) 
Seat 2: lalon22 ($1.98 in chips) 
Seat 3: Gorwfwefwed ($2.29 in chips) 
Seat 4: ostap07 ($2 in chips) 
Seat 5: vycheslav d ($1.67 in chips) 
Seat 6: didier.rouss ($0.78 in chips) 
Seat 7: Schdoerrchen ($2.90 in chips) 
Seat 8: serg197211 ($2.28 in chips) 
Seat 9: Redvin33 ($2.10 in chips) 
lalon22: posts small blind $0.01
Gorwfwefwed: posts big blind $0.02
*** HOLE CARDS ***
Dealt to Redvin33 [4s 9c]
ostap07: raises $0.02 to $0.04
vycheslav d: folds 
didier.rouss: folds 
Schdoerrchen: folds 
serg197211: calls $0.04
Redvin33: folds 
VOLOOOODYA: folds 
lalon22: calls $0.03
Gorwfwefwed: folds 
*** FLOP *** [3h 3c Ts]
lalon22: checks 
ostap07: checks 
serg197211: bets $0.09
lalon22: calls $0.09
ostap07: folds 
*** TURN *** [3h 3c Ts] [8s]
lalon22: checks 
serg197211: bets $0.21
lalon22: folds 
Uncalled bet ($0.21) returned to serg197211
serg197211 collected $0.31 from pot
serg197211: doesn't show hand 
*** SUMMARY ***
Total pot $0.32 | Rake $0.01 
Board [3h 3c Ts 8s]
Seat 1: VOLOOOODYA (button) folded before Flop (didn't bet)
Seat 2: lalon22 (small blind) folded on the Turn
Seat 3: Gorwfwefwed (big blind) folded before Flop
Seat 4: ostap07 folded on the Flop
Seat 5: vycheslav d folded before Flop (didn't bet)
Seat 6: didier.rouss folded before Flop (didn't bet)
Seat 7: Schdoerrchen folded before Flop (didn't bet)
Seat 8: serg197211 collected ($0.31)
Seat 9: Redvin33 folded before Flop (didn't bet)



PokerStars Zoom Hand #172696802264:  Hold'em No Limit ($0.01/$0.02) - 2017/07/06 18:31:43 ET
Table 'McNaught' 9-max Seat #1 is the button
Seat 1: colllatinboy ($1.97 in chips) 
Seat 2: bediboy ($4.76 in chips) 
Seat 3: qualifire ($2.10 in chips) 
Seat 4: Redvin33 ($2.19 in chips) 
Seat 5: SolyMar_2011 ($1.13 in chips) 
Seat 6: eviljanne ($2.15 in chips) 
Seat 7: Clarence Jr ($2.51 in chips) 
Seat 8: Sespirion ($1.45 in chips) 
Seat 9: serg197211 ($2 in chips) 
bediboy: posts small blind $0.01
qualifire: posts big blind $0.02
*** HOLE CARDS ***
Dealt to Redvin33 [Ts 5h]
Redvin33: folds 
SolyMar_2011: folds 
eviljanne: raises $0.04 to $0.06
Clarence Jr: folds 
Sespirion: folds 
serg197211: folds 
colllatinboy: folds 
bediboy: folds 
qualifire: folds 
Uncalled bet ($0.04) returned to eviljanne
eviljanne collected $0.05 from pot
eviljanne: doesn't show hand 
*** SUMMARY ***
Total pot $0.05 | Rake $0 
Seat 1: colllatinboy (button) folded before Flop (didn't bet)
Seat 2: bediboy (small blind) folded before Flop
Seat 3: qualifire (big blind) folded before Flop
Seat 4: Redvin33 folded before Flop (didn't bet)
Seat 5: SolyMar_2011 folded before Flop (didn't bet)
Seat 6: eviljanne collected ($0.05)
Seat 7: Clarence Jr folded before Flop (didn't bet)
Seat 8: Sespirion folded before Flop (didn't bet)
Seat 9: serg197211 folded before Flop (didn't bet)



PokerStars Zoom Hand #172696806945:  Hold'em No Limit ($0.01/$0.02) - 2017/07/06 18:31:50 ET
Table 'McNaught' 9-max Seat #1 is the button
Seat 1: Agares91 ($2.01 in chips) 
Seat 2: Redvin33 ($2.19 in chips) 
Seat 3: sergiorom@n ($2 in chips) 
Seat 4: Calchiat ($3.55 in chips) 
Seat 5: valera_9696@ ($2.04 in chips) 
Seat 6: alexpolevaja ($0.42 in chips) 
Seat 7: 3thirteen616 ($1.07 in chips) 
Seat 8: lion.1st ($2.11 in chips) 
Seat 9: colmcc ($2.27 in chips) 
Redvin33: posts small blind $0.01
sergiorom@n: posts big blind $0.02
*** HOLE CARDS ***
Dealt to Redvin33 [Ts 6d]
Calchiat: raises $0.04 to $0.06
valera_9696@: folds 
alexpolevaja: folds 
3thirteen616: calls $0.06
lion.1st: folds 
colmcc: folds 
Agares91: folds 
Redvin33: folds 
sergiorom@n: folds 
*** FLOP *** [Qd 5s Ah]
Calchiat: bets $0.08
3thirteen616: folds 
Uncalled bet ($0.08) returned to Calchiat
Calchiat collected $0.14 from pot
Calchiat: doesn't show hand 
*** SUMMARY ***
Total pot $0.15 | Rake $0.01 
Board [Qd 5s Ah]
Seat 1: Agares91 (button) folded before Flop (didn't bet)
Seat 2: Redvin33 (small blind) folded before Flop
Seat 3: sergiorom@n (big blind) folded before Flop
Seat 4: Calchiat collected ($0.14)
Seat 5: valera_9696@ folded before Flop (didn't bet)
Seat 6: alexpolevaja folded before Flop (didn't bet)
Seat 7: 3thirteen616 folded on the Flop
Seat 8: lion.1st folded before Flop (didn't bet)
Seat 9: colmcc folded before Flop (didn't bet)



PokerStars Zoom Hand #172696804912:  Hold'em No Limit ($0.01/$0.02) - 2017/07/06 18:31:47 ET
Table 'McNaught' 9-max Seat #1 is the button
Seat 1: jeka2015 ($1.09 in chips) 
Seat 2: tdjf ($6.88 in chips) 
Seat 3: ntr2xit ($2 in chips) 
Seat 4: Redvin33 ($2.19 in chips) 
Seat 5: japu2010 ($2.77 in chips) 
Seat 6: colmcc ($2.01 in chips) 
Seat 7: PJWALL ($2.03 in chips) 
Seat 8: burik23 ($2 in chips) 
Seat 9: Xamil666 ($3.24 in chips) 
tdjf: posts small blind $0.01
ntr2xit: posts big blind $0.02
*** HOLE CARDS ***
Dealt to Redvin33 [4d Qs]
Redvin33: folds 
japu2010: folds 
colmcc: folds 
PJWALL: folds 
burik23: calls $0.02
Xamil666: folds 
jeka2015: folds 
tdjf: raises $0.02 to $0.04
ntr2xit: calls $0.02
burik23: calls $0.02
*** FLOP *** [6s 4c 9d]
tdjf: bets $0.12
ntr2xit: calls $0.12
burik23: folds 
*** TURN *** [6s 4c 9d] [Kc]
tdjf: bets $0.34
ntr2xit: folds 
Uncalled bet ($0.34) returned to tdjf
tdjf collected $0.35 from pot
tdjf: doesn't show hand 
*** SUMMARY ***
Total pot $0.36 | Rake $0.01 
Board [6s 4c 9d Kc]
Seat 1: jeka2015 (button) folded before Flop (didn't bet)
Seat 2: tdjf (small blind) collected ($0.35)
Seat 3: ntr2xit (big blind) folded on the Turn
Seat 4: Redvin33 folded before Flop (didn't bet)
Seat 5: japu2010 folded before Flop (didn't bet)
Seat 6: colmcc folded before Flop (didn't bet)
Seat 7: PJWALL folded before Flop (didn't bet)
Seat 8: burik23 folded on the Flop
Seat 9: Xamil666 folded before Flop (didn't bet)



PokerStars Zoom Hand #172696809652:  Hold'em No Limit ($0.01/$0.02) - 2017/07/06 18:31:54 ET
Table 'McNaught' 9-max Seat #1 is the button
Seat 1: nightspeaker ($4.34 in chips) 
Seat 2: ntr2xit ($2 in chips) 
Seat 3: mamiladi1971 ($2.14 in chips) 
Seat 4: Svetlana2962 ($2.70 in chips) 
Seat 5: OlgaGold88 ($1.32 in chips) 
Seat 6: Redvin33 ($2.18 in chips) 
Seat 7: pIay2kiLL ($1.98 in chips) 
Seat 8: SweetPlay777 ($1.55 in chips) 
Seat 9: REISR18 ($4.53 in chips) 
ntr2xit: posts small blind $0.01
mamiladi1971: posts big blind $0.02
*** HOLE CARDS ***
Dealt to Redvin33 [Ac 6s]
Svetlana2962: folds 
OlgaGold88: folds 
Redvin33: raises $0.03 to $0.05
pIay2kiLL: folds 
SweetPlay777: folds 
REISR18: folds 
nightspeaker: folds 
ntr2xit: folds 
mamiladi1971: calls $0.03
*** FLOP *** [7c Js Qs]
mamiladi1971: checks 
Redvin33: bets $0.08
mamiladi1971: calls $0.08
*** TURN *** [7c Js Qs] [Qc]
mamiladi1971: checks 
Redvin33: bets $0.18
mamiladi1971: folds 
Uncalled bet ($0.18) returned to Redvin33
Redvin33 collected $0.26 from pot
Redvin33: doesn't show hand 
*** SUMMARY ***
Total pot $0.27 | Rake $0.01 
Board [7c Js Qs Qc]
Seat 1: nightspeaker (button) folded before Flop (didn't bet)
Seat 2: ntr2xit (small blind) folded before Flop
Seat 3: mamiladi1971 (big blind) folded on the Turn
Seat 4: Svetlana2962 folded before Flop (didn't bet)
Seat 5: OlgaGold88 folded before Flop (didn't bet)
Seat 6: Redvin33 collected ($0.26)
Seat 7: pIay2kiLL folded before Flop (didn't bet)
Seat 8: SweetPlay777 folded before Flop (didn't bet)
Seat 9: REISR18 folded before Flop (didn't bet)



PokerStars Zoom Hand #172696852046:  Hold'em No Limit ($0.01/$0.02) - 2017/07/06 18:32:57 ET
Table 'McNaught' 9-max Seat #1 is the button
Seat 1: COULEUR7 ($2.04 in chips) 
Seat 2: Ksan5979 ($2.14 in chips) 
Seat 3: yayadub ($0.78 in chips) 
Seat 4: Robin872 ($2.84 in chips) 
Seat 5: KarlMarx18 ($2 in chips) 
Seat 6: ttrrookk ($1.90 in chips) 
Seat 7: MrSchnuff ($2.71 in chips) 
Seat 8: Agares91 ($2.03 in chips) 
Seat 9: Redvin33 ($2.31 in chips) 
Ksan5979: posts small blind $0.01
yayadub: posts big blind $0.02
*** HOLE CARDS ***
Dealt to Redvin33 [Tc Ad]
Robin872: folds 
KarlMarx18: folds 
ttrrookk: folds 
MrSchnuff: folds 
Agares91: folds 
Redvin33: raises $0.03 to $0.05
COULEUR7: folds 
Ksan5979: calls $0.04
yayadub: folds 
*** FLOP *** [4s Js 9d]
Ksan5979: checks 
Redvin33: checks 
*** TURN *** [4s Js 9d] [Kh]
Ksan5979: checks 
Redvin33: bets $0.04
Ksan5979: folds 
Uncalled bet ($0.04) returned to Redvin33
Redvin33 collected $0.12 from pot
Redvin33: doesn't show hand 
*** SUMMARY ***
Total pot $0.12 | Rake $0 
Board [4s Js 9d Kh]
Seat 1: COULEUR7 (button) folded before Flop (didn't bet)
Seat 2: Ksan5979 (small blind) folded on the Turn
Seat 3: yayadub (big blind) folded before Flop
Seat 4: Robin872 folded before Flop (didn't bet)
Seat 5: KarlMarx18 folded before Flop (didn't bet)
Seat 6: ttrrookk folded before Flop (didn't bet)
Seat 7: MrSchnuff folded before Flop (didn't bet)
Seat 8: Agares91 folded before Flop (didn't bet)
Seat 9: Redvin33 collected ($0.12)



PokerStars Zoom Hand #172696870302:  Hold'em No Limit ($0.01/$0.02) - 2017/07/06 18:33:24 ET
Table 'McNaught' 9-max Seat #1 is the button
Seat 1: Redvin33 ($2.38 in chips) 
Seat 2: Ksan5979 ($2.10 in chips) 
Seat 3: SweetPlay777 ($1.42 in chips) 
Seat 4: grave_17 ($2.47 in chips) 
Seat 5: denzell574 ($2.04 in chips) 
Seat 6: MrSchnuff ($2.73 in chips) 
Seat 7: Cayoosh16 ($1.03 in chips) 
Seat 8: setair ($2.20 in chips) 
Seat 9: Gorwfwefwed ($3.71 in chips) 
Ksan5979: posts small blind $0.01
SweetPlay777: posts big blind $0.02
*** HOLE CARDS ***
Dealt to Redvin33 [Ah 5h]
grave_17: folds 
denzell574: folds 
MrSchnuff: folds 
Cayoosh16: folds 
setair: folds 
Gorwfwefwed: folds 
Redvin33: raises $0.03 to $0.05
Ksan5979: folds 
SweetPlay777: calls $0.03
*** FLOP *** [Qs 7s 4c]
SweetPlay777: checks 
Redvin33: bets $0.04
SweetPlay777: calls $0.04
*** TURN *** [Qs 7s 4c] [Tc]
SweetPlay777: checks 
Redvin33: checks 
*** RIVER *** [Qs 7s 4c Tc] [Ad]
SweetPlay777: bets $0.18
Redvin33: calls $0.18
*** SHOW DOWN ***
SweetPlay777: shows [8h 8d] (a pair of Eights)
Redvin33: shows [Ah 5h] (a pair of Aces)
Redvin33 collected $0.53 from pot
*** SUMMARY ***
Total pot $0.55 | Rake $0.02 
Board [Qs 7s 4c Tc Ad]
Seat 1: Redvin33 (button) showed [Ah 5h] and won ($0.53) with a pair of Aces
Seat 2: Ksan5979 (small blind) folded before Flop
Seat 3: SweetPlay777 (big blind) showed [8h 8d] and lost with a pair of Eights
Seat 4: grave_17 folded before Flop (didn't bet)
Seat 5: denzell574 folded before Flop (didn't bet)
Seat 6: MrSchnuff folded before Flop (didn't bet)
Seat 7: Cayoosh16 folded before Flop (didn't bet)
Seat 8: setair folded before Flop (didn't bet)
Seat 9: Gorwfwefwed folded before Flop (didn't bet)



PokerStars Zoom Hand #172696898717:  Hold'em No Limit ($0.01/$0.02) - 2017/07/06 18:34:06 ET
Table 'McNaught' 9-max Seat #1 is the button
Seat 1: Agares91 ($2.30 in chips) 
Seat 2: pIay2kiLL ($1.98 in chips) 
Seat 3: Redvin33 ($2.64 in chips) 
Seat 4: ntr2xit ($2.75 in chips) 
Seat 5: ArgusLL ($2.10 in chips) 
Seat 6: leonardosnc ($1.55 in chips) 
Seat 7: O_Atec ($5.45 in chips) 
Seat 8: lalon22 ($1.76 in chips) 
Seat 9: ArthurStk ($3.26 in chips) 
pIay2kiLL: posts small blind $0.01
Redvin33: posts big blind $0.02
*** HOLE CARDS ***
Dealt to Redvin33 [Qc 3d]
ntr2xit: folds 
ArgusLL: folds 
leonardosnc: folds 
O_Atec: folds 
lalon22: folds 
ArthurStk: raises $0.04 to $0.06
Agares91: folds 
pIay2kiLL: folds 
Redvin33: folds 
Uncalled bet ($0.04) returned to ArthurStk
ArthurStk collected $0.05 from pot
ArthurStk: doesn't show hand 
*** SUMMARY ***
Total pot $0.05 | Rake $0 
Seat 1: Agares91 (button) folded before Flop (didn't bet)
Seat 2: pIay2kiLL (small blind) folded before Flop
Seat 3: Redvin33 (big blind) folded before Flop
Seat 4: ntr2xit folded before Flop (didn't bet)
Seat 5: ArgusLL folded before Flop (didn't bet)
Seat 6: leonardosnc folded before Flop (didn't bet)
Seat 7: O_Atec folded before Flop (didn't bet)
Seat 8: lalon22 folded before Flop (didn't bet)
Seat 9: ArthurStk collected ($0.05)



PokerStars Zoom Hand #172696909425:  Hold'em No Limit ($0.01/$0.02) - 2017/07/06 18:34:22 ET
Table 'McNaught' 9-max Seat #1 is the button
Seat 1: Redvin33 ($2.62 in chips) 
Seat 2: jokkers_br ($1.21 in chips) 
Seat 3: lalon22 ($1.76 in chips) 
Seat 4: REISR18 ($11.69 in chips) 
Seat 5: Nille20 ($2.10 in chips) 
Seat 6: Grigoris1962 ($1.87 in chips) 
Seat 7: pIay2kiLL ($1.98 in chips) 
Seat 8: Lionvodoo ($2 in chips) 
Seat 9: LUKIANOV777 ($2.17 in chips) 
jokkers_br: posts small blind $0.01
lalon22: posts big blind $0.02
*** HOLE CARDS ***
Dealt to Redvin33 [2d Ks]
REISR18: folds 
Nille20: folds 
Grigoris1962: folds 
pIay2kiLL: folds 
Lionvodoo: folds 
LUKIANOV777: folds 
Redvin33: folds 
jokkers_br: folds 
Uncalled bet ($0.01) returned to lalon22
lalon22 collected $0.02 from pot
lalon22: doesn't show hand 
*** SUMMARY ***
Total pot $0.02 | Rake $0 
Seat 1: Redvin33 (button) folded before Flop (didn't bet)
Seat 2: jokkers_br (small blind) folded before Flop
Seat 3: lalon22 (big blind) collected ($0.02)
Seat 4: REISR18 folded before Flop (didn't bet)
Seat 5: Nille20 folded before Flop (didn't bet)
Seat 6: Grigoris1962 folded before Flop (didn't bet)
Seat 7: pIay2kiLL folded before Flop (didn't bet)
Seat 8: Lionvodoo folded before Flop (didn't bet)
Seat 9: LUKIANOV777 folded before Flop (didn't bet)



PokerStars Zoom Hand #172696895996:  Hold'em No Limit ($0.01/$0.02) - 2017/07/06 18:34:02 ET
Table 'McNaught' 9-max Seat #1 is the button
Seat 1: ArthurStk ($3.26 in chips) 
Seat 2: BlackChipp ($1.65 in chips) 
Seat 3: Fixitys ($1.79 in chips) 
Seat 4: Mr.Chipeater ($2.22 in chips) 
Seat 5: Gamer577 ($2.38 in chips) 
Seat 6: REISR18 ($4.84 in chips) 
Seat 7: tseku0816 ($0.72 in chips) 
Seat 8: Redvin33 ($2.64 in chips) 
Seat 9: Brucechiou ($2 in chips) 
BlackChipp: posts small blind $0.01
Fixitys: posts big blind $0.02
*** HOLE CARDS ***
Dealt to Redvin33 [3h Jd]
Mr.Chipeater: folds 
Gamer577: folds 
REISR18: folds 
tseku0816: raises $0.02 to $0.04
Redvin33: folds 
Brucechiou: folds 
ArthurStk: folds 
BlackChipp: calls $0.03
Fixitys: folds 
*** FLOP *** [Kh Ad Kd]
BlackChipp: checks 
tseku0816: checks 
*** TURN *** [Kh Ad Kd] [5d]
BlackChipp: checks 
tseku0816: checks 
*** RIVER *** [Kh Ad Kd 5d] [8c]
BlackChipp: checks 
tseku0816: bets $0.06
BlackChipp: folds 
Uncalled bet ($0.06) returned to tseku0816
tseku0816 collected $0.10 from pot
tseku0816: doesn't show hand 
*** SUMMARY ***
Total pot $0.10 | Rake $0 
Board [Kh Ad Kd 5d 8c]
Seat 1: ArthurStk (button) folded before Flop (didn't bet)
Seat 2: BlackChipp (small blind) folded on the River
Seat 3: Fixitys (big blind) folded before Flop
Seat 4: Mr.Chipeater folded before Flop (didn't bet)
Seat 5: Gamer577 folded before Flop (didn't bet)
Seat 6: REISR18 folded before Flop (didn't bet)
Seat 7: tseku0816 collected ($0.10)
Seat 8: Redvin33 folded before Flop (didn't bet)
Seat 9: Brucechiou folded before Flop (didn't bet)



PokerStars Zoom Hand #172696914693:  Hold'em No Limit ($0.01/$0.02) - 2017/07/06 18:34:30 ET
Table 'McNaught' 9-max Seat #1 is the button
Seat 1: Mùúh 22 ($3.11 in chips) 
Seat 2: robertomuc ($2.23 in chips) 
Seat 3: grave_17 ($2.44 in chips) 
Seat 4: VOLOOOODYA ($1.83 in chips) 
Seat 5: san9@neuer ($1.73 in chips) 
Seat 6: smopuim ($3.84 in chips) 
Seat 7: Redvin33 ($2.62 in chips) 
Seat 8: SweetPlay777 ($1.22 in chips) 
Seat 9: qualifire ($4.63 in chips) 
robertomuc: posts small blind $0.01
grave_17: posts big blind $0.02
*** HOLE CARDS ***
Dealt to Redvin33 [Js Ac]
VOLOOOODYA: folds 
san9@neuer: folds 
smopuim: folds 
Redvin33: raises $0.03 to $0.05
SweetPlay777: folds 
qualifire: folds 
Mùúh 22: folds 
robertomuc: calls $0.04
grave_17: folds 
*** FLOP *** [Qd Kh 7d]
robertomuc: checks 
Redvin33: bets $0.06
robertomuc: folds 
Uncalled bet ($0.06) returned to Redvin33
Redvin33 collected $0.12 from pot
Redvin33: doesn't show hand 
*** SUMMARY ***
Total pot $0.12 | Rake $0 
Board [Qd Kh 7d]
Seat 1: Mùúh 22 (button) folded before Flop (didn't bet)
Seat 2: robertomuc (small blind) folded on the Flop
Seat 3: grave_17 (big blind) folded before Flop
Seat 4: VOLOOOODYA folded before Flop (didn't bet)
Seat 5: san9@neuer folded before Flop (didn't bet)
Seat 6: smopuim folded before Flop (didn't bet)
Seat 7: Redvin33 collected ($0.12)
Seat 8: SweetPlay777 folded before Flop (didn't bet)
Seat 9: qualifire folded before Flop (didn't bet)



PokerStars Zoom Hand #172696934095:  Hold'em No Limit ($0.01/$0.02) - 2017/07/06 18:34:59 ET
Table 'McNaught' 9-max Seat #1 is the button
Seat 1: komarkoff ($2 in chips) 
Seat 2: ChristoPloBe ($2.13 in chips) 
Seat 3: locobest13 ($2.14 in chips) 
Seat 4: Gamer577 ($2 in chips) 
Seat 5: Xamil666 ($4.58 in chips) 
Seat 6: ArgusLL ($2.08 in chips) 
Seat 7: Redvin33 ($2.69 in chips) 
Seat 8: Sympathya ($2.53 in chips) 
Seat 9: Haczlo ($4.79 in chips) 
ChristoPloBe: posts small blind $0.01
locobest13: posts big blind $0.02
*** HOLE CARDS ***
Dealt to Redvin33 [Jd Kc]
Gamer577: raises $0.04 to $0.06
Xamil666: folds 
ArgusLL: folds 
Redvin33: calls $0.06
Sympathya: folds 
Haczlo: folds 
komarkoff: folds 
ChristoPloBe: folds 
locobest13: folds 
*** FLOP *** [7h Qd Tc]
Gamer577: bets $0.09
Redvin33: calls $0.09
*** TURN *** [7h Qd Tc] [Qh]
Gamer577: bets $0.21
Redvin33: folds 
Uncalled bet ($0.21) returned to Gamer577
Gamer577 collected $0.32 from pot
Gamer577: doesn't show hand 
*** SUMMARY ***
Total pot $0.33 | Rake $0.01 
Board [7h Qd Tc Qh]
Seat 1: komarkoff (button) folded before Flop (didn't bet)
Seat 2: ChristoPloBe (small blind) folded before Flop
Seat 3: locobest13 (big blind) folded before Flop
Seat 4: Gamer577 collected ($0.32)
Seat 5: Xamil666 folded before Flop (didn't bet)
Seat 6: ArgusLL folded before Flop (didn't bet)
Seat 7: Redvin33 folded on the Turn
Seat 8: Sympathya folded before Flop (didn't bet)
Seat 9: Haczlo folded before Flop (didn't bet)



PokerStars Zoom Hand #172696958952:  Hold'em No Limit ($0.01/$0.02) - 2017/07/06 18:35:36 ET
Table 'McNaught' 9-max Seat #1 is the button
Seat 1: KaHcTpykTap ($3.82 in chips) 
Seat 2: bicho1040 ($5.68 in chips) 
Seat 3: wexie ($1.79 in chips) 
Seat 4: Caatkins ($1.89 in chips) 
Seat 5: Redvin33 ($2.53 in chips) 
Seat 6: arsen99 ($2.86 in chips) 
Seat 7: colmcc ($2.40 in chips) 
Seat 8: REISR18 ($3.46 in chips) 
Seat 9: Gamer577 ($2.49 in chips) 
bicho1040: posts small blind $0.01
wexie: posts big blind $0.02
*** HOLE CARDS ***
Dealt to Redvin33 [6h Jd]
Caatkins: folds 
Redvin33: folds 
arsen99: folds 
colmcc: folds 
REISR18: folds 
Gamer577: folds 
KaHcTpykTap: folds 
bicho1040: folds 
Uncalled bet ($0.01) returned to wexie
wexie collected $0.02 from pot
wexie: doesn't show hand 
*** SUMMARY ***
Total pot $0.02 | Rake $0 
Seat 1: KaHcTpykTap (button) folded before Flop (didn't bet)
Seat 2: bicho1040 (small blind) folded before Flop
Seat 3: wexie (big blind) collected ($0.02)
Seat 4: Caatkins folded before Flop (didn't bet)
Seat 5: Redvin33 folded before Flop (didn't bet)
Seat 6: arsen99 folded before Flop (didn't bet)
Seat 7: colmcc folded before Flop (didn't bet)
Seat 8: REISR18 folded before Flop (didn't bet)
Seat 9: Gamer577 folded before Flop (didn't bet)



PokerStars Zoom Hand #172696965585:  Hold'em No Limit ($0.01/$0.02) - 2017/07/06 18:35:46 ET
Table 'McNaught' 9-max Seat #1 is the button
Seat 1: FidgetyWins ($2.59 in chips) 
Seat 2: wexie ($1.80 in chips) 
Seat 3: Grimm Araan ($1.42 in chips) 
Seat 4: ArthurStk ($2.56 in chips) 
Seat 5: REISR18 ($3.46 in chips) 
Seat 6: ewsikinho ($9.43 in chips) 
Seat 7: Dulaper ($1.87 in chips) 
Seat 8: Redvin33 ($2.53 in chips) 
Seat 9: Peros1 ($2 in chips) 
wexie: posts small blind $0.01
Grimm Araan: posts big blind $0.02
*** HOLE CARDS ***
Dealt to Redvin33 [Qs Kc]
ArthurStk: raises $0.04 to $0.06
REISR18: folds 
ewsikinho: folds 
Dulaper: folds 
Redvin33: calls $0.06
Peros1: folds 
FidgetyWins: folds 
wexie: folds 
Grimm Araan: calls $0.04
*** FLOP *** [2c 8d 2h]
Grimm Araan: checks 
ArthurStk: bets $0.12
Redvin33: folds 
Grimm Araan: folds 
Uncalled bet ($0.12) returned to ArthurStk
ArthurStk collected $0.18 from pot
ArthurStk: doesn't show hand 
*** SUMMARY ***
Total pot $0.19 | Rake $0.01 
Board [2c 8d 2h]
Seat 1: FidgetyWins (button) folded before Flop (didn't bet)
Seat 2: wexie (small blind) folded before Flop
Seat 3: Grimm Araan (big blind) folded on the Flop
Seat 4: ArthurStk collected ($0.18)
Seat 5: REISR18 folded before Flop (didn't bet)
Seat 6: ewsikinho folded before Flop (didn't bet)
Seat 7: Dulaper folded before Flop (didn't bet)
Seat 8: Redvin33 folded on the Flop
Seat 9: Peros1 folded before Flop (didn't bet)



PokerStars Zoom Hand #172696962934:  Hold'em No Limit ($0.01/$0.02) - 2017/07/06 18:35:42 ET
Table 'McNaught' 9-max Seat #1 is the button
Seat 1: setair ($2.22 in chips) 
Seat 2: Cayoosh16 ($1.68 in chips) 
Seat 3: ShadMrPo ($2 in chips) 
Seat 4: Taraba68 ($2.32 in chips) 
Seat 5: ArthurStk ($2.56 in chips) 
Seat 6: Redvin33 ($2.53 in chips) 
Seat 7: manowar7771 ($2.75 in chips) 
Seat 8: Mùúh 22 ($3.07 in chips) 
Seat 9: colmcc ($2.19 in chips) 
Cayoosh16: posts small blind $0.01
ShadMrPo: posts big blind $0.02
*** HOLE CARDS ***
Dealt to Redvin33 [Tc 4d]
Taraba68 has timed out
Taraba68: folds 
ArthurStk: folds 
Redvin33: folds 
manowar7771: folds 
Mùúh 22: folds 
colmcc: folds 
setair: folds 
Cayoosh16: folds 
Uncalled bet ($0.01) returned to ShadMrPo
ShadMrPo collected $0.02 from pot
ShadMrPo: doesn't show hand 
*** SUMMARY ***
Total pot $0.02 | Rake $0 
Seat 1: setair (button) folded before Flop (didn't bet)
Seat 2: Cayoosh16 (small blind) folded before Flop
Seat 3: ShadMrPo (big blind) collected ($0.02)
Seat 4: Taraba68 folded before Flop (didn't bet)
Seat 5: ArthurStk folded before Flop (didn't bet)
Seat 6: Redvin33 folded before Flop (didn't bet)
Seat 7: manowar7771 folded before Flop (didn't bet)
Seat 8: Mùúh 22 folded before Flop (didn't bet)
Seat 9: colmcc folded before Flop (didn't bet)



PokerStars Zoom Hand #172696956219:  Hold'em No Limit ($0.01/$0.02) - 2017/07/06 18:35:32 ET
Table 'McNaught' 9-max Seat #1 is the button
Seat 1: 3thirteen616 ($5.35 in chips) 
Seat 2: Redvin33 ($2.54 in chips) 
Seat 3: KarlMarx18 ($2.15 in chips) 
Seat 4: nicolasriver ($2.76 in chips) 
Seat 5: dmitrychuk ($1.90 in chips) 
Seat 6: babaevv0 ($1.35 in chips) 
Seat 7: SSSA204 ($2.03 in chips) 
Seat 8: RogerPernía ($2.47 in chips) 
Seat 9: pickdoker ($2.15 in chips) 
Redvin33: posts small blind $0.01
KarlMarx18: posts big blind $0.02
*** HOLE CARDS ***
Dealt to Redvin33 [8c Th]
nicolasriver: folds 
dmitrychuk: folds 
babaevv0 has timed out
babaevv0: folds 
SSSA204: folds 
RogerPernía: folds 
pickdoker: folds 
3thirteen616: raises $0.05 to $0.07
Redvin33: folds 
KarlMarx18: folds 
Uncalled bet ($0.05) returned to 3thirteen616
3thirteen616 collected $0.05 from pot
3thirteen616: doesn't show hand 
*** SUMMARY ***
Total pot $0.05 | Rake $0 
Seat 1: 3thirteen616 (button) collected ($0.05)
Seat 2: Redvin33 (small blind) folded before Flop
Seat 3: KarlMarx18 (big blind) folded before Flop
Seat 4: nicolasriver folded before Flop (didn't bet)
Seat 5: dmitrychuk folded before Flop (didn't bet)
Seat 6: babaevv0 folded before Flop (didn't bet)
Seat 7: SSSA204 folded before Flop (didn't bet)
Seat 8: RogerPernía folded before Flop (didn't bet)
Seat 9: pickdoker folded before Flop (didn't bet)



PokerStars Zoom Hand #172696976169:  Hold'em No Limit ($0.01/$0.02) - 2017/07/06 18:36:02 ET
Table 'McNaught' 9-max Seat #1 is the button
Seat 1: fsbmro ($2.13 in chips) 
Seat 2: Kenshiro*969 ($2.06 in chips) 
Seat 3: Tsybulya ($8.66 in chips) 
Seat 4: LicGuapo ($2.17 in chips) 
Seat 5: Redvin33 ($2.47 in chips) 
Seat 6: sohatyy ($2.56 in chips) 
Seat 7: mmartin1748 ($2.14 in chips) 
Seat 8: Cayoosh16 ($1.99 in chips) 
Seat 9: locobest13 ($2.07 in chips) 
Kenshiro*969: posts small blind $0.01
Tsybulya: posts big blind $0.02
*** HOLE CARDS ***
Dealt to Redvin33 [Jh Jd]
LicGuapo: folds 
Redvin33: raises $0.03 to $0.05
sohatyy: folds 
mmartin1748: folds 
Cayoosh16: raises $0.15 to $0.20
locobest13: folds 
fsbmro: folds 
Kenshiro*969: folds 
Tsybulya: folds 
Redvin33: folds 
Uncalled bet ($0.15) returned to Cayoosh16
Cayoosh16 collected $0.13 from pot
Cayoosh16: doesn't show hand 
*** SUMMARY ***
Total pot $0.13 | Rake $0 
Seat 1: fsbmro (button) folded before Flop (didn't bet)
Seat 2: Kenshiro*969 (small blind) folded before Flop
Seat 3: Tsybulya (big blind) folded before Flop
Seat 4: LicGuapo folded before Flop (didn't bet)
Seat 5: Redvin33 folded before Flop
Seat 6: sohatyy folded before Flop (didn't bet)
Seat 7: mmartin1748 folded before Flop (didn't bet)
Seat 8: Cayoosh16 collected ($0.13)
Seat 9: locobest13 folded before Flop (didn't bet)



PokerStars Zoom Hand #172697014253:  Hold'em No Limit ($0.01/$0.02) - 2017/07/06 18:36:59 ET
Table 'McNaught' 9-max Seat #1 is the button
Seat 1: Winterdgr ($2.06 in chips) 
Seat 2: nerml000 ($2.76 in chips) 
Seat 3: Redvin33 ($2.42 in chips) 
Seat 4: Jaffar999 ($2.24 in chips) 
Seat 5: 3thirteen616 ($5.41 in chips) 
Seat 6: pIay2kiLL ($1.98 in chips) 
Seat 7: }II{yJIuI{ ($1.17 in chips) 
Seat 8: SweetPlay777 ($1.82 in chips) 
Seat 9: AZAAAAAP ($1.97 in chips) 
nerml000: posts small blind $0.01
Redvin33: posts big blind $0.02
*** HOLE CARDS ***
Dealt to Redvin33 [9d 9h]
Jaffar999: folds 
3thirteen616: folds 
pIay2kiLL: folds 
}II{yJIuI{: folds 
SweetPlay777: folds 
AZAAAAAP: folds 
Winterdgr: folds 
nerml000: folds 
Uncalled bet ($0.01) returned to Redvin33
Redvin33 collected $0.02 from pot
Redvin33: doesn't show hand 
*** SUMMARY ***
Total pot $0.02 | Rake $0 
Seat 1: Winterdgr (button) folded before Flop (didn't bet)
Seat 2: nerml000 (small blind) folded before Flop
Seat 3: Redvin33 (big blind) collected ($0.02)
Seat 4: Jaffar999 folded before Flop (didn't bet)
Seat 5: 3thirteen616 folded before Flop (didn't bet)
Seat 6: pIay2kiLL folded before Flop (didn't bet)
Seat 7: }II{yJIuI{ folded before Flop (didn't bet)
Seat 8: SweetPlay777 folded before Flop (didn't bet)
Seat 9: AZAAAAAP folded before Flop (didn't bet)



PokerStars Zoom Hand #172697022236:  Hold'em No Limit ($0.01/$0.02) - 2017/07/06 18:37:11 ET
Table 'McNaught' 9-max Seat #1 is the button
Seat 1: Unconform ($2.11 in chips) 
Seat 2: uncledon888 ($0.80 in chips) 
Seat 3: vycheslav d ($0.77 in chips) 
Seat 4: colllatinboy ($1.62 in chips) 
Seat 5: Sympathya ($2.50 in chips) 
Seat 6: COULEUR7 ($2.01 in chips) 
Seat 7: MHTROYS ($1.03 in chips) 
Seat 8: toluschev ($1.33 in chips) 
Seat 9: Redvin33 ($2.43 in chips) 
uncledon888: posts small blind $0.01
vycheslav d: posts big blind $0.02
*** HOLE CARDS ***
Dealt to Redvin33 [7h Ah]
colllatinboy: folds 
Sympathya: folds 
COULEUR7: folds 
MHTROYS: folds 
toluschev: raises $0.04 to $0.06
Redvin33: calls $0.06
Unconform: folds 
uncledon888: folds 
vycheslav d: folds 
*** FLOP *** [9d Js 9c]
toluschev: bets $0.08
Redvin33: folds 
Uncalled bet ($0.08) returned to toluschev
toluschev collected $0.14 from pot
toluschev: doesn't show hand 
*** SUMMARY ***
Total pot $0.15 | Rake $0.01 
Board [9d Js 9c]
Seat 1: Unconform (button) folded before Flop (didn't bet)
Seat 2: uncledon888 (small blind) folded before Flop
Seat 3: vycheslav d (big blind) folded before Flop
Seat 4: colllatinboy folded before Flop (didn't bet)
Seat 5: Sympathya folded before Flop (didn't bet)
Seat 6: COULEUR7 folded before Flop (didn't bet)
Seat 7: MHTROYS folded before Flop (didn't bet)
Seat 8: toluschev collected ($0.14)
Seat 9: Redvin33 folded on the Flop



PokerStars Zoom Hand #172697046834:  Hold'em No Limit ($0.01/$0.02) - 2017/07/06 18:37:48 ET
Table 'McNaught' 9-max Seat #1 is the button
Seat 1: batiraki13 ($2.07 in chips) 
Seat 2: dmitrychuk ($1.83 in chips) 
Seat 3: viagem ($5.64 in chips) 
Seat 4: Redvin33 ($2.37 in chips) 
Seat 5: nerml000 ($2.25 in chips) 
Seat 6: lokkiannu ($0.75 in chips) 
Seat 7: Caatkins ($1.92 in chips) 
Seat 8: KaHcTpykTap ($2 in chips) 
Seat 9: REISR18 ($3.43 in chips) 
dmitrychuk: posts small blind $0.01
viagem: posts big blind $0.02
*** HOLE CARDS ***
Dealt to Redvin33 [3c Js]
Redvin33: folds 
nerml000: folds 
lokkiannu: folds 
Caatkins: raises $0.06 to $0.08
KaHcTpykTap: folds 
REISR18: calls $0.08
batiraki13: folds 
dmitrychuk: folds 
viagem: raises $0.25 to $0.33
Caatkins: raises $1.59 to $1.92 and is all-in
REISR18: folds 
viagem: calls $1.59
*** FLOP *** [8s 5d Td]
*** TURN *** [8s 5d Td] [4s]
*** RIVER *** [8s 5d Td 4s] [6s]
*** SHOW DOWN ***
viagem: shows [Ac Ad] (a pair of Aces)
Caatkins: shows [Qc Qs] (a pair of Queens)
viagem collected $3.79 from pot
*** SUMMARY ***
Total pot $3.93 | Rake $0.14 
Board [8s 5d Td 4s 6s]
Seat 1: batiraki13 (button) folded before Flop (didn't bet)
Seat 2: dmitrychuk (small blind) folded before Flop
Seat 3: viagem (big blind) showed [Ac Ad] and won ($3.79) with a pair of Aces
Seat 4: Redvin33 folded before Flop (didn't bet)
Seat 5: nerml000 folded before Flop (didn't bet)
Seat 6: lokkiannu folded before Flop (didn't bet)
Seat 7: Caatkins showed [Qc Qs] and lost with a pair of Queens
Seat 8: KaHcTpykTap folded before Flop (didn't bet)
Seat 9: REISR18 folded before Flop



PokerStars Zoom Hand #172697043470:  Hold'em No Limit ($0.01/$0.02) - 2017/07/06 18:37:43 ET
Table 'McNaught' 9-max Seat #1 is the button
Seat 1: colmcc ($2.13 in chips) 
Seat 2: benchboy ($2.04 in chips) 
Seat 3: Gamer577 ($2.03 in chips) 
Seat 4: Unconform ($2.45 in chips) 
Seat 5: Roman 0992 ($2 in chips) 
Seat 6: Redvin33 ($2.37 in chips) 
Seat 7: Bart018 ($1.98 in chips) 
Seat 8: ArgusLL ($2.11 in chips) 
Seat 9: I gendos ($3.07 in chips) 
benchboy: posts small blind $0.01
Gamer577: posts big blind $0.02
*** HOLE CARDS ***
Dealt to Redvin33 [6c 8d]
Unconform: folds 
Roman 0992: folds 
Redvin33: folds 
Bart018: raises $0.04 to $0.06
ArgusLL: folds 
I gendos: calls $0.06
colmcc: folds 
benchboy: folds 
Gamer577: folds 
*** FLOP *** [Kh Js 4h]
Bart018: bets $0.10
I gendos: calls $0.10
*** TURN *** [Kh Js 4h] [4c]
Bart018: bets $0.24
I gendos: calls $0.24
*** RIVER *** [Kh Js 4h 4c] [Qh]
Bart018: bets $0.28
I gendos: calls $0.28
*** SHOW DOWN ***
Bart018: shows [Kd Ah] (two pair, Kings and Fours)
I gendos: mucks hand 
Bart018 collected $1.34 from pot
*** SUMMARY ***
Total pot $1.39 | Rake $0.05 
Board [Kh Js 4h 4c Qh]
Seat 1: colmcc (button) folded before Flop (didn't bet)
Seat 2: benchboy (small blind) folded before Flop
Seat 3: Gamer577 (big blind) folded before Flop
Seat 4: Unconform folded before Flop (didn't bet)
Seat 5: Roman 0992 folded before Flop (didn't bet)
Seat 6: Redvin33 folded before Flop (didn't bet)
Seat 7: Bart018 showed [Kd Ah] and won ($1.34) with two pair, Kings and Fours
Seat 8: ArgusLL folded before Flop (didn't bet)
Seat 9: I gendos mucked [Ac Qd]



PokerStars Zoom Hand #172697054695:  Hold'em No Limit ($0.01/$0.02) - 2017/07/06 18:38:00 ET
Table 'McNaught' 9-max Seat #1 is the button
Seat 1: Nikoro309 ($2.81 in chips) 
Seat 2: Redvin33 ($2.37 in chips) 
Seat 3: Ksan5979 ($2.44 in chips) 
Seat 4: Cayoosh16 ($1.28 in chips) 
Seat 5: rubino_nick ($2 in chips) 
Seat 6: Nille20 ($2.12 in chips) 
Seat 7: vycheslav d ($0.74 in chips) 
Seat 8: Gorwfwefwed ($3.67 in chips) 
Seat 9: denzell574 ($2 in chips) 
Redvin33: posts small blind $0.01
Ksan5979: posts big blind $0.02
*** HOLE CARDS ***
Dealt to Redvin33 [9d 9c]
Cayoosh16: folds 
rubino_nick: folds 
Nille20: folds 
vycheslav d: folds 
Gorwfwefwed: folds 
denzell574: raises $0.03 to $0.05
Nikoro309: raises $0.12 to $0.17
Redvin33: calls $0.16
Ksan5979: folds 
denzell574: calls $0.12
*** FLOP *** [2c 6h 4d]
Redvin33: bets $0.14
denzell574: calls $0.14
Nikoro309: folds 
*** TURN *** [2c 6h 4d] [7s]
Redvin33: checks 
denzell574: checks 
*** RIVER *** [2c 6h 4d 7s] [Td]
Redvin33: checks 
denzell574: checks 
*** SHOW DOWN ***
Redvin33: shows [9d 9c] (a pair of Nines)
denzell574: mucks hand 
Redvin33 collected $0.78 from pot
*** SUMMARY ***
Total pot $0.81 | Rake $0.03 
Board [2c 6h 4d 7s Td]
Seat 1: Nikoro309 (button) folded on the Flop
Seat 2: Redvin33 (small blind) showed [9d 9c] and won ($0.78) with a pair of Nines
Seat 3: Ksan5979 (big blind) folded before Flop
Seat 4: Cayoosh16 folded before Flop (didn't bet)
Seat 5: rubino_nick folded before Flop (didn't bet)
Seat 6: Nille20 folded before Flop (didn't bet)
Seat 7: vycheslav d folded before Flop (didn't bet)
Seat 8: Gorwfwefwed folded before Flop (didn't bet)
Seat 9: denzell574 mucked [Ac 6c]



PokerStars Zoom Hand #172697093425:  Hold'em No Limit ($0.01/$0.02) - 2017/07/06 18:38:59 ET
Table 'McNaught' 9-max Seat #1 is the button
Seat 1: Redvin33 ($2.84 in chips) 
Seat 2: ewsikinho ($2 in chips) 
Seat 3: mmartin1748 ($2.49 in chips) 
Seat 4: komarkoff ($2 in chips) 
Seat 5: COULEUR7 ($4.33 in chips) 
Seat 6: denzell574 ($1.69 in chips) 
Seat 7: E-Berta ($0.64 in chips) 
Seat 8: ShadMrPo ($2.11 in chips) 
Seat 9: ArthurStk ($3.20 in chips) 
ewsikinho: posts small blind $0.01
mmartin1748: posts big blind $0.02
*** HOLE CARDS ***
Dealt to Redvin33 [Qh Kd]
komarkoff: folds 
COULEUR7: folds 
denzell574: folds 
E-Berta: folds 
ShadMrPo: folds 
ArthurStk: folds 
Redvin33: raises $0.03 to $0.05
ewsikinho: folds 
mmartin1748: calls $0.03
*** FLOP *** [Ad 8s 9s]
mmartin1748: checks 
Redvin33: checks 
*** TURN *** [Ad 8s 9s] [3h]
mmartin1748: checks 
Redvin33: bets $0.06
mmartin1748: calls $0.06
*** RIVER *** [Ad 8s 9s 3h] [3c]
mmartin1748: checks 
Redvin33: bets $0.06
mmartin1748: calls $0.06
*** SHOW DOWN ***
Redvin33: shows [Qh Kd] (a pair of Threes)
mmartin1748: shows [6h 6d] (two pair, Sixes and Threes)
mmartin1748 collected $0.34 from pot
*** SUMMARY ***
Total pot $0.35 | Rake $0.01 
Board [Ad 8s 9s 3h 3c]
Seat 1: Redvin33 (button) showed [Qh Kd] and lost with a pair of Threes
Seat 2: ewsikinho (small blind) folded before Flop
Seat 3: mmartin1748 (big blind) showed [6h 6d] and won ($0.34) with two pair, Sixes and Threes
Seat 4: komarkoff folded before Flop (didn't bet)
Seat 5: COULEUR7 folded before Flop (didn't bet)
Seat 6: denzell574 folded before Flop (didn't bet)
Seat 7: E-Berta folded before Flop (didn't bet)
Seat 8: ShadMrPo folded before Flop (didn't bet)
Seat 9: ArthurStk folded before Flop (didn't bet)



PokerStars Zoom Hand #172697132361:  Hold'em No Limit ($0.01/$0.02) - 2017/07/06 18:39:59 ET
Table 'McNaught' 9-max Seat #1 is the button
Seat 1: Allekccc ($9.74 in chips) 
Seat 2: Kostya83Uzh ($2 in chips) 
Seat 3: ArgusLL ($2.19 in chips) 
Seat 4: Redvin33 ($2.67 in chips) 
Seat 5: Lionvodoo ($2 in chips) 
Seat 6: ewsikinho ($6.39 in chips) 
Seat 7: cooler50 ($1.89 in chips) 
Seat 8: ArthurStk ($8.97 in chips) 
Seat 9: Cnopic666 ($3.43 in chips) 
Kostya83Uzh: posts small blind $0.01
ArgusLL: posts big blind $0.02
*** HOLE CARDS ***
Dealt to Redvin33 [9c 4s]
Redvin33: folds 
Lionvodoo: folds 
ewsikinho: folds 
cooler50: folds 
ArthurStk: folds 
Cnopic666: folds 
Allekccc: folds 
Kostya83Uzh: folds 
Uncalled bet ($0.01) returned to ArgusLL
ArgusLL collected $0.02 from pot
ArgusLL: doesn't show hand 
*** SUMMARY ***
Total pot $0.02 | Rake $0 
Seat 1: Allekccc (button) folded before Flop (didn't bet)
Seat 2: Kostya83Uzh (small blind) folded before Flop
Seat 3: ArgusLL (big blind) collected ($0.02)
Seat 4: Redvin33 folded before Flop (didn't bet)
Seat 5: Lionvodoo folded before Flop (didn't bet)
Seat 6: ewsikinho folded before Flop (didn't bet)
Seat 7: cooler50 folded before Flop (didn't bet)
Seat 8: ArthurStk folded before Flop (didn't bet)
Seat 9: Cnopic666 folded before Flop (didn't bet)



PokerStars Zoom Hand #172697136424:  Hold'em No Limit ($0.01/$0.02) - 2017/07/06 18:40:05 ET
Table 'McNaught' 9-max Seat #1 is the button
Seat 1: lanaman1 ($1.57 in chips) 
Seat 2: Fons Vitae ($1.55 in chips) 
Seat 3: Xamil666 ($4.55 in chips) 
Seat 4: ArthurStk ($2.50 in chips) 
Seat 5: Kenshiro*969 ($2.19 in chips) 
Seat 6: SebConway ($1.72 in chips) 
Seat 7: jokkers_br ($1.04 in chips) 
Seat 8: Redvin33 ($2.67 in chips) 
Seat 9: tseku0816 ($1.49 in chips) 
Fons Vitae: posts small blind $0.01
Xamil666: posts big blind $0.02
*** HOLE CARDS ***
Dealt to Redvin33 [Js 2s]
ArthurStk: folds 
Kenshiro*969: folds 
SebConway: folds 
jokkers_br: folds 
Redvin33: folds 
tseku0816: folds 
lanaman1: folds 
Fons Vitae: folds 
Uncalled bet ($0.01) returned to Xamil666
Xamil666 collected $0.02 from pot
Xamil666: doesn't show hand 
*** SUMMARY ***
Total pot $0.02 | Rake $0 
Seat 1: lanaman1 (button) folded before Flop (didn't bet)
Seat 2: Fons Vitae (small blind) folded before Flop
Seat 3: Xamil666 (big blind) collected ($0.02)
Seat 4: ArthurStk folded before Flop (didn't bet)
Seat 5: Kenshiro*969 folded before Flop (didn't bet)
Seat 6: SebConway folded before Flop (didn't bet)
Seat 7: jokkers_br folded before Flop (didn't bet)
Seat 8: Redvin33 folded before Flop (didn't bet)
Seat 9: tseku0816 folded before Flop (didn't bet)



PokerStars Zoom Hand #172697140374:  Hold'em No Limit ($0.01/$0.02) - 2017/07/06 18:40:11 ET
Table 'McNaught' 9-max Seat #1 is the button
Seat 1: ArthurStk ($2.50 in chips) 
Seat 2: LicGuapo ($2.08 in chips) 
Seat 3: MPaz_87 ($2.11 in chips) 
Seat 4: Redvin33 ($2.67 in chips) 
Seat 5: filipov1976 ($4.17 in chips) 
Seat 6: qualifire ($3.22 in chips) 
Seat 7: Gamer577 ($2.19 in chips) 
Seat 8: valera_9696@ ($2.18 in chips) 
Seat 9: Cnopic666 ($16.33 in chips) 
LicGuapo: posts small blind $0.01
MPaz_87: posts big blind $0.02
*** HOLE CARDS ***
Dealt to Redvin33 [Qh Qs]
Redvin33: raises $0.03 to $0.05
filipov1976: folds 
qualifire: folds 
Gamer577: folds 
valera_9696@: folds 
Cnopic666: folds 
ArthurStk: folds 
LicGuapo: folds 
MPaz_87: folds 
Uncalled bet ($0.03) returned to Redvin33
Redvin33 collected $0.05 from pot
Redvin33: doesn't show hand 
*** SUMMARY ***
Total pot $0.05 | Rake $0 
Seat 1: ArthurStk (button) folded before Flop (didn't bet)
Seat 2: LicGuapo (small blind) folded before Flop
Seat 3: MPaz_87 (big blind) folded before Flop
Seat 4: Redvin33 collected ($0.05)
Seat 5: filipov1976 folded before Flop (didn't bet)
Seat 6: qualifire folded before Flop (didn't bet)
Seat 7: Gamer577 folded before Flop (didn't bet)
Seat 8: valera_9696@ folded before Flop (didn't bet)
Seat 9: Cnopic666 folded before Flop (didn't bet)



PokerStars Zoom Hand #172697162464:  Hold'em No Limit ($0.01/$0.02) - 2017/07/06 18:40:45 ET
Table 'McNaught' 9-max Seat #1 is the button
Seat 1: ameno-dorime ($1.23 in chips) 
Seat 2: kubeiks ($1.46 in chips) 
Seat 3: Allekccc ($9.73 in chips) 
Seat 4: grave_17 ($2.06 in chips) 
Seat 5: Schdoerrchen ($3.06 in chips) 
Seat 6: paul_ivanov ($1.53 in chips) 
Seat 7: Redvin33 ($2.70 in chips) 
Seat 8: Ujo Gugl ($3.68 in chips) 
Seat 9: Sympathya ($2.26 in chips) 
kubeiks: posts small blind $0.01
Allekccc: posts big blind $0.02
*** HOLE CARDS ***
Dealt to Redvin33 [7h 8c]
grave_17: folds 
Schdoerrchen: folds 
paul_ivanov: raises $0.04 to $0.06
Redvin33: folds 
Ujo Gugl: folds 
Sympathya: folds 
ameno-dorime: folds 
kubeiks: folds 
Allekccc: folds 
Uncalled bet ($0.04) returned to paul_ivanov
paul_ivanov collected $0.05 from pot
paul_ivanov: doesn't show hand 
*** SUMMARY ***
Total pot $0.05 | Rake $0 
Seat 1: ameno-dorime (button) folded before Flop (didn't bet)
Seat 2: kubeiks (small blind) folded before Flop
Seat 3: Allekccc (big blind) folded before Flop
Seat 4: grave_17 folded before Flop (didn't bet)
Seat 5: Schdoerrchen folded before Flop (didn't bet)
Seat 6: paul_ivanov collected ($0.05)
Seat 7: Redvin33 folded before Flop (didn't bet)
Seat 8: Ujo Gugl folded before Flop (didn't bet)
Seat 9: Sympathya folded before Flop (didn't bet)



PokerStars Zoom Hand #172697172910:  Hold'em No Limit ($0.01/$0.02) - 2017/07/06 18:41:01 ET
Table 'McNaught' 9-max Seat #1 is the button
Seat 1: Rishnu Fr ($4.09 in chips) 
Seat 2: KarlMarx18 ($2.03 in chips) 
Seat 3: Gamer577 ($4.16 in chips) 
Seat 4: robertomuc ($2 in chips) 
Seat 5: vagebolle ($1.15 in chips) 
Seat 6: Redvin33 ($2.68 in chips) 
Seat 7: O_Atec ($3.05 in chips) 
Seat 8: motola cun ($2.26 in chips) 
Seat 9: mamiladi1971 ($1.72 in chips) 
KarlMarx18: posts small blind $0.01
Gamer577: posts big blind $0.02
*** HOLE CARDS ***
Dealt to Redvin33 [Jd 2s]
robertomuc: folds 
vagebolle: folds 
Redvin33: folds 
O_Atec: folds 
motola cun: folds 
mamiladi1971: folds 
Rishnu Fr: folds 
KarlMarx18: folds 
Uncalled bet ($0.01) returned to Gamer577
Gamer577 collected $0.02 from pot
Gamer577: doesn't show hand 
*** SUMMARY ***
Total pot $0.02 | Rake $0 
Seat 1: Rishnu Fr (button) folded before Flop (didn't bet)
Seat 2: KarlMarx18 (small blind) folded before Flop
Seat 3: Gamer577 (big blind) collected ($0.02)
Seat 4: robertomuc folded before Flop (didn't bet)
Seat 5: vagebolle folded before Flop (didn't bet)
Seat 6: Redvin33 folded before Flop (didn't bet)
Seat 7: O_Atec folded before Flop (didn't bet)
Seat 8: motola cun folded before Flop (didn't bet)
Seat 9: mamiladi1971 folded before Flop (didn't bet)



PokerStars Zoom Hand #172697165035:  Hold'em No Limit ($0.01/$0.02) - 2017/07/06 18:40:49 ET
Table 'McNaught' 9-max Seat #1 is the button
Seat 1: kubeiks ($1.45 in chips) 
Seat 2: lion.1st ($2.03 in chips) 
Seat 3: Redvin33 ($2.70 in chips) 
Seat 4: }II{yJIuI{ ($1.12 in chips) 
Seat 5: I gendos ($2.26 in chips) 
Seat 6: jokkers_br ($1.07 in chips) 
Seat 7: LUKIANOV777 ($2.20 in chips) 
Seat 8: PJWALL ($4.25 in chips) 
Seat 9: Svetlana2962 ($3.22 in chips) 
lion.1st: posts small blind $0.01
Redvin33: posts big blind $0.02
*** HOLE CARDS ***
Dealt to Redvin33 [4d 2h]
}II{yJIuI{: folds 
I gendos: folds 
jokkers_br: raises $0.04 to $0.06
LUKIANOV777: folds 
PJWALL: folds 
Svetlana2962: folds 
kubeiks: calls $0.06
lion.1st: folds 
Redvin33: folds 
*** FLOP *** [5h 9s 6h]
jokkers_br: bets $0.14
kubeiks: folds 
Uncalled bet ($0.14) returned to jokkers_br
jokkers_br collected $0.14 from pot
jokkers_br: doesn't show hand 
*** SUMMARY ***
Total pot $0.15 | Rake $0.01 
Board [5h 9s 6h]
Seat 1: kubeiks (button) folded on the Flop
Seat 2: lion.1st (small blind) folded before Flop
Seat 3: Redvin33 (big blind) folded before Flop
Seat 4: }II{yJIuI{ folded before Flop (didn't bet)
Seat 5: I gendos folded before Flop (didn't bet)
Seat 6: jokkers_br collected ($0.14)
Seat 7: LUKIANOV777 folded before Flop (didn't bet)
Seat 8: PJWALL folded before Flop (didn't bet)
Seat 9: Svetlana2962 folded before Flop (didn't bet)



PokerStars Zoom Hand #172697153331:  Hold'em No Limit ($0.01/$0.02) - 2017/07/06 18:40:31 ET
Table 'McNaught' 9-max Seat #1 is the button
Seat 1: setair ($1.12 in chips) 
Seat 2: QuasarGP ($1.55 in chips) 
Seat 3: evgeniiviz ($2 in chips) 
Seat 4: AJIEKC ($1.69 in chips) 
Seat 5: Cnopic666 ($16.33 in chips) 
Seat 6: Rajjan92 ($1 in chips) 
Seat 7: ntr2xit ($2.06 in chips) 
Seat 8: Gamer577 ($2 in chips) 
Seat 9: Redvin33 ($2.70 in chips) 
QuasarGP: posts small blind $0.01
evgeniiviz: posts big blind $0.02
*** HOLE CARDS ***
Dealt to Redvin33 [3d Ts]
AJIEKC: folds 
Cnopic666: folds 
Rajjan92: folds 
ntr2xit: folds 
Gamer577: raises $0.04 to $0.06
Redvin33: folds 
setair: folds 
QuasarGP: raises $0.10 to $0.16
evgeniiviz: folds 
Gamer577: calls $0.10
*** FLOP *** [Td 3s 3h]
QuasarGP: checks 
Gamer577: checks 
*** TURN *** [Td 3s 3h] [Th]
QuasarGP: bets $0.16
Gamer577: calls $0.16
*** RIVER *** [Td 3s 3h Th] [3c]
QuasarGP: checks 
Gamer577: checks 
*** SHOW DOWN ***
QuasarGP: shows [Qd Qc] (a full house, Threes full of Queens)
Gamer577: mucks hand 
QuasarGP collected $0.64 from pot
*** SUMMARY ***
Total pot $0.66 | Rake $0.02 
Board [Td 3s 3h Th 3c]
Seat 1: setair (button) folded before Flop (didn't bet)
Seat 2: QuasarGP (small blind) showed [Qd Qc] and won ($0.64) with a full house, Threes full of Queens
Seat 3: evgeniiviz (big blind) folded before Flop
Seat 4: AJIEKC folded before Flop (didn't bet)
Seat 5: Cnopic666 folded before Flop (didn't bet)
Seat 6: Rajjan92 folded before Flop (didn't bet)
Seat 7: ntr2xit folded before Flop (didn't bet)
Seat 8: Gamer577 mucked [9c 9d]
Seat 9: Redvin33 folded before Flop (didn't bet)



PokerStars Zoom Hand #172697175589:  Hold'em No Limit ($0.01/$0.02) - 2017/07/06 18:41:05 ET
Table 'McNaught' 9-max Seat #1 is the button
Seat 1: andreyzz1964 ($0.67 in chips) 
Seat 2: KostMalen ($2 in chips) 
Seat 3: Agares91 ($4 in chips) 
Seat 4: Rishnu Fr ($4.09 in chips) 
Seat 5: LUKIANOV777 ($2.20 in chips) 
Seat 6: FredFlush777 ($2.26 in chips) 
Seat 7: Redvin33 ($2.68 in chips) 
Seat 8: bicho1040 ($2.36 in chips) 
Seat 9: KarlMarx18 ($2.02 in chips) 
KostMalen: posts small blind $0.01
Agares91: posts big blind $0.02
*** HOLE CARDS ***
Dealt to Redvin33 [Qd Qs]
Rishnu Fr: folds 
LUKIANOV777: raises $0.04 to $0.06
FredFlush777: folds 
Redvin33: raises $0.04 to $0.10
bicho1040: folds 
KarlMarx18: folds 
andreyzz1964: calls $0.10
KostMalen: calls $0.09
Agares91: calls $0.08
LUKIANOV777: calls $0.04
*** FLOP *** [Ac 6s 4s]
KostMalen: checks 
Agares91: bets $0.36
LUKIANOV777: folds 
Redvin33: folds 
andreyzz1964: raises $0.21 to $0.57 and is all-in
KostMalen: folds 
Agares91: calls $0.21
*** TURN *** [Ac 6s 4s] [8d]
*** RIVER *** [Ac 6s 4s 8d] [Ah]
*** SHOW DOWN ***
Agares91: shows [6d 6c] (a full house, Sixes full of Aces)
andreyzz1964: shows [Jd Ad] (three of a kind, Aces)
Agares91 collected $1.58 from pot
*** SUMMARY ***
Total pot $1.64 | Rake $0.06 
Board [Ac 6s 4s 8d Ah]
Seat 1: andreyzz1964 (button) showed [Jd Ad] and lost with three of a kind, Aces
Seat 2: KostMalen (small blind) folded on the Flop
Seat 3: Agares91 (big blind) showed [6d 6c] and won ($1.58) with a full house, Sixes full of Aces
Seat 4: Rishnu Fr folded before Flop (didn't bet)
Seat 5: LUKIANOV777 folded on the Flop
Seat 6: FredFlush777 folded before Flop (didn't bet)
Seat 7: Redvin33 folded on the Flop
Seat 8: bicho1040 folded before Flop (didn't bet)
Seat 9: KarlMarx18 folded before Flop (didn't bet)



PokerStars Zoom Hand #172697200743:  Hold'em No Limit ($0.01/$0.02) - 2017/07/06 18:41:44 ET
Table 'McNaught' 9-max Seat #1 is the button
Seat 1: Redvin33 ($2.58 in chips) 
Seat 2: Mùúh 22 ($2.93 in chips) 
Seat 3: TheCoelhao ($2.25 in chips) 
Seat 4: FredFlush777 ($2.23 in chips) 
Seat 5: Gorwfwefwed ($2.67 in chips) 
Seat 6: JeffersonWd ($1.72 in chips) 
Seat 7: 00Nitro ($2 in chips) 
Seat 8: Ksan5979 ($2.47 in chips) 
Seat 9: xMathiUx ($1.24 in chips) 
Mùúh 22: posts small blind $0.01
TheCoelhao: posts big blind $0.02
*** HOLE CARDS ***
Dealt to Redvin33 [Tc 4h]
FredFlush777: folds 
Gorwfwefwed: folds 
JeffersonWd: folds 
00Nitro: folds 
Ksan5979: folds 
xMathiUx: folds 
Redvin33: folds 
Mùúh 22: raises $0.08 to $0.10
TheCoelhao: folds 
Uncalled bet ($0.08) returned to Mùúh 22
Mùúh 22 collected $0.04 from pot
Mùúh 22: doesn't show hand 
*** SUMMARY ***
Total pot $0.04 | Rake $0 
Seat 1: Redvin33 (button) folded before Flop (didn't bet)
Seat 2: Mùúh 22 (small blind) collected ($0.04)
Seat 3: TheCoelhao (big blind) folded before Flop
Seat 4: FredFlush777 folded before Flop (didn't bet)
Seat 5: Gorwfwefwed folded before Flop (didn't bet)
Seat 6: JeffersonWd folded before Flop (didn't bet)
Seat 7: 00Nitro folded before Flop (didn't bet)
Seat 8: Ksan5979 folded before Flop (didn't bet)
Seat 9: xMathiUx folded before Flop (didn't bet)



PokerStars Zoom Hand #172697205949:  Hold'em No Limit ($0.01/$0.02) - 2017/07/06 18:41:52 ET
Table 'McNaught' 9-max Seat #1 is the button
Seat 1: sergiorom@n ($2.09 in chips) 
Seat 2: Redvin33 ($2.58 in chips) 
Seat 3: VOLOOOODYA ($3.24 in chips) 
Seat 4: Vikta8 ($1.07 in chips) 
Seat 5: Robin872 ($2.08 in chips) 
Seat 6: Tsybulya ($4.65 in chips) 
Seat 7: juzikaa ($1.95 in chips) 
Seat 8: Ede1wei$$ ($2 in chips) 
Seat 9: Jeka90210 ($1.45 in chips) 
Redvin33: posts small blind $0.01
VOLOOOODYA: posts big blind $0.02
*** HOLE CARDS ***
Dealt to Redvin33 [Ah 4s]
Vikta8: folds 
Robin872: raises $0.04 to $0.06
Tsybulya: folds 
juzikaa: folds 
Ede1wei$$: folds 
Jeka90210: folds 
sergiorom@n: folds 
Redvin33: calls $0.05
VOLOOOODYA: folds 
*** FLOP *** [4d Td 5c]
Redvin33: bets $0.06
Robin872: folds 
Uncalled bet ($0.06) returned to Redvin33
Redvin33 collected $0.14 from pot
Redvin33: doesn't show hand 
*** SUMMARY ***
Total pot $0.14 | Rake $0 
Board [4d Td 5c]
Seat 1: sergiorom@n (button) folded before Flop (didn't bet)
Seat 2: Redvin33 (small blind) collected ($0.14)
Seat 3: VOLOOOODYA (big blind) folded before Flop
Seat 4: Vikta8 folded before Flop (didn't bet)
Seat 5: Robin872 folded on the Flop
Seat 6: Tsybulya folded before Flop (didn't bet)
Seat 7: juzikaa folded before Flop (didn't bet)
Seat 8: Ede1wei$$ folded before Flop (didn't bet)
Seat 9: Jeka90210 folded before Flop (didn't bet)



PokerStars Zoom Hand #172697228552:  Hold'em No Limit ($0.01/$0.02) - 2017/07/06 18:42:27 ET
Table 'McNaught' 9-max Seat #1 is the button
Seat 1: Cayoosh16 ($1.30 in chips) 
Seat 2: Gorwfwefwed ($3.62 in chips) 
Seat 3: Lionvodoo ($2.18 in chips) 
Seat 4: Robin872 ($2.80 in chips) 
Seat 5: KleidedutrA ($4.56 in chips) 
Seat 6: Ede1wei$$ ($2 in chips) 
Seat 7: DeLaSoya ($1.61 in chips) 
Seat 8: Redvin33 ($2.66 in chips) 
Seat 9: Kagronak.PS ($2.54 in chips) 
Gorwfwefwed: posts small blind $0.01
Lionvodoo: posts big blind $0.02
*** HOLE CARDS ***
Dealt to Redvin33 [2h 7d]
Robin872: folds 
KleidedutrA: folds 
Ede1wei$$: folds 
DeLaSoya: folds 
Redvin33: folds 
Kagronak.PS: raises $0.04 to $0.06
Cayoosh16: folds 
Gorwfwefwed: folds 
Lionvodoo: folds 
Uncalled bet ($0.04) returned to Kagronak.PS
Kagronak.PS collected $0.05 from pot
Kagronak.PS: doesn't show hand 
*** SUMMARY ***
Total pot $0.05 | Rake $0 
Seat 1: Cayoosh16 (button) folded before Flop (didn't bet)
Seat 2: Gorwfwefwed (small blind) folded before Flop
Seat 3: Lionvodoo (big blind) folded before Flop
Seat 4: Robin872 folded before Flop (didn't bet)
Seat 5: KleidedutrA folded before Flop (didn't bet)
Seat 6: Ede1wei$$ folded before Flop (didn't bet)
Seat 7: DeLaSoya folded before Flop (didn't bet)
Seat 8: Redvin33 folded before Flop (didn't bet)
Seat 9: Kagronak.PS collected ($0.05)



PokerStars Zoom Hand #172697223364:  Hold'em No Limit ($0.01/$0.02) - 2017/07/06 18:42:19 ET
Table 'McNaught' 9-max Seat #1 is the button
Seat 1: Taraba68 ($1.99 in chips) 
Seat 2: Cayoosh16 ($1.95 in chips) 
Seat 3: ntr2xit ($3.33 in chips) 
Seat 4: LUKIANOV777 ($1.85 in chips) 
Seat 5: arsen99 ($5.35 in chips) 
Seat 6: Redvin33 ($2.66 in chips) 
Seat 7: sergiorom@n ($2.08 in chips) 
Seat 8: manowar7771 ($2.03 in chips) 
Seat 9: Mr.Chipeater ($2.82 in chips) 
Cayoosh16: posts small blind $0.01
ntr2xit: posts big blind $0.02
*** HOLE CARDS ***
Dealt to Redvin33 [7s Jc]
LUKIANOV777: folds 
arsen99: folds 
Redvin33: folds 
sergiorom@n: folds 
manowar7771: folds 
Mr.Chipeater: raises $0.04 to $0.06
Taraba68: folds 
Cayoosh16: folds 
ntr2xit: calls $0.04
*** FLOP *** [Qd As 8h]
ntr2xit: checks 
Mr.Chipeater: checks 
*** TURN *** [Qd As 8h] [Kc]
ntr2xit: checks 
Mr.Chipeater: checks 
*** RIVER *** [Qd As 8h Kc] [4h]
ntr2xit: bets $0.10
Mr.Chipeater: folds 
Uncalled bet ($0.10) returned to ntr2xit
ntr2xit collected $0.13 from pot
ntr2xit: doesn't show hand 
*** SUMMARY ***
Total pot $0.13 | Rake $0 
Board [Qd As 8h Kc 4h]
Seat 1: Taraba68 (button) folded before Flop (didn't bet)
Seat 2: Cayoosh16 (small blind) folded before Flop
Seat 3: ntr2xit (big blind) collected ($0.13)
Seat 4: LUKIANOV777 folded before Flop (didn't bet)
Seat 5: arsen99 folded before Flop (didn't bet)
Seat 6: Redvin33 folded before Flop (didn't bet)
Seat 7: sergiorom@n folded before Flop (didn't bet)
Seat 8: manowar7771 folded before Flop (didn't bet)
Seat 9: Mr.Chipeater folded on the River



PokerStars Zoom Hand #172697225971:  Hold'em No Limit ($0.01/$0.02) - 2017/07/06 18:42:23 ET
Table 'McNaught' 9-max Seat #1 is the button
Seat 1: jip347 ($0.24 in chips) 
Seat 2: Manu171077 ($0.96 in chips) 
Seat 3: LicGuapo ($2.10 in chips) 
Seat 4: Haczlo ($4.41 in chips) 
Seat 5: Brucechiou ($2.06 in chips) 
Seat 6: Xamil666 ($2.98 in chips) 
Seat 7: 00Nitro ($2.30 in chips) 
Seat 8: lion.1st ($2.15 in chips) 
Seat 9: Redvin33 ($2.66 in chips) 
Manu171077: posts small blind $0.01
LicGuapo: posts big blind $0.02
*** HOLE CARDS ***
Dealt to Redvin33 [5h Jh]
Haczlo: folds 
Brucechiou: folds 
Xamil666: folds 
00Nitro: folds 
lion.1st: folds 
Redvin33: folds 
jip347: raises $0.02 to $0.04
Manu171077: calls $0.03
LicGuapo: folds 
*** FLOP *** [2h 6c 9h]
Manu171077: checks 
jip347: checks 
*** TURN *** [2h 6c 9h] [8s]
Manu171077: checks 
jip347: bets $0.05
Manu171077: calls $0.05
*** RIVER *** [2h 6c 9h 8s] [Js]
Manu171077: checks 
jip347: checks 
*** SHOW DOWN ***
Manu171077: shows [As Qh] (high card Ace)
jip347: shows [Qs Jc] (a pair of Jacks)
jip347 collected $0.19 from pot
*** SUMMARY ***
Total pot $0.20 | Rake $0.01 
Board [2h 6c 9h 8s Js]
Seat 1: jip347 (button) showed [Qs Jc] and won ($0.19) with a pair of Jacks
Seat 2: Manu171077 (small blind) showed [As Qh] and lost with high card Ace
Seat 3: LicGuapo (big blind) folded before Flop
Seat 4: Haczlo folded before Flop (didn't bet)
Seat 5: Brucechiou folded before Flop (didn't bet)
Seat 6: Xamil666 folded before Flop (didn't bet)
Seat 7: 00Nitro folded before Flop (didn't bet)
Seat 8: lion.1st folded before Flop (didn't bet)
Seat 9: Redvin33 folded before Flop (didn't bet)



PokerStars Zoom Hand #172697237531:  Hold'em No Limit ($0.01/$0.02) - 2017/07/06 18:42:41 ET
Table 'McNaught' 9-max Seat #1 is the button
Seat 1: denzell574 ($2.02 in chips) 
Seat 2: MYRZILKA904 ($2.84 in chips) 
Seat 3: KarlMarx18 ($2.20 in chips) 
Seat 4: Ksan5979 ($2.02 in chips) 
Seat 5: Redvin33 ($2.66 in chips) 
Seat 6: arsen99 ($5.33 in chips) 
Seat 7: Peros1 ($3.78 in chips) 
Seat 8: valera_9696@ ($2.07 in chips) 
Seat 9: MPaz_87 ($2 in chips) 
MYRZILKA904: posts small blind $0.01
KarlMarx18: posts big blind $0.02
*** HOLE CARDS ***
Dealt to Redvin33 [Kd Ac]
Ksan5979: folds 
Redvin33: raises $0.03 to $0.05
arsen99: folds 
Peros1: folds 
valera_9696@: folds 
MPaz_87: folds 
denzell574: folds 
MYRZILKA904: folds 
KarlMarx18: folds 
Uncalled bet ($0.03) returned to Redvin33
Redvin33 collected $0.05 from pot
Redvin33: doesn't show hand 
*** SUMMARY ***
Total pot $0.05 | Rake $0 
Seat 1: denzell574 (button) folded before Flop (didn't bet)
Seat 2: MYRZILKA904 (small blind) folded before Flop
Seat 3: KarlMarx18 (big blind) folded before Flop
Seat 4: Ksan5979 folded before Flop (didn't bet)
Seat 5: Redvin33 collected ($0.05)
Seat 6: arsen99 folded before Flop (didn't bet)
Seat 7: Peros1 folded before Flop (didn't bet)
Seat 8: valera_9696@ folded before Flop (didn't bet)
Seat 9: MPaz_87 folded before Flop (didn't bet)



PokerStars Zoom Hand #172697249147:  Hold'em No Limit ($0.01/$0.02) - 2017/07/06 18:42:59 ET
Table 'McNaught' 9-max Seat #1 is the button
Seat 1: AZAAAAAP ($2 in chips) 
Seat 2: mamiladi1971 ($0.77 in chips) 
Seat 3: Redvin33 ($2.69 in chips) 
Seat 4: JeffersonWd ($2.86 in chips) 
Seat 5: Gorwfwefwed ($1.99 in chips) 
Seat 6: sohatyy ($2.34 in chips) 
Seat 7: Suchvn ($2.70 in chips) 
Seat 8: Click400 ($2.01 in chips) 
Seat 9: setair ($1.19 in chips) 
mamiladi1971: posts small blind $0.01
Redvin33: posts big blind $0.02
*** HOLE CARDS ***
Dealt to Redvin33 [9h As]
JeffersonWd: folds 
Gorwfwefwed: folds 
sohatyy: folds 
Suchvn: calls $0.02
Click400: folds 
setair: raises $0.02 to $0.04
AZAAAAAP: folds 
mamiladi1971: folds 
Redvin33: calls $0.02
Suchvn: calls $0.02
*** FLOP *** [Th Kh 5h]
Redvin33: bets $0.06
Suchvn: folds 
setair: calls $0.06
*** TURN *** [Th Kh 5h] [Ah]
Redvin33: bets $0.08
setair: calls $0.08
*** RIVER *** [Th Kh 5h Ah] [6c]
Redvin33: bets $0.14
setair: calls $0.14
*** SHOW DOWN ***
Redvin33: shows [9h As] (a flush, Ace high)
setair: mucks hand 
Redvin33 collected $0.67 from pot
*** SUMMARY ***
Total pot $0.69 | Rake $0.02 
Board [Th Kh 5h Ah 6c]
Seat 1: AZAAAAAP (button) folded before Flop (didn't bet)
Seat 2: mamiladi1971 (small blind) folded before Flop
Seat 3: Redvin33 (big blind) showed [9h As] and won ($0.67) with a flush, Ace high
Seat 4: JeffersonWd folded before Flop (didn't bet)
Seat 5: Gorwfwefwed folded before Flop (didn't bet)
Seat 6: sohatyy folded before Flop (didn't bet)
Seat 7: Suchvn folded on the Flop
Seat 8: Click400 folded before Flop (didn't bet)
Seat 9: setair mucked [Ks Ts]



PokerStars Zoom Hand #172697288379:  Hold'em No Limit ($0.01/$0.02) - 2017/07/06 18:44:00 ET
Table 'McNaught' 9-max Seat #1 is the button
Seat 1: Xamil666 ($4.64 in chips) 
Seat 2: Kenshiro*969 ($2.72 in chips) 
Seat 3: Rufus Titum ($2.30 in chips) 
Seat 4: lion.1st ($2.19 in chips) 
Seat 5: Redvin33 ($3.04 in chips) 
Seat 6: rokirov ($1.97 in chips) 
Seat 7: sergiorom@n ($2 in chips) 
Seat 8: Gorwfwefwed ($1.97 in chips) 
Seat 9: filipov1976 ($2.24 in chips) 
Kenshiro*969: posts small blind $0.01
Rufus Titum: posts big blind $0.02
*** HOLE CARDS ***
Dealt to Redvin33 [As 3c]
lion.1st: folds 
Redvin33: calls $0.02
rokirov: folds 
sergiorom@n: folds 
Gorwfwefwed: folds 
filipov1976: folds 
Xamil666: folds 
Kenshiro*969: folds 
Rufus Titum: checks 
*** FLOP *** [2d Kd Ts]
Rufus Titum: checks 
Redvin33: checks 
*** TURN *** [2d Kd Ts] [7s]
Rufus Titum: checks 
Redvin33: bets $0.05
Rufus Titum: calls $0.05
*** RIVER *** [2d Kd Ts 7s] [8c]
Rufus Titum: checks 
Redvin33: checks 
*** SHOW DOWN ***
Rufus Titum: shows [Tc Js] (a pair of Tens)
Redvin33: mucks hand 
Rufus Titum collected $0.14 from pot
*** SUMMARY ***
Total pot $0.15 | Rake $0.01 
Board [2d Kd Ts 7s 8c]
Seat 1: Xamil666 (button) folded before Flop (didn't bet)
Seat 2: Kenshiro*969 (small blind) folded before Flop
Seat 3: Rufus Titum (big blind) showed [Tc Js] and won ($0.14) with a pair of Tens
Seat 4: lion.1st folded before Flop (didn't bet)
Seat 5: Redvin33 mucked [As 3c]
Seat 6: rokirov folded before Flop (didn't bet)
Seat 7: sergiorom@n folded before Flop (didn't bet)
Seat 8: Gorwfwefwed folded before Flop (didn't bet)
Seat 9: filipov1976 folded before Flop (didn't bet)



PokerStars Zoom Hand #172697319946:  Hold'em No Limit ($0.01/$0.02) - 2017/07/06 18:44:49 ET
Table 'McNaught' 9-max Seat #1 is the button
Seat 1: rokirov ($1.97 in chips) 
Seat 2: Redvin33 ($2.97 in chips) 
Seat 3: xMathiUx ($1 in chips) 
Seat 4: sergiorom@n ($2.29 in chips) 
Seat 5: Robin872 ($4.19 in chips) 
Seat 6: Svenski33 ($4.58 in chips) 
Seat 7: wellgardiano ($2.21 in chips) 
Seat 8: bicho1040 ($6.76 in chips) 
Seat 9: lion.1st ($1.84 in chips) 
Redvin33: posts small blind $0.01
xMathiUx: posts big blind $0.02
*** HOLE CARDS ***
Dealt to Redvin33 [3c Jc]
sergiorom@n: folds 
Robin872: folds 
Svenski33: folds 
wellgardiano: raises $0.02 to $0.04
bicho1040: folds 
lion.1st: folds 
rokirov: folds 
Redvin33: calls $0.03
xMathiUx: folds 
*** FLOP *** [7d Kd 6s]
Redvin33: bets $0.10
wellgardiano: calls $0.10
*** TURN *** [7d Kd 6s] [6c]
Redvin33: checks 
wellgardiano: checks 
*** RIVER *** [7d Kd 6s 6c] [6d]
Redvin33: bets $0.12
wellgardiano: raises $0.12 to $0.24
Redvin33: folds 
Uncalled bet ($0.12) returned to wellgardiano
wellgardiano collected $0.52 from pot
wellgardiano: doesn't show hand 
*** SUMMARY ***
Total pot $0.54 | Rake $0.02 
Board [7d Kd 6s 6c 6d]
Seat 1: rokirov (button) folded before Flop (didn't bet)
Seat 2: Redvin33 (small blind) folded on the River
Seat 3: xMathiUx (big blind) folded before Flop
Seat 4: sergiorom@n folded before Flop (didn't bet)
Seat 5: Robin872 folded before Flop (didn't bet)
Seat 6: Svenski33 folded before Flop (didn't bet)
Seat 7: wellgardiano collected ($0.52)
Seat 8: bicho1040 folded before Flop (didn't bet)
Seat 9: lion.1st folded before Flop (didn't bet)



PokerStars Zoom Hand #172697359367:  Hold'em No Limit ($0.01/$0.02) - 2017/07/06 18:45:50 ET
Table 'McNaught' 9-max Seat #1 is the button
Seat 1: go_last_game ($1.88 in chips) 
Seat 2: Cnopic666 ($3.15 in chips) 
Seat 3: denzell574 ($1.93 in chips) 
Seat 4: Rufus Titum ($2.04 in chips) 
Seat 5: ShadMrPo ($5.54 in chips) 
Seat 6: DiNiceBoy ($3.95 in chips) 
Seat 7: Redvin33 ($2.71 in chips) 
Seat 8: KostMalen ($2 in chips) 
Seat 9: grave_17 ($2.26 in chips) 
Cnopic666: posts small blind $0.01
denzell574: posts big blind $0.02
*** HOLE CARDS ***
Dealt to Redvin33 [3s 7h]
Rufus Titum: folds 
ShadMrPo: folds 
DiNiceBoy: folds 
Redvin33: folds 
KostMalen: folds 
grave_17: raises $0.04 to $0.06
go_last_game: folds 
Cnopic666: folds 
denzell574: calls $0.04
*** FLOP *** [Jc 9c 6c]
denzell574: checks 
grave_17: bets $0.10
denzell574: folds 
Uncalled bet ($0.10) returned to grave_17
grave_17 collected $0.13 from pot
grave_17: doesn't show hand 
*** SUMMARY ***
Total pot $0.13 | Rake $0 
Board [Jc 9c 6c]
Seat 1: go_last_game (button) folded before Flop (didn't bet)
Seat 2: Cnopic666 (small blind) folded before Flop
Seat 3: denzell574 (big blind) folded on the Flop
Seat 4: Rufus Titum folded before Flop (didn't bet)
Seat 5: ShadMrPo folded before Flop (didn't bet)
Seat 6: DiNiceBoy folded before Flop (didn't bet)
Seat 7: Redvin33 folded before Flop (didn't bet)
Seat 8: KostMalen folded before Flop (didn't bet)
Seat 9: grave_17 collected ($0.13)



PokerStars Zoom Hand #172697362074:  Hold'em No Limit ($0.01/$0.02) - 2017/07/06 18:45:54 ET
Table 'McNaught' 9-max Seat #1 is the button
Seat 1: setair ($1.69 in chips) 
Seat 2: Grigoris1962 ($1.71 in chips) 
Seat 3: LUKIANOV777 ($2.06 in chips) 
Seat 4: Lionvodoo ($2.13 in chips) 
Seat 5: Ujo Gugl ($2.32 in chips) 
Seat 6: Marthmer1 ($1 in chips) 
Seat 7: go_last_game ($1.88 in chips) 
Seat 8: Redvin33 ($2.71 in chips) 
Seat 9: qualifire ($2.86 in chips) 
Grigoris1962: posts small blind $0.01
LUKIANOV777: posts big blind $0.02
*** HOLE CARDS ***
Dealt to Redvin33 [Ac 8s]
Lionvodoo: folds 
Ujo Gugl: folds 
Marthmer1: calls $0.02
go_last_game: folds 
Redvin33: raises $0.03 to $0.05
qualifire: folds 
setair: folds 
Grigoris1962: folds 
LUKIANOV777: calls $0.03
Marthmer1: calls $0.03
*** FLOP *** [5s Ts Qh]
LUKIANOV777: checks 
Marthmer1: checks 
Redvin33: checks 
*** TURN *** [5s Ts Qh] [Ad]
LUKIANOV777: checks 
Marthmer1: bets $0.02
Redvin33: raises $0.06 to $0.08
LUKIANOV777: calls $0.08
Marthmer1: raises $0.06 to $0.14
Redvin33: calls $0.06
LUKIANOV777: calls $0.06
*** RIVER *** [5s Ts Qh Ad] [Tc]
LUKIANOV777: checks 
Marthmer1: bets $0.28
Redvin33: calls $0.28
LUKIANOV777: folds 
*** SHOW DOWN ***
Marthmer1: shows [Qs Qc] (a full house, Queens full of Tens)
Redvin33: mucks hand 
Marthmer1 collected $1.10 from pot
*** SUMMARY ***
Total pot $1.14 | Rake $0.04 
Board [5s Ts Qh Ad Tc]
Seat 1: setair (button) folded before Flop (didn't bet)
Seat 2: Grigoris1962 (small blind) folded before Flop
Seat 3: LUKIANOV777 (big blind) folded on the River
Seat 4: Lionvodoo folded before Flop (didn't bet)
Seat 5: Ujo Gugl folded before Flop (didn't bet)
Seat 6: Marthmer1 showed [Qs Qc] and won ($1.10) with a full house, Queens full of Tens
Seat 7: go_last_game folded before Flop (didn't bet)
Seat 8: Redvin33 mucked [Ac 8s]
Seat 9: qualifire folded before Flop (didn't bet)



PokerStars Zoom Hand #172697416466:  Hold'em No Limit ($0.01/$0.02) - 2017/07/06 18:47:03 ET
Table 'McNaught' 9-max Seat #1 is the button
Seat 1: ArgusLL ($2.56 in chips) 
Seat 2: OlgaGold88 ($1.27 in chips) 
Seat 3: ntr2xit ($2 in chips) 
Seat 4: plaz v ($3.40 in chips) 
Seat 5: KaHcTpykTap ($2 in chips) 
Seat 6: Redvin33 ($2.24 in chips) 
Seat 7: Nikoro309 ($3.04 in chips) 
Seat 8: Jølle1996 ($2.16 in chips) 
Seat 9: Unconform ($2.35 in chips) 
OlgaGold88: posts small blind $0.01
ntr2xit: posts big blind $0.02
*** HOLE CARDS ***
Dealt to Redvin33 [5h 9d]
plaz v: folds 
KaHcTpykTap: folds 
Redvin33: folds 
Nikoro309: raises $0.04 to $0.06
Jølle1996: folds 
Unconform: folds 
ArgusLL: folds 
OlgaGold88: folds 
ntr2xit: folds 
Uncalled bet ($0.04) returned to Nikoro309
Nikoro309 collected $0.05 from pot
Nikoro309: doesn't show hand 
*** SUMMARY ***
Total pot $0.05 | Rake $0 
Seat 1: ArgusLL (button) folded before Flop (didn't bet)
Seat 2: OlgaGold88 (small blind) folded before Flop
Seat 3: ntr2xit (big blind) folded before Flop
Seat 4: plaz v folded before Flop (didn't bet)
Seat 5: KaHcTpykTap folded before Flop (didn't bet)
Seat 6: Redvin33 folded before Flop (didn't bet)
Seat 7: Nikoro309 collected ($0.05)
Seat 8: Jølle1996 folded before Flop (didn't bet)
Seat 9: Unconform folded before Flop (didn't bet)



PokerStars Zoom Hand #172697419050:  Hold'em No Limit ($0.01/$0.02) - 2017/07/06 18:47:07 ET
Table 'McNaught' 9-max Seat #1 is the button
Seat 1: denzell574 ($1.97 in chips) 
Seat 2: DiNiceBoy ($2.57 in chips) 
Seat 3: OlgaGold88 ($1.26 in chips) 
Seat 4: Redvin33 ($2.24 in chips) 
Seat 5: andreyzz1964 ($2.48 in chips) 
Seat 6: smiechtje ($2.76 in chips) 
Seat 7: sohatyy ($2.57 in chips) 
Seat 8: Sympathya ($3.36 in chips) 
Seat 9: maurixxx007 ($1.90 in chips) 
DiNiceBoy: posts small blind $0.01
OlgaGold88: posts big blind $0.02
*** HOLE CARDS ***
Dealt to Redvin33 [Ah Kc]
Redvin33: raises $0.03 to $0.05
andreyzz1964: folds 
smiechtje: folds 
sohatyy: folds 
Sympathya: folds 
maurixxx007: folds 
denzell574: folds 
DiNiceBoy: folds 
OlgaGold88: folds 
Uncalled bet ($0.03) returned to Redvin33
Redvin33 collected $0.05 from pot
Redvin33: doesn't show hand 
*** SUMMARY ***
Total pot $0.05 | Rake $0 
Seat 1: denzell574 (button) folded before Flop (didn't bet)
Seat 2: DiNiceBoy (small blind) folded before Flop
Seat 3: OlgaGold88 (big blind) folded before Flop
Seat 4: Redvin33 collected ($0.05)
Seat 5: andreyzz1964 folded before Flop (didn't bet)
Seat 6: smiechtje folded before Flop (didn't bet)
Seat 7: sohatyy folded before Flop (didn't bet)
Seat 8: Sympathya folded before Flop (didn't bet)
Seat 9: maurixxx007 folded before Flop (didn't bet)



PokerStars Zoom Hand #172697407416:  Hold'em No Limit ($0.01/$0.02) - 2017/07/06 18:46:49 ET
Table 'McNaught' 9-max Seat #1 is the button
Seat 1: Nikoro309 ($3.38 in chips) 
Seat 2: Crazylady007 ($1.71 in chips) 
Seat 3: colllatinboy ($1.12 in chips) 
Seat 4: victordyfox ($0.94 in chips) 
Seat 5: ewsikinho ($8.74 in chips) 
Seat 6: valera_9696@ ($2 in chips) 
Seat 7: rubino_nick ($3.10 in chips) 
Seat 8: Gorwfwefwed ($3.61 in chips) 
Seat 9: Redvin33 ($2.24 in chips) 
Crazylady007: posts small blind $0.01
colllatinboy: posts big blind $0.02
*** HOLE CARDS ***
Dealt to Redvin33 [2h Kc]
victordyfox: calls $0.02
ewsikinho: folds 
valera_9696@: folds 
rubino_nick: folds 
Gorwfwefwed: folds 
Redvin33: folds 
Nikoro309: folds 
Crazylady007: calls $0.01
colllatinboy: checks 
*** FLOP *** [Js 8s 5c]
Crazylady007: checks 
colllatinboy: checks 
victordyfox: bets $0.06
Crazylady007: folds 
colllatinboy: folds 
Uncalled bet ($0.06) returned to victordyfox
victordyfox collected $0.06 from pot
victordyfox: doesn't show hand 
*** SUMMARY ***
Total pot $0.06 | Rake $0 
Board [Js 8s 5c]
Seat 1: Nikoro309 (button) folded before Flop (didn't bet)
Seat 2: Crazylady007 (small blind) folded on the Flop
Seat 3: colllatinboy (big blind) folded on the Flop
Seat 4: victordyfox collected ($0.06)
Seat 5: ewsikinho folded before Flop (didn't bet)
Seat 6: valera_9696@ folded before Flop (didn't bet)
Seat 7: rubino_nick folded before Flop (didn't bet)
Seat 8: Gorwfwefwed folded before Flop (didn't bet)
Seat 9: Redvin33 folded before Flop (didn't bet)



PokerStars Zoom Hand #172697412594:  Hold'em No Limit ($0.01/$0.02) - 2017/07/06 18:46:57 ET
Table 'McNaught' 9-max Seat #1 is the button
Seat 1: NJoy2Win ($8.45 in chips) 
Seat 2: vagebolle ($0.69 in chips) 
Seat 3: Gamer577 ($2 in chips) 
Seat 4: qualifire ($1.52 in chips) 
Seat 5: Redvin33 ($2.24 in chips) 
Seat 6: dhasis13 ($2.19 in chips) 
Seat 7: Cayoosh16 ($1.07 in chips) 
Seat 8: nightspeaker ($5.59 in chips) 
Seat 9: paul261985 ($2.66 in chips) 
vagebolle: posts small blind $0.01
Gamer577: posts big blind $0.02
*** HOLE CARDS ***
Dealt to Redvin33 [Kc 3s]
qualifire: folds 
Redvin33: folds 
dhasis13: folds 
Cayoosh16: folds 
nightspeaker: folds 
paul261985: raises $0.05 to $0.07
NJoy2Win: folds 
vagebolle: calls $0.06
Gamer577: folds 
*** FLOP *** [6c 7d 4h]
vagebolle: checks 
paul261985: bets $0.08
vagebolle: calls $0.08
*** TURN *** [6c 7d 4h] [5d]
vagebolle: checks 
paul261985: bets $0.31
vagebolle: calls $0.31
*** RIVER *** [6c 7d 4h 5d] [6d]
vagebolle: bets $0.23 and is all-in
paul261985: folds 
Uncalled bet ($0.23) returned to vagebolle
vagebolle collected $0.91 from pot
vagebolle: doesn't show hand 
*** SUMMARY ***
Total pot $0.94 | Rake $0.03 
Board [6c 7d 4h 5d 6d]
Seat 1: NJoy2Win (button) folded before Flop (didn't bet)
Seat 2: vagebolle (small blind) collected ($0.91)
Seat 3: Gamer577 (big blind) folded before Flop
Seat 4: qualifire folded before Flop (didn't bet)
Seat 5: Redvin33 folded before Flop (didn't bet)
Seat 6: dhasis13 folded before Flop (didn't bet)
Seat 7: Cayoosh16 folded before Flop (didn't bet)
Seat 8: nightspeaker folded before Flop (didn't bet)
Seat 9: paul261985 folded on the River



PokerStars Zoom Hand #172697409994:  Hold'em No Limit ($0.01/$0.02) - 2017/07/06 18:46:53 ET
Table 'McNaught' 9-max Seat #1 is the button
Seat 1: Redvin33 ($2.24 in chips) 
Seat 2: Hansepower00 ($1.47 in chips) 
Seat 3: egjoer ($4.16 in chips) 
Seat 4: Winterdgr ($1.77 in chips) 
Seat 5: valera_9696@ ($2 in chips) 
Seat 6: Svetlana2962 ($3.63 in chips) 
Seat 7: Artem23Ka ($2 in chips) 
Seat 8: Unconform ($2.22 in chips) 
Seat 9: Sympathya ($3.16 in chips) 
Hansepower00: posts small blind $0.01
egjoer: posts big blind $0.02
*** HOLE CARDS ***
Dealt to Redvin33 [2c 6s]
Winterdgr: folds 
valera_9696@: folds 
Svetlana2962: folds 
Artem23Ka has timed out
Artem23Ka: folds 
Unconform: folds 
Sympathya: folds 
Redvin33: folds 
Hansepower00: raises $0.02 to $0.04
egjoer: calls $0.02
*** FLOP *** [3d Kc Ks]
Hansepower00: checks 
egjoer: bets $0.06
Hansepower00: calls $0.06
*** TURN *** [3d Kc Ks] [Kh]
Hansepower00: checks 
egjoer: bets $0.14
Hansepower00: raises $0.14 to $0.28
egjoer: calls $0.14
*** RIVER *** [3d Kc Ks Kh] [Js]
Hansepower00: bets $1.09 and is all-in
egjoer: calls $1.09
*** SHOW DOWN ***
Hansepower00: shows [Ah As] (a full house, Kings full of Aces)
egjoer: shows [Kd Jd] (four of a kind, Kings)
egjoer collected $2.84 from pot
*** SUMMARY ***
Total pot $2.94 | Rake $0.10 
Board [3d Kc Ks Kh Js]
Seat 1: Redvin33 (button) folded before Flop (didn't bet)
Seat 2: Hansepower00 (small blind) showed [Ah As] and lost with a full house, Kings full of Aces
Seat 3: egjoer (big blind) showed [Kd Jd] and won ($2.84) with four of a kind, Kings
Seat 4: Winterdgr folded before Flop (didn't bet)
Seat 5: valera_9696@ folded before Flop (didn't bet)
Seat 6: Svetlana2962 folded before Flop (didn't bet)
Seat 7: Artem23Ka folded before Flop (didn't bet)
Seat 8: Unconform folded before Flop (didn't bet)
Seat 9: Sympathya folded before Flop (didn't bet)



PokerStars Zoom Hand #172697431686:  Hold'em No Limit ($0.01/$0.02) - 2017/07/06 18:47:27 ET
Table 'McNaught' 9-max Seat #1 is the button
Seat 1: LUKIANOV777 ($2.23 in chips) 
Seat 2: SABA7778 ($0.97 in chips) 
Seat 3: Redvin33 ($2.27 in chips) 
Seat 4: egjoer ($2 in chips) 
Seat 5: eviljanne ($2.17 in chips) 
Seat 6: qualifire ($1.51 in chips) 
Seat 7: wellgardiano ($2.51 in chips) 
Seat 8: Lionvodoo ($2.05 in chips) 
Seat 9: Rufus Titum ($2.08 in chips) 
SABA7778: posts small blind $0.01
Redvin33: posts big blind $0.02
*** HOLE CARDS ***
Dealt to Redvin33 [Jh Kc]
egjoer: folds 
eviljanne: folds 
qualifire: folds 
wellgardiano: raises $0.02 to $0.04
Lionvodoo: folds 
Rufus Titum: raises $0.11 to $0.15
LUKIANOV777: folds 
SABA7778: folds 
Redvin33: folds 
wellgardiano: folds 
Uncalled bet ($0.11) returned to Rufus Titum
Rufus Titum collected $0.11 from pot
Rufus Titum: doesn't show hand 
*** SUMMARY ***
Total pot $0.11 | Rake $0 
Seat 1: LUKIANOV777 (button) folded before Flop (didn't bet)
Seat 2: SABA7778 (small blind) folded before Flop
Seat 3: Redvin33 (big blind) folded before Flop
Seat 4: egjoer folded before Flop (didn't bet)
Seat 5: eviljanne folded before Flop (didn't bet)
Seat 6: qualifire folded before Flop (didn't bet)
Seat 7: wellgardiano folded before Flop
Seat 8: Lionvodoo folded before Flop (didn't bet)
Seat 9: Rufus Titum collected ($0.11)



PokerStars Zoom Hand #172697445618:  Hold'em No Limit ($0.01/$0.02) - 2017/07/06 18:47:49 ET
Table 'McNaught' 9-max Seat #1 is the button
Seat 1: victordyfox ($0.95 in chips) 
Seat 2: ArthurStk ($3.82 in chips) 
Seat 3: Unconform ($2.19 in chips) 
Seat 4: Redvin33 ($2.25 in chips) 
Seat 5: qualifire ($3.52 in chips) 
Seat 6: vagebolle ($1.14 in chips) 
Seat 7: garça409 ($0.71 in chips) 
Seat 8: geogas79 ($3.13 in chips) 
Seat 9: serg197211 ($2.08 in chips) 
ArthurStk: posts small blind $0.01
Unconform: posts big blind $0.02
*** HOLE CARDS ***
Dealt to Redvin33 [Qh 6d]
Redvin33: folds 
qualifire: folds 
vagebolle: folds 
garça409: folds 
geogas79: folds 
serg197211: raises $0.04 to $0.06
victordyfox: folds 
ArthurStk: folds 
Unconform: folds 
Uncalled bet ($0.04) returned to serg197211
serg197211 collected $0.05 from pot
serg197211: doesn't show hand 
*** SUMMARY ***
Total pot $0.05 | Rake $0 
Seat 1: victordyfox (button) folded before Flop (didn't bet)
Seat 2: ArthurStk (small blind) folded before Flop
Seat 3: Unconform (big blind) folded before Flop
Seat 4: Redvin33 folded before Flop (didn't bet)
Seat 5: qualifire folded before Flop (didn't bet)
Seat 6: vagebolle folded before Flop (didn't bet)
Seat 7: garça409 folded before Flop (didn't bet)
Seat 8: geogas79 folded before Flop (didn't bet)
Seat 9: serg197211 collected ($0.05)



PokerStars Zoom Hand #172697450740:  Hold'em No Limit ($0.01/$0.02) - 2017/07/06 18:47:57 ET
Table 'McNaught' 9-max Seat #1 is the button
Seat 1: setair ($1.66 in chips) 
Seat 2: Redvin33 ($2.25 in chips) 
Seat 3: nightowl89 ($2 in chips) 
Seat 4: olsche74 ($0.83 in chips) 
Seat 5: andreyzz1964 ($1.04 in chips) 
Seat 6: ewsikinho ($8.73 in chips) 
Seat 7: lion.1st ($2.16 in chips) 
Seat 8: Dayterius ($3.15 in chips) 
Seat 9: dorlo ($2.38 in chips) 
Redvin33: posts small blind $0.01
nightowl89: posts big blind $0.02
*** HOLE CARDS ***
Dealt to Redvin33 [9h Qh]
olsche74: folds 
andreyzz1964: raises $0.04 to $0.06
ewsikinho: folds 
lion.1st: folds 
Dayterius: folds 
dorlo: folds 
setair: folds 
Redvin33: calls $0.05
nightowl89: folds 
*** FLOP *** [6s Jh 7c]
Redvin33: checks 
andreyzz1964: bets $0.08
Redvin33: folds 
Uncalled bet ($0.08) returned to andreyzz1964
andreyzz1964 collected $0.14 from pot
andreyzz1964: doesn't show hand 
*** SUMMARY ***
Total pot $0.14 | Rake $0 
Board [6s Jh 7c]
Seat 1: setair (button) folded before Flop (didn't bet)
Seat 2: Redvin33 (small blind) folded on the Flop
Seat 3: nightowl89 (big blind) folded before Flop
Seat 4: olsche74 folded before Flop (didn't bet)
Seat 5: andreyzz1964 collected ($0.14)
Seat 6: ewsikinho folded before Flop (didn't bet)
Seat 7: lion.1st folded before Flop (didn't bet)
Seat 8: Dayterius folded before Flop (didn't bet)
Seat 9: dorlo folded before Flop (didn't bet)



PokerStars Zoom Hand #172697448220:  Hold'em No Limit ($0.01/$0.02) - 2017/07/06 18:47:53 ET
Table 'McNaught' 9-max Seat #1 is the button
Seat 1: jip347 ($1.36 in chips) 
Seat 2: mamiladi1971 ($1.94 in chips) 
Seat 3: grave_17 ($2.96 in chips) 
Seat 4: DiNiceBoy ($3.92 in chips) 
Seat 5: dorlo ($2.38 in chips) 
Seat 6: KostMalen ($2 in chips) 
Seat 7: KaHcTpykTap ($3.30 in chips) 
Seat 8: Redvin33 ($2.25 in chips) 
Seat 9: locobest13 ($1.42 in chips) 
mamiladi1971: posts small blind $0.01
grave_17: posts big blind $0.02
*** HOLE CARDS ***
Dealt to Redvin33 [5s 4d]
DiNiceBoy: folds 
dorlo: folds 
KostMalen: raises $0.04 to $0.06
KaHcTpykTap: folds 
Redvin33: folds 
locobest13: folds 
jip347: folds 
mamiladi1971: calls $0.05
grave_17: raises $0.14 to $0.20
KostMalen: folds 
mamiladi1971: folds 
Uncalled bet ($0.14) returned to grave_17
grave_17 collected $0.18 from pot
grave_17: doesn't show hand 
*** SUMMARY ***
Total pot $0.18 | Rake $0 
Seat 1: jip347 (button) folded before Flop (didn't bet)
Seat 2: mamiladi1971 (small blind) folded before Flop
Seat 3: grave_17 (big blind) collected ($0.18)
Seat 4: DiNiceBoy folded before Flop (didn't bet)
Seat 5: dorlo folded before Flop (didn't bet)
Seat 6: KostMalen folded before Flop
Seat 7: KaHcTpykTap folded before Flop (didn't bet)
Seat 8: Redvin33 folded before Flop (didn't bet)
Seat 9: locobest13 folded before Flop (didn't bet)



PokerStars Zoom Hand #172697466560:  Hold'em No Limit ($0.01/$0.02) - 2017/07/06 18:48:22 ET
Table 'McNaught' 9-max Seat #1 is the button
Seat 1: edskifrench ($0.99 in chips) 
Seat 2: MYRZILKA904 ($2.12 in chips) 
Seat 3: E-Berta ($0.63 in chips) 
Seat 4: robertomuc ($2 in chips) 
Seat 5: Crazylady007 ($1.31 in chips) 
Seat 6: Cayoosh16 ($2.06 in chips) 
Seat 7: Redvin33 ($2.19 in chips) 
Seat 8: SolyMar_2011 ($0.77 in chips) 
Seat 9: Bart018 ($4.53 in chips) 
MYRZILKA904: posts small blind $0.01
E-Berta: posts big blind $0.02
*** HOLE CARDS ***
Dealt to Redvin33 [3d Th]
robertomuc: raises $0.03 to $0.05
Crazylady007: folds 
Cayoosh16: folds 
Redvin33: folds 
SolyMar_2011: folds 
Bart018: folds 
edskifrench: folds 
MYRZILKA904: raises $0.13 to $0.18
E-Berta: folds 
robertomuc: folds 
Uncalled bet ($0.13) returned to MYRZILKA904
MYRZILKA904 collected $0.12 from pot
MYRZILKA904: doesn't show hand 
*** SUMMARY ***
Total pot $0.12 | Rake $0 
Seat 1: edskifrench (button) folded before Flop (didn't bet)
Seat 2: MYRZILKA904 (small blind) collected ($0.12)
Seat 3: E-Berta (big blind) folded before Flop
Seat 4: robertomuc folded before Flop
Seat 5: Crazylady007 folded before Flop (didn't bet)
Seat 6: Cayoosh16 folded before Flop (didn't bet)
Seat 7: Redvin33 folded before Flop (didn't bet)
Seat 8: SolyMar_2011 folded before Flop (didn't bet)
Seat 9: Bart018 folded before Flop (didn't bet)



PokerStars Zoom Hand #172697469026:  Hold'em No Limit ($0.01/$0.02) - 2017/07/06 18:48:26 ET
Table 'McNaught' 9-max Seat #1 is the button
Seat 1: Redvin33 ($2.19 in chips) 
Seat 2: Caatkins ($2.50 in chips) 
Seat 3: yohyoxyd ($2 in chips) 
Seat 4: Mùúh 22 ($2.07 in chips) 
Seat 5: Cayoosh16 ($1.04 in chips) 
Seat 6: Jaffar999 ($4.04 in chips) 
Seat 7: mercurio0359 ($1.99 in chips) 
Seat 8: Sympathya ($3.33 in chips) 
Seat 9: stacionar ($1.80 in chips) 
Caatkins: posts small blind $0.01
yohyoxyd: posts big blind $0.02
*** HOLE CARDS ***
Dealt to Redvin33 [5s Ad]
Mùúh 22: folds 
Cayoosh16: folds 
Jaffar999: folds 
mercurio0359: folds 
Sympathya: folds 
stacionar: folds 
Redvin33: raises $0.03 to $0.05
Caatkins: folds 
yohyoxyd: calls $0.03
*** FLOP *** [Qd Th 9c]
yohyoxyd: checks 
Redvin33: bets $0.11
yohyoxyd: folds 
Uncalled bet ($0.11) returned to Redvin33
Redvin33 collected $0.11 from pot
Redvin33: doesn't show hand 
*** SUMMARY ***
Total pot $0.11 | Rake $0 
Board [Qd Th 9c]
Seat 1: Redvin33 (button) collected ($0.11)
Seat 2: Caatkins (small blind) folded before Flop
Seat 3: yohyoxyd (big blind) folded on the Flop
Seat 4: Mùúh 22 folded before Flop (didn't bet)
Seat 5: Cayoosh16 folded before Flop (didn't bet)
Seat 6: Jaffar999 folded before Flop (didn't bet)
Seat 7: mercurio0359 folded before Flop (didn't bet)
Seat 8: Sympathya folded before Flop (didn't bet)
Seat 9: stacionar folded before Flop (didn't bet)



PokerStars Zoom Hand #172697488157:  Hold'em No Limit ($0.01/$0.02) - 2017/07/06 18:48:56 ET
Table 'McNaught' 9-max Seat #1 is the button
Seat 1: Lucas Cremer ($0.96 in chips) 
Seat 2: cooler50 ($1.47 in chips) 
Seat 3: denzell574 ($1.77 in chips) 
Seat 4: lokkiannu ($1.62 in chips) 
Seat 5: nerml000 ($1.89 in chips) 
Seat 6: panxopolis ($2.05 in chips) 
Seat 7: tseku0816 ($1.77 in chips) 
Seat 8: ArgusLL ($2.03 in chips) 
Seat 9: Redvin33 ($2.25 in chips) 
cooler50: posts small blind $0.01
denzell574: posts big blind $0.02
*** HOLE CARDS ***
Dealt to Redvin33 [2s 4h]
lokkiannu: calls $0.02
nerml000: folds 
panxopolis: folds 
tseku0816: folds 
ArgusLL: folds 
Redvin33: folds 
Lucas Cremer: folds 
cooler50: calls $0.01
denzell574: checks 
*** FLOP *** [9s Ks 7c]
cooler50: checks 
denzell574: bets $0.02
lokkiannu: raises $0.06 to $0.08
cooler50: folds 
denzell574: folds 
Uncalled bet ($0.06) returned to lokkiannu
lokkiannu collected $0.10 from pot
lokkiannu: doesn't show hand 
*** SUMMARY ***
Total pot $0.10 | Rake $0 
Board [9s Ks 7c]
Seat 1: Lucas Cremer (button) folded before Flop (didn't bet)
Seat 2: cooler50 (small blind) folded on the Flop
Seat 3: denzell574 (big blind) folded on the Flop
Seat 4: lokkiannu collected ($0.10)
Seat 5: nerml000 folded before Flop (didn't bet)
Seat 6: panxopolis folded before Flop (didn't bet)
Seat 7: tseku0816 folded before Flop (didn't bet)
Seat 8: ArgusLL folded before Flop (didn't bet)
Seat 9: Redvin33 folded before Flop (didn't bet)



PokerStars Zoom Hand #172697496374:  Hold'em No Limit ($0.01/$0.02) - 2017/07/06 18:49:09 ET
Table 'McNaught' 9-max Seat #1 is the button
Seat 1: Curt_3D ($2 in chips) 
Seat 2: SolyMar_2011 ($0.75 in chips) 
Seat 3: Gamer577 ($4.44 in chips) 
Seat 4: ameno-dorime ($0.87 in chips) 
Seat 5: reddysetg0 ($0.65 in chips) 
Seat 6: s.v.armodios ($6.34 in chips) 
Seat 7: Redvin33 ($2.25 in chips) 
Seat 8: yohyoxyd ($1.94 in chips) 
Seat 9: sohatyy ($2.36 in chips) 
SolyMar_2011: posts small blind $0.01
Gamer577: posts big blind $0.02
*** HOLE CARDS ***
Dealt to Redvin33 [Tc 9s]
ameno-dorime: folds 
reddysetg0: raises $0.04 to $0.06
s.v.armodios: folds 
Redvin33: folds 
yohyoxyd: folds 
sohatyy: folds 
Curt_3D: folds 
SolyMar_2011: calls $0.05
Gamer577: folds 
*** FLOP *** [Ac Ad 4d]
SolyMar_2011: bets $0.07
reddysetg0: calls $0.07
*** TURN *** [Ac Ad 4d] [3s]
SolyMar_2011: bets $0.14
reddysetg0: folds 
Uncalled bet ($0.14) returned to SolyMar_2011
SolyMar_2011 collected $0.27 from pot
SolyMar_2011: doesn't show hand 
*** SUMMARY ***
Total pot $0.28 | Rake $0.01 
Board [Ac Ad 4d 3s]
Seat 1: Curt_3D (button) folded before Flop (didn't bet)
Seat 2: SolyMar_2011 (small blind) collected ($0.27)
Seat 3: Gamer577 (big blind) folded before Flop
Seat 4: ameno-dorime folded before Flop (didn't bet)
Seat 5: reddysetg0 folded on the Turn
Seat 6: s.v.armodios folded before Flop (didn't bet)
Seat 7: Redvin33 folded before Flop (didn't bet)
Seat 8: yohyoxyd folded before Flop (didn't bet)
Seat 9: sohatyy folded before Flop (didn't bet)



PokerStars Zoom Hand #172697498955:  Hold'em No Limit ($0.01/$0.02) - 2017/07/06 18:49:13 ET
Table 'McNaught' 9-max Seat #1 is the button
Seat 1: Rishnu Fr ($2 in chips) 
Seat 2: usekey777 ($1.76 in chips) 
Seat 3: ameno-dorime ($0.87 in chips) 
Seat 4: Redvin33 ($2.25 in chips) 
Seat 5: werrr6699 ($2.13 in chips) 
Seat 6: Cayoosh16 ($2.02 in chips) 
Seat 7: KostMalen ($3.65 in chips) 
Seat 8: ruudu74 ($0.97 in chips) 
Seat 9: filipov1976 ($2.02 in chips) 
usekey777: posts small blind $0.01
ameno-dorime: posts big blind $0.02
*** HOLE CARDS ***
Dealt to Redvin33 [2c Qc]
Redvin33: folds 
werrr6699: raises $0.04 to $0.06
Cayoosh16: folds 
KostMalen: folds 
ruudu74: folds 
filipov1976: folds 
Rishnu Fr: calls $0.06
usekey777: calls $0.05
ameno-dorime: calls $0.04
*** FLOP *** [Th 2d Kc]
usekey777: checks 
ameno-dorime: checks 
werrr6699: bets $0.12
Rishnu Fr: folds 
usekey777: folds 
ameno-dorime: folds 
Uncalled bet ($0.12) returned to werrr6699
werrr6699 collected $0.23 from pot
werrr6699: doesn't show hand 
*** SUMMARY ***
Total pot $0.24 | Rake $0.01 
Board [Th 2d Kc]
Seat 1: Rishnu Fr (button) folded on the Flop
Seat 2: usekey777 (small blind) folded on the Flop
Seat 3: ameno-dorime (big blind) folded on the Flop
Seat 4: Redvin33 folded before Flop (didn't bet)
Seat 5: werrr6699 collected ($0.23)
Seat 6: Cayoosh16 folded before Flop (didn't bet)
Seat 7: KostMalen folded before Flop (didn't bet)
Seat 8: ruudu74 folded before Flop (didn't bet)
Seat 9: filipov1976 folded before Flop (didn't bet)



PokerStars Zoom Hand #172697502145:  Hold'em No Limit ($0.01/$0.02) - 2017/07/06 18:49:18 ET
Table 'McNaught' 9-max Seat #1 is the button
Seat 1: andreyzz1964 ($1.04 in chips) 
Seat 2: serg197211 ($2.12 in chips) 
Seat 3: Redvin33 ($2.25 in chips) 
Seat 4: Mr.Chipeater ($2.16 in chips) 
Seat 5: coringapenta ($1.80 in chips) 
Seat 6: ruudu74 ($0.97 in chips) 
Seat 7: REISR18 ($4.19 in chips) 
Seat 8: valera_9696@ ($2.28 in chips) 
Seat 9: Curt_3D ($2 in chips) 
serg197211: posts small blind $0.01
Redvin33: posts big blind $0.02
*** HOLE CARDS ***
Dealt to Redvin33 [Ah Ac]
Mr.Chipeater: folds 
coringapenta: folds 
ruudu74: raises $0.02 to $0.04
REISR18: folds 
valera_9696@: folds 
Curt_3D: folds 
andreyzz1964: folds 
serg197211: folds 
Redvin33: raises $0.06 to $0.10
ruudu74: calls $0.06
*** FLOP *** [3s 6c Tc]
Redvin33: bets $0.08
ruudu74: folds 
Uncalled bet ($0.08) returned to Redvin33
Redvin33 collected $0.20 from pot
Redvin33: doesn't show hand 
*** SUMMARY ***
Total pot $0.21 | Rake $0.01 
Board [3s 6c Tc]
Seat 1: andreyzz1964 (button) folded before Flop (didn't bet)
Seat 2: serg197211 (small blind) folded before Flop
Seat 3: Redvin33 (big blind) collected ($0.20)
Seat 4: Mr.Chipeater folded before Flop (didn't bet)
Seat 5: coringapenta folded before Flop (didn't bet)
Seat 6: ruudu74 folded on the Flop
Seat 7: REISR18 folded before Flop (didn't bet)
Seat 8: valera_9696@ folded before Flop (didn't bet)
Seat 9: Curt_3D folded before Flop (didn't bet)



PokerStars Zoom Hand #172697491956:  Hold'em No Limit ($0.01/$0.02) - 2017/07/06 18:49:02 ET
Table 'McNaught' 9-max Seat #1 is the button
Seat 1: CashmanJim ($2.03 in chips) 
Seat 2: Taraba68 ($1.81 in chips) 
Seat 3: ggGoldenPunk ($1.77 in chips) 
Seat 4: Roman 0992 ($3.26 in chips) 
Seat 5: usekey777 ($1.76 in chips) 
Seat 6: Redvin33 ($2.25 in chips) 
Seat 7: ArgusLL ($2 in chips) 
Seat 8: manowar7771 ($1.89 in chips) 
Seat 9: toluschev ($2.43 in chips) 
Taraba68: posts small blind $0.01
ggGoldenPunk: posts big blind $0.02
*** HOLE CARDS ***
Dealt to Redvin33 [4d 7d]
Roman 0992: folds 
usekey777: folds 
Redvin33: folds 
ArgusLL: folds 
manowar7771: raises $0.04 to $0.06
toluschev: calls $0.06
CashmanJim: folds 
Taraba68: folds 
ggGoldenPunk: folds 
*** FLOP *** [6c Td 2c]
manowar7771: checks 
toluschev: bets $0.10
manowar7771: calls $0.10
*** TURN *** [6c Td 2c] [Qd]
manowar7771: checks 
toluschev: bets $0.26
manowar7771: calls $0.26
*** RIVER *** [6c Td 2c Qd] [3c]
manowar7771: checks 
toluschev: checks 
*** SHOW DOWN ***
manowar7771: shows [Ac Jh] (high card Ace)
toluschev: shows [2h 2s] (three of a kind, Deuces)
toluschev collected $0.84 from pot
*** SUMMARY ***
Total pot $0.87 | Rake $0.03 
Board [6c Td 2c Qd 3c]
Seat 1: CashmanJim (button) folded before Flop (didn't bet)
Seat 2: Taraba68 (small blind) folded before Flop
Seat 3: ggGoldenPunk (big blind) folded before Flop
Seat 4: Roman 0992 folded before Flop (didn't bet)
Seat 5: usekey777 folded before Flop (didn't bet)
Seat 6: Redvin33 folded before Flop (didn't bet)
Seat 7: ArgusLL folded before Flop (didn't bet)
Seat 8: manowar7771 showed [Ac Jh] and lost with high card Ace
Seat 9: toluschev showed [2h 2s] and won ($0.84) with three of a kind, Deuces



PokerStars Zoom Hand #172697521049:  Hold'em No Limit ($0.01/$0.02) - 2017/07/06 18:49:48 ET
Table 'McNaught' 9-max Seat #1 is the button
Seat 1: grave_17 ($2.01 in chips) 
Seat 2: Redvin33 ($2.35 in chips) 
Seat 3: usekey777 ($1.70 in chips) 
Seat 4: doberman1977 ($4.15 in chips) 
Seat 5: Lionvodoo ($2 in chips) 
Seat 6: AJIEKC ($1.60 in chips) 
Seat 7: Mùúh 22 ($2.60 in chips) 
Seat 8: Nille20 ($2.07 in chips) 
Seat 9: ArthurStk ($4.07 in chips) 
Redvin33: posts small blind $0.01
usekey777: posts big blind $0.02
*** HOLE CARDS ***
Dealt to Redvin33 [3d 9c]
doberman1977: folds 
Lionvodoo: folds 
AJIEKC: folds 
Mùúh 22: folds 
Nille20: folds 
ArthurStk: folds 
grave_17: folds 
Redvin33: folds 
Uncalled bet ($0.01) returned to usekey777
usekey777 collected $0.02 from pot
usekey777: doesn't show hand 
*** SUMMARY ***
Total pot $0.02 | Rake $0 
Seat 1: grave_17 (button) folded before Flop (didn't bet)
Seat 2: Redvin33 (small blind) folded before Flop
Seat 3: usekey777 (big blind) collected ($0.02)
Seat 4: doberman1977 folded before Flop (didn't bet)
Seat 5: Lionvodoo folded before Flop (didn't bet)
Seat 6: AJIEKC folded before Flop (didn't bet)
Seat 7: Mùúh 22 folded before Flop (didn't bet)
Seat 8: Nille20 folded before Flop (didn't bet)
Seat 9: ArthurStk folded before Flop (didn't bet)



PokerStars Zoom Hand #172697529932:  Hold'em No Limit ($0.01/$0.02) - 2017/07/06 18:50:02 ET
Table 'McNaught' 9-max Seat #1 is the button
Seat 1: Jeka90210 ($1.71 in chips) 
Seat 2: SweetPlay777 ($1.50 in chips) 
Seat 3: serg197211 ($2.11 in chips) 
Seat 4: Metasss ($1.28 in chips) 
Seat 5: aka_d_trick ($2 in chips) 
Seat 6: Haczlo ($2 in chips) 
Seat 7: ameno-dorime ($1.06 in chips) 
Seat 8: Redvin33 ($2.34 in chips) 
Seat 9: Agares91 ($4.37 in chips) 
SweetPlay777: posts small blind $0.01
serg197211: posts big blind $0.02
*** HOLE CARDS ***
Dealt to Redvin33 [3c Ac]
Metasss: folds 
aka_d_trick: folds 
Haczlo: folds 
ameno-dorime: folds 
Redvin33: calls $0.02
Agares91: folds 
Jeka90210: folds 
SweetPlay777: folds 
serg197211: checks 
*** FLOP *** [6c 5h Jd]
serg197211: checks 
Redvin33: bets $0.05
serg197211: folds 
Uncalled bet ($0.05) returned to Redvin33
Redvin33 collected $0.05 from pot
Redvin33: doesn't show hand 
*** SUMMARY ***
Total pot $0.05 | Rake $0 
Board [6c 5h Jd]
Seat 1: Jeka90210 (button) folded before Flop (didn't bet)
Seat 2: SweetPlay777 (small blind) folded before Flop
Seat 3: serg197211 (big blind) folded on the Flop
Seat 4: Metasss folded before Flop (didn't bet)
Seat 5: aka_d_trick folded before Flop (didn't bet)
Seat 6: Haczlo folded before Flop (didn't bet)
Seat 7: ameno-dorime folded before Flop (didn't bet)
Seat 8: Redvin33 collected ($0.05)
Seat 9: Agares91 folded before Flop (didn't bet)



PokerStars Zoom Hand #172697526801:  Hold'em No Limit ($0.01/$0.02) - 2017/07/06 18:49:57 ET
Table 'McNaught' 9-max Seat #1 is the button
Seat 1: Tonymoretz ($2 in chips) 
Seat 2: LUKIANOV777 ($2.05 in chips) 
Seat 3: cooler50 ($2 in chips) 
Seat 4: Redvin33 ($2.34 in chips) 
Seat 5: Vikta8 ($1.13 in chips) 
Seat 6: Ede1wei$$ ($2.15 in chips) 
Seat 7: nsigi ($4.01 in chips) 
Seat 8: CashmanJim ($2.10 in chips) 
Seat 9: lion.1st ($1.97 in chips) 
LUKIANOV777: posts small blind $0.01
cooler50: posts big blind $0.02
*** HOLE CARDS ***
Dealt to Redvin33 [9d 2s]
Redvin33: folds 
Vikta8: folds 
Ede1wei$$: raises $0.06 to $0.08
nsigi: folds 
CashmanJim: folds 
lion.1st: folds 
Tonymoretz: folds 
LUKIANOV777: calls $0.07
cooler50: folds 
*** FLOP *** [4h 3c 3s]
LUKIANOV777: bets $0.12
Ede1wei$$: raises $0.20 to $0.32
LUKIANOV777: folds 
Uncalled bet ($0.20) returned to Ede1wei$$
Ede1wei$$ collected $0.41 from pot
Ede1wei$$: doesn't show hand 
*** SUMMARY ***
Total pot $0.42 | Rake $0.01 
Board [4h 3c 3s]
Seat 1: Tonymoretz (button) folded before Flop (didn't bet)
Seat 2: LUKIANOV777 (small blind) folded on the Flop
Seat 3: cooler50 (big blind) folded before Flop
Seat 4: Redvin33 folded before Flop (didn't bet)
Seat 5: Vikta8 folded before Flop (didn't bet)
Seat 6: Ede1wei$$ collected ($0.41)
Seat 7: nsigi folded before Flop (didn't bet)
Seat 8: CashmanJim folded before Flop (didn't bet)
Seat 9: lion.1st folded before Flop (didn't bet)



PokerStars Zoom Hand #172697523586:  Hold'em No Limit ($0.01/$0.02) - 2017/07/06 18:49:52 ET
Table 'McNaught' 9-max Seat #1 is the button
Seat 1: dorlo ($2.29 in chips) 
Seat 2: dhasis13 ($2.18 in chips) 
Seat 3: setair ($1.64 in chips) 
Seat 4: Peros1 ($4.50 in chips) 
Seat 5: lion.1st ($1.79 in chips) 
Seat 6: ntr2xit ($2.11 in chips) 
Seat 7: filipov1976 ($2 in chips) 
Seat 8: JeffersonWd ($2.88 in chips) 
Seat 9: Redvin33 ($2.34 in chips) 
dhasis13: posts small blind $0.01
setair: posts big blind $0.02
*** HOLE CARDS ***
Dealt to Redvin33 [Th Jd]
Peros1: folds 
lion.1st: folds 
ntr2xit: folds 
filipov1976: raises $0.06 to $0.08
JeffersonWd: calls $0.08
Redvin33: folds 
dorlo: calls $0.08
dhasis13: folds 
setair: folds 
*** FLOP *** [Jh 3h 2c]
filipov1976: bets $0.20
JeffersonWd: calls $0.20
dorlo: calls $0.20
*** TURN *** [Jh 3h 2c] [7d]
filipov1976: bets $0.84
JeffersonWd: raises $1.76 to $2.60 and is all-in
dorlo: folds 
filipov1976: calls $0.88 and is all-in
Uncalled bet ($0.88) returned to JeffersonWd
*** RIVER *** [Jh 3h 2c 7d] [4c]
*** SHOW DOWN ***
filipov1976: shows [Ks Kd] (a pair of Kings)
JeffersonWd: shows [Js Jc] (three of a kind, Jacks)
JeffersonWd collected $4.16 from pot
*** SUMMARY ***
Total pot $4.31 | Rake $0.15 
Board [Jh 3h 2c 7d 4c]
Seat 1: dorlo (button) folded on the Turn
Seat 2: dhasis13 (small blind) folded before Flop
Seat 3: setair (big blind) folded before Flop
Seat 4: Peros1 folded before Flop (didn't bet)
Seat 5: lion.1st folded before Flop (didn't bet)
Seat 6: ntr2xit folded before Flop (didn't bet)
Seat 7: filipov1976 showed [Ks Kd] and lost with a pair of Kings
Seat 8: JeffersonWd showed [Js Jc] and won ($4.16) with three of a kind, Jacks
Seat 9: Redvin33 folded before Flop (didn't bet)



PokerStars Zoom Hand #172697548131:  Hold'em No Limit ($0.01/$0.02) - 2017/07/06 18:50:31 ET
Table 'McNaught' 9-max Seat #1 is the button
Seat 1: Grigoris1962 ($1.37 in chips) 
Seat 2: nightowl89 ($4.20 in chips) 
Seat 3: ggGoldenPunk ($1.91 in chips) 
Seat 4: stacionar ($1.91 in chips) 
Seat 5: Redvin33 ($2.37 in chips) 
Seat 6: japu2010 ($2.32 in chips) 
Seat 7: KaHcTpykTap ($2.10 in chips) 
Seat 8: colllatinboy ($2.24 in chips) 
Seat 9: Artem23Ka ($5.83 in chips) 
nightowl89: posts small blind $0.01
ggGoldenPunk: posts big blind $0.02
*** HOLE CARDS ***
Dealt to Redvin33 [2h Kc]
stacionar: folds 
Redvin33: folds 
japu2010: raises $0.03 to $0.05
KaHcTpykTap: folds 
colllatinboy: folds 
Artem23Ka: folds 
Grigoris1962: folds 
nightowl89: folds 
ggGoldenPunk: folds 
Uncalled bet ($0.03) returned to japu2010
japu2010 collected $0.05 from pot
japu2010: doesn't show hand 
*** SUMMARY ***
Total pot $0.05 | Rake $0 
Seat 1: Grigoris1962 (button) folded before Flop (didn't bet)
Seat 2: nightowl89 (small blind) folded before Flop
Seat 3: ggGoldenPunk (big blind) folded before Flop
Seat 4: stacionar folded before Flop (didn't bet)
Seat 5: Redvin33 folded before Flop (didn't bet)
Seat 6: japu2010 collected ($0.05)
Seat 7: KaHcTpykTap folded before Flop (didn't bet)
Seat 8: colllatinboy folded before Flop (didn't bet)
Seat 9: Artem23Ka folded before Flop (didn't bet)



PokerStars Zoom Hand #172697545611:  Hold'em No Limit ($0.01/$0.02) - 2017/07/06 18:50:27 ET
Table 'McNaught' 9-max Seat #1 is the button
Seat 1: Redvin33 ($2.37 in chips) 
Seat 2: wellgardiano ($2.59 in chips) 
Seat 3: ewsikinho ($2.24 in chips) 
Seat 4: Ede1wei$$ ($2.71 in chips) 
Seat 5: SweetPlay777 ($1.52 in chips) 
Seat 6: stacionar ($1.91 in chips) 
Seat 7: victordyfox ($1.05 in chips) 
Seat 8: ShadMrPo ($5.24 in chips) 
Seat 9: Calchiat ($3.06 in chips) 
wellgardiano: posts small blind $0.01
ewsikinho: posts big blind $0.02
*** HOLE CARDS ***
Dealt to Redvin33 [Kh 4c]
Ede1wei$$: folds 
SweetPlay777: folds 
stacionar: folds 
victordyfox: folds 
ShadMrPo: folds 
Calchiat: folds 
Redvin33: folds 
wellgardiano: calls $0.01
ewsikinho: raises $0.08 to $0.10
wellgardiano: folds 
Uncalled bet ($0.08) returned to ewsikinho
ewsikinho collected $0.04 from pot
ewsikinho: doesn't show hand 
*** SUMMARY ***
Total pot $0.04 | Rake $0 
Seat 1: Redvin33 (button) folded before Flop (didn't bet)
Seat 2: wellgardiano (small blind) folded before Flop
Seat 3: ewsikinho (big blind) collected ($0.04)
Seat 4: Ede1wei$$ folded before Flop (didn't bet)
Seat 5: SweetPlay777 folded before Flop (didn't bet)
Seat 6: stacionar folded before Flop (didn't bet)
Seat 7: victordyfox folded before Flop (didn't bet)
Seat 8: ShadMrPo folded before Flop (didn't bet)
Seat 9: Calchiat folded before Flop (didn't bet)



PokerStars Zoom Hand #172697550590:  Hold'em No Limit ($0.01/$0.02) - 2017/07/06 18:50:35 ET
Table 'McNaught' 9-max Seat #1 is the button
Seat 1: MPaz_87 ($2.18 in chips) 
Seat 2: MargaridaRS ($0.98 in chips) 
Seat 3: Timlagor ($1.54 in chips) 
Seat 4: scorpion2680 ($1.27 in chips) 
Seat 5: Redvin33 ($2.37 in chips) 
Seat 6: Robin872 ($2.89 in chips) 
Seat 7: Grigoris1962 ($1.37 in chips) 
Seat 8: Sympathya ($3.04 in chips) 
Seat 9: serg197211 ($2.08 in chips) 
MargaridaRS: posts small blind $0.01
Timlagor: posts big blind $0.02
*** HOLE CARDS ***
Dealt to Redvin33 [Qc Td]
scorpion2680: folds 
Redvin33: folds 
Robin872: folds 
Grigoris1962: folds 
Sympathya: raises $0.03 to $0.05
serg197211: folds 
MPaz_87: folds 
MargaridaRS: folds 
Timlagor: folds 
Uncalled bet ($0.03) returned to Sympathya
Sympathya collected $0.05 from pot
Sympathya: doesn't show hand 
*** SUMMARY ***
Total pot $0.05 | Rake $0 
Seat 1: MPaz_87 (button) folded before Flop (didn't bet)
Seat 2: MargaridaRS (small blind) folded before Flop
Seat 3: Timlagor (big blind) folded before Flop
Seat 4: scorpion2680 folded before Flop (didn't bet)
Seat 5: Redvin33 folded before Flop (didn't bet)
Seat 6: Robin872 folded before Flop (didn't bet)
Seat 7: Grigoris1962 folded before Flop (didn't bet)
Seat 8: Sympathya collected ($0.05)
Seat 9: serg197211 folded before Flop (didn't bet)



PokerStars Zoom Hand #172697553115:  Hold'em No Limit ($0.01/$0.02) - 2017/07/06 18:50:39 ET
Table 'McNaught' 9-max Seat #1 is the button
Seat 1: Curt_3D ($2 in chips) 
Seat 2: KleidedutrA ($4.66 in chips) 
Seat 3: Redvin33 ($2.37 in chips) 
Seat 4: Bart018 ($4.50 in chips) 
Seat 5: Gamer577 ($4.39 in chips) 
Seat 6: Tonymoretz ($2 in chips) 
Seat 7: ageloc2012 ($0.97 in chips) 
Seat 8: Kenshiro*969 ($2.12 in chips) 
Seat 9: burik23 ($2.37 in chips) 
KleidedutrA: posts small blind $0.01
Redvin33: posts big blind $0.02
*** HOLE CARDS ***
Dealt to Redvin33 [Qs 9d]
Bart018: folds 
Gamer577: folds 
Tonymoretz: folds 
ageloc2012: folds 
Kenshiro*969: folds 
burik23: folds 
Curt_3D: folds 
KleidedutrA: calls $0.01
Redvin33: checks 
*** FLOP *** [3h 2d 5s]
KleidedutrA: bets $0.04
Redvin33: folds 
Uncalled bet ($0.04) returned to KleidedutrA
KleidedutrA collected $0.04 from pot
KleidedutrA: doesn't show hand 
*** SUMMARY ***
Total pot $0.04 | Rake $0 
Board [3h 2d 5s]
Seat 1: Curt_3D (button) folded before Flop (didn't bet)
Seat 2: KleidedutrA (small blind) collected ($0.04)
Seat 3: Redvin33 (big blind) folded on the Flop
Seat 4: Bart018 folded before Flop (didn't bet)
Seat 5: Gamer577 folded before Flop (didn't bet)
Seat 6: Tonymoretz folded before Flop (didn't bet)
Seat 7: ageloc2012 folded before Flop (didn't bet)
Seat 8: Kenshiro*969 folded before Flop (didn't bet)
Seat 9: burik23 folded before Flop (didn't bet)



PokerStars Zoom Hand #172697566839:  Hold'em No Limit ($0.01/$0.02) - 2017/07/06 18:51:01 ET
Table 'McNaught' 9-max Seat #1 is the button
Seat 1: KostMalen ($3.60 in chips) 
Seat 2: Haczlo ($3.50 in chips) 
Seat 3: Schdoerrchen ($2.12 in chips) 
Seat 4: paul_ivanov ($0.66 in chips) 
Seat 5: Kenshiro*969 ($3.17 in chips) 
Seat 6: uncledon888 ($1.44 in chips) 
Seat 7: Redvin33 ($2.35 in chips) 
Seat 8: Artem23Ka ($2 in chips) 
Seat 9: lion.1st ($2.03 in chips) 
Haczlo: posts small blind $0.01
Schdoerrchen: posts big blind $0.02
*** HOLE CARDS ***
Dealt to Redvin33 [2c 7h]
paul_ivanov: folds 
Kenshiro*969: folds 
uncledon888: folds 
Redvin33: folds 
Artem23Ka: folds 
lion.1st: folds 
KostMalen: folds 
Haczlo: folds 
Uncalled bet ($0.01) returned to Schdoerrchen
Schdoerrchen collected $0.02 from pot
Schdoerrchen: doesn't show hand 
*** SUMMARY ***
Total pot $0.02 | Rake $0 
Seat 1: KostMalen (button) folded before Flop (didn't bet)
Seat 2: Haczlo (small blind) folded before Flop
Seat 3: Schdoerrchen (big blind) collected ($0.02)
Seat 4: paul_ivanov folded before Flop (didn't bet)
Seat 5: Kenshiro*969 folded before Flop (didn't bet)
Seat 6: uncledon888 folded before Flop (didn't bet)
Seat 7: Redvin33 folded before Flop (didn't bet)
Seat 8: Artem23Ka folded before Flop (didn't bet)
Seat 9: lion.1st folded before Flop (didn't bet)



PokerStars Zoom Hand #172697569314:  Hold'em No Limit ($0.01/$0.02) - 2017/07/06 18:51:05 ET
Table 'McNaught' 9-max Seat #1 is the button
Seat 1: nerml000 ($1.89 in chips) 
Seat 2: Xamil666 ($4.32 in chips) 
Seat 3: paul_ivanov ($0.66 in chips) 
Seat 4: Redvin33 ($2.35 in chips) 
Seat 5: Peros1 ($4.55 in chips) 
Seat 6: wellgardiano ($2.57 in chips) 
Seat 7: Ede1wei$$ ($2.22 in chips) 
Seat 8: MPaz_87 ($2.33 in chips) 
Seat 9: egjoer ($2.23 in chips) 
Xamil666: posts small blind $0.01
paul_ivanov: posts big blind $0.02
*** HOLE CARDS ***
Dealt to Redvin33 [Th Ac]
Redvin33: calls $0.02
Peros1: folds 
wellgardiano: calls $0.02
Ede1wei$$: folds 
MPaz_87: raises $0.06 to $0.08
egjoer: folds 
nerml000: folds 
Xamil666: calls $0.07
paul_ivanov: folds 
Redvin33: calls $0.06
wellgardiano: folds 
*** FLOP *** [2h Kc 9s]
Xamil666: checks 
Redvin33: bets $0.12
MPaz_87: calls $0.12
Xamil666: folds 
*** TURN *** [2h Kc 9s] [Qd]
Redvin33: checks 
MPaz_87: bets $0.28
Redvin33: folds 
Uncalled bet ($0.28) returned to MPaz_87
MPaz_87 collected $0.50 from pot
MPaz_87: doesn't show hand 
*** SUMMARY ***
Total pot $0.52 | Rake $0.02 
Board [2h Kc 9s Qd]
Seat 1: nerml000 (button) folded before Flop (didn't bet)
Seat 2: Xamil666 (small blind) folded on the Flop
Seat 3: paul_ivanov (big blind) folded before Flop
Seat 4: Redvin33 folded on the Turn
Seat 5: Peros1 folded before Flop (didn't bet)
Seat 6: wellgardiano folded before Flop
Seat 7: Ede1wei$$ folded before Flop (didn't bet)
Seat 8: MPaz_87 collected ($0.50)
Seat 9: egjoer folded before Flop (didn't bet)



PokerStars Zoom Hand #172697607700:  Hold'em No Limit ($0.01/$0.02) - 2017/07/06 18:52:06 ET
Table 'McNaught' 9-max Seat #1 is the button
Seat 1: MPaz_87 ($2.08 in chips) 
Seat 2: Redvin33 ($2.15 in chips) 
Seat 3: filipov1976 ($3.44 in chips) 
Seat 4: Roman 0992 ($2.49 in chips) 
Seat 5: alexpolevaja ($0.33 in chips) 
Seat 6: d11dozer ($2.01 in chips) 
Seat 7: valera_9696@ ($2.32 in chips) 
Seat 8: Gorwfwefwed ($3.27 in chips) 
Seat 9: toluschev ($2.66 in chips) 
Redvin33: posts small blind $0.01
filipov1976: posts big blind $0.02
*** HOLE CARDS ***
Dealt to Redvin33 [4s 7s]
Roman 0992: folds 
alexpolevaja: folds 
d11dozer: folds 
valera_9696@: folds 
Gorwfwefwed: folds 
toluschev: folds 
MPaz_87: folds 
Redvin33: folds 
Uncalled bet ($0.01) returned to filipov1976
filipov1976 collected $0.02 from pot
filipov1976: doesn't show hand 
*** SUMMARY ***
Total pot $0.02 | Rake $0 
Seat 1: MPaz_87 (button) folded before Flop (didn't bet)
Seat 2: Redvin33 (small blind) folded before Flop
Seat 3: filipov1976 (big blind) collected ($0.02)
Seat 4: Roman 0992 folded before Flop (didn't bet)
Seat 5: alexpolevaja folded before Flop (didn't bet)
Seat 6: d11dozer folded before Flop (didn't bet)
Seat 7: valera_9696@ folded before Flop (didn't bet)
Seat 8: Gorwfwefwed folded before Flop (didn't bet)
Seat 9: toluschev folded before Flop (didn't bet)



PokerStars Zoom Hand #172697610228:  Hold'em No Limit ($0.01/$0.02) - 2017/07/06 18:52:10 ET
Table 'McNaught' 9-max Seat #1 is the button
Seat 1: JeffersonWd ($1.69 in chips) 
Seat 2: Rufus Titum ($2.81 in chips) 
Seat 3: Crazylady007 ($1.59 in chips) 
Seat 4: ageloc2012 ($1.06 in chips) 
Seat 5: DiNiceBoy ($2.83 in chips) 
Seat 6: egjoer ($2.04 in chips) 
Seat 7: maurixxx007 ($1.23 in chips) 
Seat 8: Redvin33 ($2.14 in chips) 
Seat 9: Mr.Chipeater ($2.13 in chips) 
Rufus Titum: posts small blind $0.01
Crazylady007: posts big blind $0.02
*** HOLE CARDS ***
Dealt to Redvin33 [3s 3h]
ageloc2012: folds 
DiNiceBoy: folds 
egjoer: folds 
maurixxx007: folds 
Redvin33: raises $0.03 to $0.05
Mr.Chipeater: calls $0.05
JeffersonWd: folds 
Rufus Titum: folds 
Crazylady007: folds 
*** FLOP *** [4h 2h 9s]
Redvin33: bets $0.06
Mr.Chipeater: calls $0.06
*** TURN *** [4h 2h 9s] [8d]
Redvin33: checks 
Mr.Chipeater: bets $0.20
Redvin33: folds 
Uncalled bet ($0.20) returned to Mr.Chipeater
Mr.Chipeater collected $0.24 from pot
Mr.Chipeater: doesn't show hand 
*** SUMMARY ***
Total pot $0.25 | Rake $0.01 
Board [4h 2h 9s 8d]
Seat 1: JeffersonWd (button) folded before Flop (didn't bet)
Seat 2: Rufus Titum (small blind) folded before Flop
Seat 3: Crazylady007 (big blind) folded before Flop
Seat 4: ageloc2012 folded before Flop (didn't bet)
Seat 5: DiNiceBoy folded before Flop (didn't bet)
Seat 6: egjoer folded before Flop (didn't bet)
Seat 7: maurixxx007 folded before Flop (didn't bet)
Seat 8: Redvin33 folded on the Turn
Seat 9: Mr.Chipeater collected ($0.24)



PokerStars Zoom Hand #172697642885:  Hold'em No Limit ($0.01/$0.02) - 2017/07/06 18:53:02 ET
Table 'McNaught' 9-max Seat #1 is the button
Seat 1: dmitrychuk ($2.36 in chips) 
Seat 2: Suchvn ($2.97 in chips) 
Seat 3: garça409 ($0.43 in chips) 
Seat 4: egjoer ($2.04 in chips) 
Seat 5: valera_9696@ ($2.29 in chips) 
Seat 6: Cayoosh16 ($2 in chips) 
Seat 7: ElNinioCha ($0.35 in chips) 
Seat 8: Gorwfwefwed ($2.02 in chips) 
Seat 9: Redvin33 ($2.03 in chips) 
Suchvn: posts small blind $0.01
garça409: posts big blind $0.02
*** HOLE CARDS ***
Dealt to Redvin33 [Ah Jd]
egjoer: folds 
valera_9696@: folds 
Cayoosh16: folds 
ElNinioCha: folds 
Gorwfwefwed: folds 
Redvin33: raises $0.03 to $0.05
dmitrychuk: folds 
Suchvn: folds 
garça409: folds 
Uncalled bet ($0.03) returned to Redvin33
Redvin33 collected $0.05 from pot
Redvin33: doesn't show hand 
*** SUMMARY ***
Total pot $0.05 | Rake $0 
Seat 1: dmitrychuk (button) folded before Flop (didn't bet)
Seat 2: Suchvn (small blind) folded before Flop
Seat 3: garça409 (big blind) folded before Flop
Seat 4: egjoer folded before Flop (didn't bet)
Seat 5: valera_9696@ folded before Flop (didn't bet)
Seat 6: Cayoosh16 folded before Flop (didn't bet)
Seat 7: ElNinioCha folded before Flop (didn't bet)
Seat 8: Gorwfwefwed folded before Flop (didn't bet)
Seat 9: Redvin33 collected ($0.05)



PokerStars Zoom Hand #172697639696:  Hold'em No Limit ($0.01/$0.02) - 2017/07/06 18:52:57 ET
Table 'McNaught' 9-max Seat #1 is the button
Seat 1: Redvin33 ($2.03 in chips) 
Seat 2: LUKIANOV777 ($2.58 in chips) 
Seat 3: nightowl89 ($2.78 in chips) 
Seat 4: aka_d_trick ($4.46 in chips) 
Seat 5: panxopolis ($1.62 in chips) 
Seat 6: Mùúh 22 ($2.08 in chips) 
Seat 7: DiNiceBoy ($4.11 in chips) 
Seat 8: ^J0K3RST@RS! ($1.93 in chips) 
Seat 9: SweetPlay777 ($1.96 in chips) 
LUKIANOV777: posts small blind $0.01
nightowl89: posts big blind $0.02
*** HOLE CARDS ***
Dealt to Redvin33 [3s Ah]
aka_d_trick: folds 
panxopolis: folds 
Mùúh 22: raises $0.04 to $0.06
DiNiceBoy: raises $0.12 to $0.18
^J0K3RST@RS!: folds 
SweetPlay777: folds 
Redvin33: folds 
LUKIANOV777: folds 
nightowl89: folds 
Mùúh 22: folds 
Uncalled bet ($0.12) returned to DiNiceBoy
DiNiceBoy collected $0.15 from pot
DiNiceBoy: doesn't show hand 
*** SUMMARY ***
Total pot $0.15 | Rake $0 
Seat 1: Redvin33 (button) folded before Flop (didn't bet)
Seat 2: LUKIANOV777 (small blind) folded before Flop
Seat 3: nightowl89 (big blind) folded before Flop
Seat 4: aka_d_trick folded before Flop (didn't bet)
Seat 5: panxopolis folded before Flop (didn't bet)
Seat 6: Mùúh 22 folded before Flop
Seat 7: DiNiceBoy collected ($0.15)
Seat 8: ^J0K3RST@RS! folded before Flop (didn't bet)
Seat 9: SweetPlay777 folded before Flop (didn't bet)



PokerStars Zoom Hand #172697661737:  Hold'em No Limit ($0.01/$0.02) - 2017/07/06 18:53:32 ET
Table 'McNaught' 9-max Seat #1 is the button
Seat 1: stacionar ($2.10 in chips) 
Seat 2: ggGoldenPunk ($1.62 in chips) 
Seat 3: LYUBOW ($3.94 in chips) 
Seat 4: Xamil666 ($4.22 in chips) 
Seat 5: Redvin33 ($2.06 in chips) 
Seat 6: andreyzz1964 ($0.35 in chips) 
Seat 7: trthskr ($1.92 in chips) 
Seat 8: sohatyy ($2.37 in chips) 
Seat 9: Unconform ($2.02 in chips) 
ggGoldenPunk: posts small blind $0.01
LYUBOW: posts big blind $0.02
*** HOLE CARDS ***
Dealt to Redvin33 [Td Jh]
Xamil666: folds 
Redvin33: folds 
andreyzz1964: folds 
trthskr: folds 
sohatyy: folds 
Unconform: folds 
stacionar: folds 
ggGoldenPunk: folds 
Uncalled bet ($0.01) returned to LYUBOW
LYUBOW collected $0.02 from pot
LYUBOW: doesn't show hand 
*** SUMMARY ***
Total pot $0.02 | Rake $0 
Seat 1: stacionar (button) folded before Flop (didn't bet)
Seat 2: ggGoldenPunk (small blind) folded before Flop
Seat 3: LYUBOW (big blind) collected ($0.02)
Seat 4: Xamil666 folded before Flop (didn't bet)
Seat 5: Redvin33 folded before Flop (didn't bet)
Seat 6: andreyzz1964 folded before Flop (didn't bet)
Seat 7: trthskr folded before Flop (didn't bet)
Seat 8: sohatyy folded before Flop (didn't bet)
Seat 9: Unconform folded before Flop (didn't bet)



PokerStars Zoom Hand #172697656774:  Hold'em No Limit ($0.01/$0.02) - 2017/07/06 18:53:24 ET
Table 'McNaught' 9-max Seat #1 is the button
Seat 1: filipov1976 ($2.10 in chips) 
Seat 2: Dayterius ($3 in chips) 
Seat 3: sergeyl01 ($0.60 in chips) 
Seat 4: maurixxx007 ($1.37 in chips) 
Seat 5: viagem ($6.07 in chips) 
Seat 6: Redvin33 ($2.06 in chips) 
Seat 7: egjoer ($2.37 in chips) 
Seat 8: Allekccc ($9.98 in chips) 
Seat 9: Curt_3D ($2.70 in chips) 
Dayterius: posts small blind $0.01
sergeyl01: posts big blind $0.02
*** HOLE CARDS ***
Dealt to Redvin33 [2h 5h]
maurixxx007: folds 
viagem: folds 
Redvin33: folds 
egjoer: folds 
Allekccc: raises $0.04 to $0.06
Curt_3D: folds 
filipov1976: folds 
Dayterius: folds 
sergeyl01: folds 
Uncalled bet ($0.04) returned to Allekccc
Allekccc collected $0.05 from pot
Allekccc: doesn't show hand 
*** SUMMARY ***
Total pot $0.05 | Rake $0 
Seat 1: filipov1976 (button) folded before Flop (didn't bet)
Seat 2: Dayterius (small blind) folded before Flop
Seat 3: sergeyl01 (big blind) folded before Flop
Seat 4: maurixxx007 folded before Flop (didn't bet)
Seat 5: viagem folded before Flop (didn't bet)
Seat 6: Redvin33 folded before Flop (didn't bet)
Seat 7: egjoer folded before Flop (didn't bet)
Seat 8: Allekccc collected ($0.05)
Seat 9: Curt_3D folded before Flop (didn't bet)



PokerStars Zoom Hand #172697664257:  Hold'em No Limit ($0.01/$0.02) - 2017/07/06 18:53:36 ET
Table 'McNaught' 9-max Seat #1 is the button
Seat 1: FANYDA ($1.97 in chips) 
Seat 2: manowar7771 ($1.69 in chips) 
Seat 3: Redvin33 ($2.06 in chips) 
Seat 4: SolyMar_2011 ($1.09 in chips) 
Seat 5: AZAAAAAP ($3.15 in chips) 
Seat 6: werrr6699 ($2 in chips) 
Seat 7: Edward Cage ($3.52 in chips) 
Seat 8: Rishnu Fr ($3.08 in chips) 
Seat 9: scorpion2680 ($1.16 in chips) 
manowar7771: posts small blind $0.01
Redvin33: posts big blind $0.02
*** HOLE CARDS ***
Dealt to Redvin33 [Qh Ad]
SolyMar_2011: folds 
AZAAAAAP: folds 
werrr6699: folds 
Edward Cage: folds 
Rishnu Fr: folds 
scorpion2680: raises $0.04 to $0.06
FANYDA: folds 
manowar7771: calls $0.05
Redvin33: calls $0.04
*** FLOP *** [Kd 5c 5s]
manowar7771: checks 
Redvin33: bets $0.10
scorpion2680: calls $0.10
manowar7771: folds 
*** TURN *** [Kd 5c 5s] [3s]
Redvin33: checks 
scorpion2680: bets $0.22
Redvin33: folds 
Uncalled bet ($0.22) returned to scorpion2680
scorpion2680 collected $0.37 from pot
scorpion2680: doesn't show hand 
*** SUMMARY ***
Total pot $0.38 | Rake $0.01 
Board [Kd 5c 5s 3s]
Seat 1: FANYDA (button) folded before Flop (didn't bet)
Seat 2: manowar7771 (small blind) folded on the Flop
Seat 3: Redvin33 (big blind) folded on the Turn
Seat 4: SolyMar_2011 folded before Flop (didn't bet)
Seat 5: AZAAAAAP folded before Flop (didn't bet)
Seat 6: werrr6699 folded before Flop (didn't bet)
Seat 7: Edward Cage folded before Flop (didn't bet)
Seat 8: Rishnu Fr folded before Flop (didn't bet)
Seat 9: scorpion2680 collected ($0.37)



PokerStars Zoom Hand #172697693331:  Hold'em No Limit ($0.01/$0.02) - 2017/07/06 18:54:23 ET
Table 'McNaught' 9-max Seat #1 is the button
Seat 1: Bart018 ($1.98 in chips) 
Seat 2: KostMalen ($3.55 in chips) 
Seat 3: PJWALL ($3.80 in chips) 
Seat 4: SUPERCARLAO ($2.92 in chips) 
Seat 5: ageloc2012 ($1.82 in chips) 
Seat 6: Rishnu Fr ($2.08 in chips) 
Seat 7: Redvin33 ($1.89 in chips) 
Seat 8: valera_9696@ ($2.14 in chips) 
Seat 9: LUKIANOV777 ($2.54 in chips) 
KostMalen: posts small blind $0.01
PJWALL: posts big blind $0.02
*** HOLE CARDS ***
Dealt to Redvin33 [Kc 3h]
SUPERCARLAO: folds 
ageloc2012: folds 
Rishnu Fr: folds 
Redvin33: folds 
valera_9696@: raises $0.04 to $0.06
LUKIANOV777: folds 
Bart018: folds 
KostMalen: folds 
PJWALL: folds 
Uncalled bet ($0.04) returned to valera_9696@
valera_9696@ collected $0.05 from pot
valera_9696@: doesn't show hand 
*** SUMMARY ***
Total pot $0.05 | Rake $0 
Seat 1: Bart018 (button) folded before Flop (didn't bet)
Seat 2: KostMalen (small blind) folded before Flop
Seat 3: PJWALL (big blind) folded before Flop
Seat 4: SUPERCARLAO folded before Flop (didn't bet)
Seat 5: ageloc2012 folded before Flop (didn't bet)
Seat 6: Rishnu Fr folded before Flop (didn't bet)
Seat 7: Redvin33 folded before Flop (didn't bet)
Seat 8: valera_9696@ collected ($0.05)
Seat 9: LUKIANOV777 folded before Flop (didn't bet)



PokerStars Zoom Hand #172697690913:  Hold'em No Limit ($0.01/$0.02) - 2017/07/06 18:54:19 ET
Table 'McNaught' 9-max Seat #1 is the button
Seat 1: Cayoosh16 ($2.03 in chips) 
Seat 2: Redvin33 ($1.90 in chips) 
Seat 3: NJoy2Win ($8.41 in chips) 
Seat 4: serg197211 ($2.35 in chips) 
Seat 5: uncledon888 ($0.33 in chips) 
Seat 6: Mr.Chipeater ($4.11 in chips) 
Seat 7: nerml000 ($1.59 in chips) 
Seat 8: Rufus Titum ($2.21 in chips) 
Seat 9: lacher29 ($2.28 in chips) 
Redvin33: posts small blind $0.01
NJoy2Win: posts big blind $0.02
*** HOLE CARDS ***
Dealt to Redvin33 [6h Qs]
serg197211: folds 
uncledon888: folds 
Mr.Chipeater: folds 
nerml000: folds 
Rufus Titum: raises $0.04 to $0.06
lacher29: folds 
Cayoosh16: folds 
Redvin33: folds 
NJoy2Win: folds 
Uncalled bet ($0.04) returned to Rufus Titum
Rufus Titum collected $0.05 from pot
Rufus Titum: doesn't show hand 
*** SUMMARY ***
Total pot $0.05 | Rake $0 
Seat 1: Cayoosh16 (button) folded before Flop (didn't bet)
Seat 2: Redvin33 (small blind) folded before Flop
Seat 3: NJoy2Win (big blind) folded before Flop
Seat 4: serg197211 folded before Flop (didn't bet)
Seat 5: uncledon888 folded before Flop (didn't bet)
Seat 6: Mr.Chipeater folded before Flop (didn't bet)
Seat 7: nerml000 folded before Flop (didn't bet)
Seat 8: Rufus Titum collected ($0.05)
Seat 9: lacher29 folded before Flop (didn't bet)



PokerStars Zoom Hand #172697659238:  Hold'em No Limit ($0.01/$0.02) - 2017/07/06 18:53:28 ET
Table 'McNaught' 9-max Seat #1 is the button
Seat 1: motola cun ($2.83 in chips) 
Seat 2: rnxbocker ($1.92 in chips) 
Seat 3: Nille20 ($2.02 in chips) 
Seat 4: 18062011 ($1.66 in chips) 
Seat 5: lalon22 ($1.80 in chips) 
Seat 6: Redvin33 ($2.06 in chips) 
Seat 7: E-Berta ($0.51 in chips) 
Seat 8: andreyzz1964 ($0.35 in chips) 
Seat 9: burik23 ($1.92 in chips) 
rnxbocker: posts small blind $0.01
Nille20: posts big blind $0.02
*** HOLE CARDS ***
Dealt to Redvin33 [7c Tc]
18062011: raises $0.04 to $0.06
lalon22: folds 
Redvin33: folds 
E-Berta: folds 
andreyzz1964: folds 
burik23: calls $0.06
motola cun: folds 
rnxbocker: folds 
Nille20: calls $0.04
*** FLOP *** [Qs Qd 6c]
Nille20: checks 
18062011: bets $0.08
burik23: calls $0.08
Nille20: folds 
*** TURN *** [Qs Qd 6c] [6d]
18062011: checks 
burik23: checks 
*** RIVER *** [Qs Qd 6c 6d] [3h]
18062011: bets $0.18
burik23: raises $0.18 to $0.36
18062011: raises $0.30 to $0.66
burik23: raises $0.30 to $0.96
18062011: raises $0.56 to $1.52 and is all-in
burik23: calls $0.56
*** SHOW DOWN ***
18062011: shows [Ac Qh] (a full house, Queens full of Sixes)
burik23: shows [Js Qc] (a full house, Queens full of Sixes)
18062011 collected $1.64 from pot
burik23 collected $1.63 from pot
*** SUMMARY ***
Total pot $3.39 | Rake $0.12 
Board [Qs Qd 6c 6d 3h]
Seat 1: motola cun (button) folded before Flop (didn't bet)
Seat 2: rnxbocker (small blind) folded before Flop
Seat 3: Nille20 (big blind) folded on the Flop
Seat 4: 18062011 showed [Ac Qh] and won ($1.64) with a full house, Queens full of Sixes
Seat 5: lalon22 folded before Flop (didn't bet)
Seat 6: Redvin33 folded before Flop (didn't bet)
Seat 7: E-Berta folded before Flop (didn't bet)
Seat 8: andreyzz1964 folded before Flop (didn't bet)
Seat 9: burik23 showed [Js Qc] and won ($1.63) with a full house, Queens full of Sixes



PokerStars Zoom Hand #172697695873:  Hold'em No Limit ($0.01/$0.02) - 2017/07/06 18:54:27 ET
Table 'McNaught' 9-max Seat #1 is the button
Seat 1: Lukstone ($2.02 in chips) 
Seat 2: Gorwfwefwed ($2.03 in chips) 
Seat 3: SSSA204 ($2 in chips) 
Seat 4: KostMalen ($3.54 in chips) 
Seat 5: fling 69 ($1.67 in chips) 
Seat 6: SABA7778 ($1 in chips) 
Seat 7: Redvin33 ($1.89 in chips) 
Seat 8: jip347 ($1.72 in chips) 
Seat 9: Mùúh 22 ($2.55 in chips) 
Gorwfwefwed: posts small blind $0.01
SSSA204: posts big blind $0.02
*** HOLE CARDS ***
Dealt to Redvin33 [5c 7h]
KostMalen: folds 
fling 69: folds 
SABA7778: folds 
Redvin33: folds 
jip347: folds 
Mùúh 22: folds 
Lukstone: folds 
Gorwfwefwed: folds 
Uncalled bet ($0.01) returned to SSSA204
SSSA204 collected $0.02 from pot
SSSA204: doesn't show hand 
*** SUMMARY ***
Total pot $0.02 | Rake $0 
Seat 1: Lukstone (button) folded before Flop (didn't bet)
Seat 2: Gorwfwefwed (small blind) folded before Flop
Seat 3: SSSA204 (big blind) collected ($0.02)
Seat 4: KostMalen folded before Flop (didn't bet)
Seat 5: fling 69 folded before Flop (didn't bet)
Seat 6: SABA7778 folded before Flop (didn't bet)
Seat 7: Redvin33 folded before Flop (didn't bet)
Seat 8: jip347 folded before Flop (didn't bet)
Seat 9: Mùúh 22 folded before Flop (didn't bet)



PokerStars Zoom Hand #172697698401:  Hold'em No Limit ($0.01/$0.02) - 2017/07/06 18:54:31 ET
Table 'McNaught' 9-max Seat #1 is the button
Seat 1: Redvin33 ($1.89 in chips) 
Seat 2: Roman 0992 ($2.51 in chips) 
Seat 3: viagem ($6.07 in chips) 
Seat 4: Ede1wei$$ ($2.71 in chips) 
Seat 5: qualifire ($2 in chips) 
Seat 6: aka_d_trick ($2.10 in chips) 
Seat 7: Bart018 ($3.10 in chips) 
Seat 8: ArgusLL ($2.03 in chips) 
Seat 9: ArthurStk ($1.93 in chips) 
Roman 0992: posts small blind $0.01
viagem: posts big blind $0.02
*** HOLE CARDS ***
Dealt to Redvin33 [4d 7s]
Ede1wei$$: folds 
qualifire: folds 
aka_d_trick: folds 
Bart018: folds 
ArgusLL: folds 
ArthurStk: folds 
Redvin33: folds 
Roman 0992: raises $0.04 to $0.06
viagem: folds 
Uncalled bet ($0.04) returned to Roman 0992
Roman 0992 collected $0.04 from pot
Roman 0992: doesn't show hand 
*** SUMMARY ***
Total pot $0.04 | Rake $0 
Seat 1: Redvin33 (button) folded before Flop (didn't bet)
Seat 2: Roman 0992 (small blind) collected ($0.04)
Seat 3: viagem (big blind) folded before Flop
Seat 4: Ede1wei$$ folded before Flop (didn't bet)
Seat 5: qualifire folded before Flop (didn't bet)
Seat 6: aka_d_trick folded before Flop (didn't bet)
Seat 7: Bart018 folded before Flop (didn't bet)
Seat 8: ArgusLL folded before Flop (didn't bet)
Seat 9: ArthurStk folded before Flop (didn't bet)



PokerStars Zoom Hand #172697701568:  Hold'em No Limit ($0.01/$0.02) - 2017/07/06 18:54:36 ET
Table 'McNaught' 9-max Seat #1 is the button
Seat 1: nerml000 ($2.62 in chips) 
Seat 2: Cayoosh16 ($2.03 in chips) 
Seat 3: SUPERCARLAO ($2.91 in chips) 
Seat 4: lalon22 ($1.79 in chips) 
Seat 5: lokkiannu ($3 in chips) 
Seat 6: panxopolis ($0.97 in chips) 
Seat 7: valera_9696@ ($2.03 in chips) 
Seat 8: dmitrychuk ($1.98 in chips) 
Seat 9: Redvin33 ($1.89 in chips) 
Cayoosh16: posts small blind $0.01
SUPERCARLAO: posts big blind $0.02
*** HOLE CARDS ***
Dealt to Redvin33 [Ks Kd]
lalon22: folds 
lokkiannu: folds 
panxopolis: raises $0.04 to $0.06
valera_9696@: calls $0.06
dmitrychuk: folds 
Redvin33: raises $0.08 to $0.14
nerml000: folds 
Cayoosh16: folds 
SUPERCARLAO: folds 
panxopolis: calls $0.08
valera_9696@: calls $0.08
*** FLOP *** [2s 5h Ad]
panxopolis: checks 
valera_9696@: checks 
Redvin33: bets $0.14
panxopolis: folds 
valera_9696@: folds 
Uncalled bet ($0.14) returned to Redvin33
Redvin33 collected $0.43 from pot
Redvin33: doesn't show hand 
*** SUMMARY ***
Total pot $0.45 | Rake $0.02 
Board [2s 5h Ad]
Seat 1: nerml000 (button) folded before Flop (didn't bet)
Seat 2: Cayoosh16 (small blind) folded before Flop
Seat 3: SUPERCARLAO (big blind) folded before Flop
Seat 4: lalon22 folded before Flop (didn't bet)
Seat 5: lokkiannu folded before Flop (didn't bet)
Seat 6: panxopolis folded on the Flop
Seat 7: valera_9696@ folded on the Flop
Seat 8: dmitrychuk folded before Flop (didn't bet)
Seat 9: Redvin33 collected ($0.43)



PokerStars Zoom Hand #172697731687:  Hold'em No Limit ($0.01/$0.02) - 2017/07/06 18:55:28 ET
Table 'McNaught' 9-max Seat #1 is the button
Seat 1: victordyfox ($0.97 in chips) 
Seat 2: AZAAAAAP ($3.09 in chips) 
Seat 3: D.Shakur ($1.55 in chips) 
Seat 4: Tonymoretz ($1.90 in chips) 
Seat 5: Ede1wei$$ ($4.13 in chips) 
Seat 6: serg197211 ($2.44 in chips) 
Seat 7: Mr.Chipeater ($4.09 in chips) 
Seat 8: Redvin33 ($2.18 in chips) 
Seat 9: japu2010 ($2.67 in chips) 
AZAAAAAP: posts small blind $0.01
D.Shakur: posts big blind $0.02
*** HOLE CARDS ***
Dealt to Redvin33 [Kh 9h]
Tonymoretz: folds 
Ede1wei$$: folds 
serg197211: folds 
Mr.Chipeater: folds 
Redvin33: raises $0.06 to $0.08
japu2010: folds 
victordyfox: folds 
AZAAAAAP: folds 
D.Shakur: folds 
Uncalled bet ($0.06) returned to Redvin33
Redvin33 collected $0.05 from pot
Redvin33: doesn't show hand 
*** SUMMARY ***
Total pot $0.05 | Rake $0 
Seat 1: victordyfox (button) folded before Flop (didn't bet)
Seat 2: AZAAAAAP (small blind) folded before Flop
Seat 3: D.Shakur (big blind) folded before Flop
Seat 4: Tonymoretz folded before Flop (didn't bet)
Seat 5: Ede1wei$$ folded before Flop (didn't bet)
Seat 6: serg197211 folded before Flop (didn't bet)
Seat 7: Mr.Chipeater folded before Flop (didn't bet)
Seat 8: Redvin33 collected ($0.05)
Seat 9: japu2010 folded before Flop (didn't bet)



PokerStars Zoom Hand #172697750080:  Hold'em No Limit ($0.01/$0.02) - 2017/07/06 18:56:03 ET
Table 'McNaught' 9-max Seat #1 is the button
Seat 1: Grigoris1962 ($1.56 in chips) 
Seat 2: COULEUR7 ($2.61 in chips) 
Seat 3: Redvin33 ($2.21 in chips) 
Seat 4: Sympathya ($1.77 in chips) 
Seat 5: C4ekz ($1.99 in chips) 
Seat 6: shige 30 ($1.85 in chips) 
Seat 7: ArgusLL ($2.06 in chips) 
Seat 8: viagem ($8.23 in chips) 
Seat 9: D.Shakur ($1.52 in chips) 
COULEUR7: posts small blind $0.01
Redvin33: posts big blind $0.02
*** HOLE CARDS ***
Dealt to Redvin33 [5c 9s]
Sympathya: folds 
C4ekz: folds 
shige 30: folds 
ArgusLL: folds 
viagem: folds 
D.Shakur: folds 
Grigoris1962: folds 
COULEUR7: folds 
Uncalled bet ($0.01) returned to Redvin33
Redvin33 collected $0.02 from pot
Redvin33: doesn't show hand 
*** SUMMARY ***
Total pot $0.02 | Rake $0 
Seat 1: Grigoris1962 (button) folded before Flop (didn't bet)
Seat 2: COULEUR7 (small blind) folded before Flop
Seat 3: Redvin33 (big blind) collected ($0.02)
Seat 4: Sympathya folded before Flop (didn't bet)
Seat 5: C4ekz folded before Flop (didn't bet)
Seat 6: shige 30 folded before Flop (didn't bet)
Seat 7: ArgusLL folded before Flop (didn't bet)
Seat 8: viagem folded before Flop (didn't bet)
Seat 9: D.Shakur folded before Flop (didn't bet)



PokerStars Zoom Hand #172697744211:  Hold'em No Limit ($0.01/$0.02) - 2017/07/06 18:55:52 ET
Table 'McNaught' 9-max Seat #1 is the button
Seat 1: serg197211 ($2 in chips) 
Seat 2: Mr.Chipeater ($4.09 in chips) 
Seat 3: Robin872 ($3.18 in chips) 
Seat 4: FANYDA ($1.92 in chips) 
Seat 5: Redvin33 ($2.21 in chips) 
Seat 6: stacionar ($2.25 in chips) 
Seat 7: bellamia26 ($5.71 in chips) 
Seat 8: Xamil666 ($6.14 in chips) 
Seat 9: andreyzz1964 ($2.44 in chips) 
Mr.Chipeater: posts small blind $0.01
Robin872: posts big blind $0.02
*** HOLE CARDS ***
Dealt to Redvin33 [6s Ts]
FANYDA: folds 
Redvin33: folds 
stacionar: folds 
bellamia26: folds 
Xamil666: folds 
andreyzz1964: folds 
serg197211: folds 
Mr.Chipeater: folds 
Uncalled bet ($0.01) returned to Robin872
Robin872 collected $0.02 from pot
Robin872: doesn't show hand 
*** SUMMARY ***
Total pot $0.02 | Rake $0 
Seat 1: serg197211 (button) folded before Flop (didn't bet)
Seat 2: Mr.Chipeater (small blind) folded before Flop
Seat 3: Robin872 (big blind) collected ($0.02)
Seat 4: FANYDA folded before Flop (didn't bet)
Seat 5: Redvin33 folded before Flop (didn't bet)
Seat 6: stacionar folded before Flop (didn't bet)
Seat 7: bellamia26 folded before Flop (didn't bet)
Seat 8: Xamil666 folded before Flop (didn't bet)
Seat 9: andreyzz1964 folded before Flop (didn't bet)



PokerStars Zoom Hand #172697754761:  Hold'em No Limit ($0.01/$0.02) - 2017/07/06 18:56:12 ET
Table 'McNaught' 9-max Seat #1 is the button
Seat 1: Redvin33 ($2.22 in chips) 
Seat 2: COULEUR7 ($2 in chips) 
Seat 3: CWellman ($2 in chips) 
Seat 4: MPaz_87 ($2.08 in chips) 
Seat 5: Xasoin ($5.12 in chips) 
Seat 6: nightowl89 ($2.66 in chips) 
Seat 7: Jeka90210 ($1.39 in chips) 
Seat 8: 18062011 ($6.55 in chips) 
Seat 9: marina552 ($1.61 in chips) 
COULEUR7: posts small blind $0.01
CWellman: posts big blind $0.02
*** HOLE CARDS ***
Dealt to Redvin33 [Ah 2c]
MPaz_87: folds 
Xasoin: folds 
nightowl89: folds 
Jeka90210: folds 
18062011: raises $0.06 to $0.08
marina552: folds 
Redvin33: folds 
COULEUR7: folds 
CWellman: calls $0.06
*** FLOP *** [Ks 8h 5c]
CWellman: checks 
18062011: bets $0.10
CWellman: folds 
Uncalled bet ($0.10) returned to 18062011
18062011 collected $0.16 from pot
18062011: doesn't show hand 
*** SUMMARY ***
Total pot $0.17 | Rake $0.01 
Board [Ks 8h 5c]
Seat 1: Redvin33 (button) folded before Flop (didn't bet)
Seat 2: COULEUR7 (small blind) folded before Flop
Seat 3: CWellman (big blind) folded on the Flop
Seat 4: MPaz_87 folded before Flop (didn't bet)
Seat 5: Xasoin folded before Flop (didn't bet)
Seat 6: nightowl89 folded before Flop (didn't bet)
Seat 7: Jeka90210 folded before Flop (didn't bet)
Seat 8: 18062011 collected ($0.16)
Seat 9: marina552 folded before Flop (didn't bet)



PokerStars Zoom Hand #172697760061:  Hold'em No Limit ($0.01/$0.02) - 2017/07/06 18:56:22 ET
Table 'McNaught' 9-max Seat #1 is the button
Seat 1: qualifire ($1.99 in chips) 
Seat 2: Chris Gardne ($1.52 in chips) 
Seat 3: stacionar ($2.25 in chips) 
Seat 4: ShadMrPo ($2.51 in chips) 
Seat 5: colllatinboy ($3.25 in chips) 
Seat 6: Redvin33 ($2.22 in chips) 
Seat 7: ^J0K3RST@RS! ($1.65 in chips) 
Seat 8: ageloc2012 ($1.68 in chips) 
Seat 9: lion.1st ($1.97 in chips) 
Chris Gardne: posts small blind $0.01
stacionar: posts big blind $0.02
*** HOLE CARDS ***
Dealt to Redvin33 [Kd Ad]
ShadMrPo: folds 
colllatinboy: folds 
Redvin33: raises $0.03 to $0.05
^J0K3RST@RS!: folds 
ageloc2012: folds 
lion.1st: folds 
qualifire: folds 
Chris Gardne: folds 
stacionar: folds 
Uncalled bet ($0.03) returned to Redvin33
Redvin33 collected $0.05 from pot
Redvin33: doesn't show hand 
*** SUMMARY ***
Total pot $0.05 | Rake $0 
Seat 1: qualifire (button) folded before Flop (didn't bet)
Seat 2: Chris Gardne (small blind) folded before Flop
Seat 3: stacionar (big blind) folded before Flop
Seat 4: ShadMrPo folded before Flop (didn't bet)
Seat 5: colllatinboy folded before Flop (didn't bet)
Seat 6: Redvin33 collected ($0.05)
Seat 7: ^J0K3RST@RS! folded before Flop (didn't bet)
Seat 8: ageloc2012 folded before Flop (didn't bet)
Seat 9: lion.1st folded before Flop (didn't bet)



