PokerStars Zoom Hand #172845196774:  Hold'em No Limit ($0.01/$0.02) - 2017/07/10 8:32:27 ET
Table 'McNaught' 9-max Seat #1 is the button
Seat 1: BeWorry ($3.13 in chips) 
Seat 2: nikmir34 ($2.83 in chips) 
Seat 3: Redvin33 ($1.60 in chips) 
Seat 4: YOHONSON ($2.01 in chips) 
Seat 5: dumbik89 ($4.35 in chips) 
Seat 6: lexa opana ($1.21 in chips) 
Seat 7: KennYLance ($0.83 in chips) 
Seat 8: squeeer ($1.92 in chips) 
Seat 9: C-class man ($2.30 in chips) 
nikmir34: posts small blind $0.01
Redvin33: posts big blind $0.02
*** HOLE CARDS ***
Dealt to Redvin33 [9c Kd]
YOHONSON: folds 
dumbik89: folds 
lexa opana: folds 
KennYLance: folds 
squeeer: folds 
C-class man: folds 
BeWorry: folds 
nikmir34: raises $0.04 to $0.06
Redvin33: calls $0.04
*** FLOP *** [2s 7s As]
nikmir34: checks 
Redvin33: bets $0.08
nikmir34: calls $0.08
*** TURN *** [2s 7s As] [5d]
nikmir34: checks 
Redvin33: bets $0.10
nikmir34: calls $0.10
*** RIVER *** [2s 7s As 5d] [Th]
nikmir34: checks 
Redvin33: bets $0.14
nikmir34: raises $0.37 to $0.51
Redvin33: folds 
Uncalled bet ($0.37) returned to nikmir34
nikmir34 collected $0.73 from pot
nikmir34: doesn't show hand 
*** SUMMARY ***
Total pot $0.76 | Rake $0.03 
Board [2s 7s As 5d Th]
Seat 1: BeWorry (button) folded before Flop (didn't bet)
Seat 2: nikmir34 (small blind) collected ($0.73)
Seat 3: Redvin33 (big blind) folded on the River
Seat 4: YOHONSON folded before Flop (didn't bet)
Seat 5: dumbik89 folded before Flop (didn't bet)
Seat 6: lexa opana folded before Flop (didn't bet)
Seat 7: KennYLance folded before Flop (didn't bet)
Seat 8: squeeer folded before Flop (didn't bet)
Seat 9: C-class man folded before Flop (didn't bet)



PokerStars Zoom Hand #172845221283:  Hold'em No Limit ($0.01/$0.02) - 2017/07/10 8:33:19 ET
Table 'McNaught' 9-max Seat #1 is the button
Seat 1: Sparco771 ($2.01 in chips) 
Seat 2: teperweb1966 ($1.10 in chips) 
Seat 3: NearLin ($3.59 in chips) 
Seat 4: MaKri11 ($1.79 in chips) 
Seat 5: 157001 ($2.26 in chips) 
Seat 6: Redvin33 ($1.22 in chips) 
Seat 7: Poker in DNA ($2.11 in chips) 
Seat 8: noborder69 ($2.52 in chips) 
Seat 9: raful1 ($1.94 in chips) 
teperweb1966: posts small blind $0.01
NearLin: posts big blind $0.02
*** HOLE CARDS ***
Dealt to Redvin33 [Tc Jc]
MaKri11: folds 
157001: folds 
Redvin33: calls $0.02
Poker in DNA: raises $0.06 to $0.08
noborder69: calls $0.08
raful1: folds 
Sparco771: folds 
teperweb1966: folds 
NearLin: folds 
Redvin33: calls $0.06
*** FLOP *** [2s 6h Qs]
Redvin33: checks 
Poker in DNA: checks 
noborder69: bets $0.13
Redvin33: folds 
Poker in DNA: folds 
Uncalled bet ($0.13) returned to noborder69
noborder69 collected $0.26 from pot
noborder69: doesn't show hand 
*** SUMMARY ***
Total pot $0.27 | Rake $0.01 
Board [2s 6h Qs]
Seat 1: Sparco771 (button) folded before Flop (didn't bet)
Seat 2: teperweb1966 (small blind) folded before Flop
Seat 3: NearLin (big blind) folded before Flop
Seat 4: MaKri11 folded before Flop (didn't bet)
Seat 5: 157001 folded before Flop (didn't bet)
Seat 6: Redvin33 folded on the Flop
Seat 7: Poker in DNA folded on the Flop
Seat 8: noborder69 collected ($0.26)
Seat 9: raful1 folded before Flop (didn't bet)



PokerStars Zoom Hand #172845242395:  Hold'em No Limit ($0.01/$0.02) - 2017/07/10 8:34:04 ET
Table 'McNaught' 9-max Seat #1 is the button
Seat 1: Mizepa ($2.25 in chips) 
Seat 2: Redvin33 ($1.14 in chips) 
Seat 3: OnixLucky ($2.02 in chips) 
Seat 4: ocrimus ($2.79 in chips) 
Seat 5: AleksanderBY ($2.13 in chips) 
Seat 6: Kadorci ($0.48 in chips) 
Seat 7: YOHONSON ($2.58 in chips) 
Seat 8: ggood76 ($2 in chips) 
Seat 9: AlekFM ($2.66 in chips) 
Redvin33: posts small blind $0.01
OnixLucky: posts big blind $0.02
*** HOLE CARDS ***
Dealt to Redvin33 [6c Ac]
ocrimus: folds 
AleksanderBY: folds 
Kadorci: folds 
YOHONSON: folds 
ggood76: folds 
AlekFM: folds 
Mizepa: raises $0.04 to $0.06
Redvin33: raises $0.06 to $0.12
OnixLucky: folds 
Mizepa: folds 
Uncalled bet ($0.06) returned to Redvin33
Redvin33 collected $0.14 from pot
Redvin33: doesn't show hand 
*** SUMMARY ***
Total pot $0.14 | Rake $0 
Seat 1: Mizepa (button) folded before Flop
Seat 2: Redvin33 (small blind) collected ($0.14)
Seat 3: OnixLucky (big blind) folded before Flop
Seat 4: ocrimus folded before Flop (didn't bet)
Seat 5: AleksanderBY folded before Flop (didn't bet)
Seat 6: Kadorci folded before Flop (didn't bet)
Seat 7: YOHONSON folded before Flop (didn't bet)
Seat 8: ggood76 folded before Flop (didn't bet)
Seat 9: AlekFM folded before Flop (didn't bet)



PokerStars Zoom Hand #172845254065:  Hold'em No Limit ($0.01/$0.02) - 2017/07/10 8:34:29 ET
Table 'McNaught' 9-max Seat #1 is the button
Seat 1: omlog ($2.01 in chips) 
Seat 2: noborder69 ($2.56 in chips) 
Seat 3: YOHONSON ($2 in chips) 
Seat 4: zora1449 ($2.04 in chips) 
Seat 5: Panzagoth ($2 in chips) 
Seat 6: kangen333 ($2.12 in chips) 
Seat 7: mig0672 ($2.48 in chips) 
Seat 8: Lu4EV ($2 in chips) 
Seat 9: Redvin33 ($1.22 in chips) 
noborder69: posts small blind $0.01
YOHONSON: posts big blind $0.02
*** HOLE CARDS ***
Dealt to Redvin33 [3c Kd]
zora1449: folds 
Panzagoth: folds 
kangen333: folds 
mig0672: folds 
Lu4EV: folds 
Redvin33: folds 
omlog: folds 
noborder69: folds 
Uncalled bet ($0.01) returned to YOHONSON
YOHONSON collected $0.02 from pot
YOHONSON: doesn't show hand 
*** SUMMARY ***
Total pot $0.02 | Rake $0 
Seat 1: omlog (button) folded before Flop (didn't bet)
Seat 2: noborder69 (small blind) folded before Flop
Seat 3: YOHONSON (big blind) collected ($0.02)
Seat 4: zora1449 folded before Flop (didn't bet)
Seat 5: Panzagoth folded before Flop (didn't bet)
Seat 6: kangen333 folded before Flop (didn't bet)
Seat 7: mig0672 folded before Flop (didn't bet)
Seat 8: Lu4EV folded before Flop (didn't bet)
Seat 9: Redvin33 folded before Flop (didn't bet)



PokerStars Zoom Hand #172845255941:  Hold'em No Limit ($0.01/$0.02) - 2017/07/10 8:34:33 ET
Table 'McNaught' 9-max Seat #1 is the button
Seat 1: Redvin33 ($1.22 in chips) 
Seat 2: DASTALA ($1.31 in chips) 
Seat 3: Rurius ($2 in chips) 
Seat 4: joker169169 ($2.07 in chips) 
Seat 5: winkiAA ($2 in chips) 
Seat 6: Poker in DNA ($2 in chips) 
Seat 7: Sparco771 ($3.62 in chips) 
Seat 8: NearLin ($1.94 in chips) 
Seat 9: Amk252 ($2.06 in chips) 
DASTALA: posts small blind $0.01
Rurius: posts big blind $0.02
*** HOLE CARDS ***
Dealt to Redvin33 [Kc Ks]
joker169169: folds 
winkiAA: folds 
Poker in DNA: folds 
Sparco771: folds 
NearLin: folds 
Amk252: folds 
Redvin33: raises $0.02 to $0.04
DASTALA: folds 
Rurius: calls $0.02
*** FLOP *** [9s Kh 8c]
Rurius: checks 
Redvin33: bets $0.02
Rurius: calls $0.02
*** TURN *** [9s Kh 8c] [Ah]
Rurius: checks 
Redvin33: bets $0.04
Rurius: folds 
Uncalled bet ($0.04) returned to Redvin33
Redvin33 collected $0.13 from pot
Redvin33: doesn't show hand 
*** SUMMARY ***
Total pot $0.13 | Rake $0 
Board [9s Kh 8c Ah]
Seat 1: Redvin33 (button) collected ($0.13)
Seat 2: DASTALA (small blind) folded before Flop
Seat 3: Rurius (big blind) folded on the Turn
Seat 4: joker169169 folded before Flop (didn't bet)
Seat 5: winkiAA folded before Flop (didn't bet)
Seat 6: Poker in DNA folded before Flop (didn't bet)
Seat 7: Sparco771 folded before Flop (didn't bet)
Seat 8: NearLin folded before Flop (didn't bet)
Seat 9: Amk252 folded before Flop (didn't bet)



PokerStars Zoom Hand #172845268153:  Hold'em No Limit ($0.01/$0.02) - 2017/07/10 8:34:59 ET
Table 'McNaught' 9-max Seat #1 is the button
Seat 1: po4ujoem ($2 in chips) 
Seat 2: Kadorci ($0.46 in chips) 
Seat 3: der_bebo ($2.50 in chips) 
Seat 4: ostrograd ($2.81 in chips) 
Seat 5: Mizepa ($1.93 in chips) 
Seat 6: Aves30 ($1.84 in chips) 
Seat 7: ateist177 ($2.76 in chips) 
Seat 8: Redvin33 ($1.29 in chips) 
Seat 9: Burbulacus ($2.26 in chips) 
Kadorci: posts small blind $0.01
der_bebo: posts big blind $0.02
*** HOLE CARDS ***
Dealt to Redvin33 [6d 4s]
ostrograd: folds 
Mizepa: folds 
Aves30: folds 
ateist177: folds 
Redvin33: folds 
Burbulacus: folds 
po4ujoem: folds 
Kadorci: folds 
Uncalled bet ($0.01) returned to der_bebo
der_bebo collected $0.02 from pot
der_bebo: doesn't show hand 
*** SUMMARY ***
Total pot $0.02 | Rake $0 
Seat 1: po4ujoem (button) folded before Flop (didn't bet)
Seat 2: Kadorci (small blind) folded before Flop
Seat 3: der_bebo (big blind) collected ($0.02)
Seat 4: ostrograd folded before Flop (didn't bet)
Seat 5: Mizepa folded before Flop (didn't bet)
Seat 6: Aves30 folded before Flop (didn't bet)
Seat 7: ateist177 folded before Flop (didn't bet)
Seat 8: Redvin33 folded before Flop (didn't bet)
Seat 9: Burbulacus folded before Flop (didn't bet)



PokerStars Zoom Hand #172845270058:  Hold'em No Limit ($0.01/$0.02) - 2017/07/10 8:35:03 ET
Table 'McNaught' 9-max Seat #1 is the button
Seat 1: YOHONSON ($2 in chips) 
Seat 2: noborder69 ($2 in chips) 
Seat 3: Azazell0666 ($2.66 in chips) 
Seat 4: Antovka ($2 in chips) 
Seat 5: Burbulacus ($2 in chips) 
Seat 6: Beatsteak123 ($2.97 in chips) 
Seat 7: Redvin33 ($1.29 in chips) 
Seat 8: x@t@bich ($2.97 in chips) 
Seat 9: MaKri11 ($2.01 in chips) 
noborder69: posts small blind $0.01
Azazell0666: posts big blind $0.02
*** HOLE CARDS ***
Dealt to Redvin33 [As 5s]
Antovka: raises $0.04 to $0.06
Burbulacus: folds 
Beatsteak123: folds 
Redvin33: calls $0.06
x@t@bich: folds 
MaKri11: calls $0.06
YOHONSON: folds 
noborder69: folds 
Azazell0666: folds 
*** FLOP *** [Th Kh 7s]
Antovka: checks 
Redvin33: checks 
MaKri11: checks 
*** TURN *** [Th Kh 7s] [7h]
Antovka: checks 
Redvin33: bets $0.08
MaKri11: folds 
Antovka: folds 
Uncalled bet ($0.08) returned to Redvin33
Redvin33 collected $0.20 from pot
Redvin33: doesn't show hand 
*** SUMMARY ***
Total pot $0.21 | Rake $0.01 
Board [Th Kh 7s 7h]
Seat 1: YOHONSON (button) folded before Flop (didn't bet)
Seat 2: noborder69 (small blind) folded before Flop
Seat 3: Azazell0666 (big blind) folded before Flop
Seat 4: Antovka folded on the Turn
Seat 5: Burbulacus folded before Flop (didn't bet)
Seat 6: Beatsteak123 folded before Flop (didn't bet)
Seat 7: Redvin33 collected ($0.20)
Seat 8: x@t@bich folded before Flop (didn't bet)
Seat 9: MaKri11 folded on the Turn



PokerStars Zoom Hand #172845284108:  Hold'em No Limit ($0.01/$0.02) - 2017/07/10 8:35:33 ET
Table 'McNaught' 9-max Seat #1 is the button
Seat 1: patriot557 ($7.43 in chips) 
Seat 2: nikmir34 ($1.59 in chips) 
Seat 3: Azazell0666 ($3.57 in chips) 
Seat 4: Poker in DNA ($3.92 in chips) 
Seat 5: AleksanderBY ($2.20 in chips) 
Seat 6: Méry66 ($2.16 in chips) 
Seat 7: svetik_bbbb ($1.02 in chips) 
Seat 8: Redvin33 ($1.43 in chips) 
Seat 9: squeeer ($2.87 in chips) 
nikmir34: posts small blind $0.01
Azazell0666: posts big blind $0.02
*** HOLE CARDS ***
Dealt to Redvin33 [7d Tc]
Poker in DNA: folds 
AleksanderBY: folds 
Méry66: folds 
svetik_bbbb: folds 
Redvin33: folds 
squeeer: folds 
patriot557: folds 
nikmir34: folds 
Uncalled bet ($0.01) returned to Azazell0666
Azazell0666 collected $0.02 from pot
Azazell0666: doesn't show hand 
*** SUMMARY ***
Total pot $0.02 | Rake $0 
Seat 1: patriot557 (button) folded before Flop (didn't bet)
Seat 2: nikmir34 (small blind) folded before Flop
Seat 3: Azazell0666 (big blind) collected ($0.02)
Seat 4: Poker in DNA folded before Flop (didn't bet)
Seat 5: AleksanderBY folded before Flop (didn't bet)
Seat 6: Méry66 folded before Flop (didn't bet)
Seat 7: svetik_bbbb folded before Flop (didn't bet)
Seat 8: Redvin33 folded before Flop (didn't bet)
Seat 9: squeeer folded before Flop (didn't bet)



PokerStars Zoom Hand #172845286398:  Hold'em No Limit ($0.01/$0.02) - 2017/07/10 8:35:38 ET
Table 'McNaught' 9-max Seat #1 is the button
Seat 1: Mùúh 22 ($3.69 in chips) 
Seat 2: Poker in DNA ($3.92 in chips) 
Seat 3: neiroob 55 ($0.93 in chips) 
Seat 4: Amk252 ($2.59 in chips) 
Seat 5: Redvin33 ($1.43 in chips) 
Seat 6: YOHONSON ($2 in chips) 
Seat 7: Beatsteak123 ($4.32 in chips) 
Seat 8: ALEKS 1839 ($2.07 in chips) 
Seat 9: bilimb ($1.52 in chips) 
Poker in DNA: posts small blind $0.01
neiroob 55: posts big blind $0.02
*** HOLE CARDS ***
Dealt to Redvin33 [Ts 8h]
Amk252: folds 
Redvin33: folds 
YOHONSON: folds 
Beatsteak123: raises $0.04 to $0.06
ALEKS 1839: raises $2.01 to $2.07 and is all-in
bilimb: folds 
Mùúh 22: folds 
Poker in DNA: folds 
neiroob 55: folds 
Beatsteak123: folds 
Uncalled bet ($2.01) returned to ALEKS 1839
ALEKS 1839 collected $0.15 from pot
ALEKS 1839: doesn't show hand 
*** SUMMARY ***
Total pot $0.15 | Rake $0 
Seat 1: Mùúh 22 (button) folded before Flop (didn't bet)
Seat 2: Poker in DNA (small blind) folded before Flop
Seat 3: neiroob 55 (big blind) folded before Flop
Seat 4: Amk252 folded before Flop (didn't bet)
Seat 5: Redvin33 folded before Flop (didn't bet)
Seat 6: YOHONSON folded before Flop (didn't bet)
Seat 7: Beatsteak123 folded before Flop
Seat 8: ALEKS 1839 collected ($0.15)
Seat 9: bilimb folded before Flop (didn't bet)



PokerStars Zoom Hand #172845288247:  Hold'em No Limit ($0.01/$0.02) - 2017/07/10 8:35:42 ET
Table 'McNaught' 9-max Seat #1 is the button
Seat 1: leha197555 ($1.47 in chips) 
Seat 2: YOHONSON ($2.01 in chips) 
Seat 3: Rurius ($2 in chips) 
Seat 4: dumbik89 ($4.22 in chips) 
Seat 5: livingod00p ($2.22 in chips) 
Seat 6: serking.ds ($1.07 in chips) 
Seat 7: Redvin33 ($1.43 in chips) 
Seat 8: kangen333 ($2.09 in chips) 
Seat 9: Gelovek ($2.04 in chips) 
YOHONSON: posts small blind $0.01
Rurius: posts big blind $0.02
*** HOLE CARDS ***
Dealt to Redvin33 [As Js]
dumbik89: folds 
livingod00p: folds 
serking.ds: folds 
Redvin33: raises $0.03 to $0.05
kangen333: calls $0.05
Gelovek: folds 
leha197555: folds 
YOHONSON: calls $0.04
Rurius: folds 
*** FLOP *** [3s 4c 9s]
YOHONSON: bets $0.12
Redvin33: calls $0.12
kangen333: folds 
*** TURN *** [3s 4c 9s] [7s]
YOHONSON: checks 
Redvin33: bets $0.08
YOHONSON: calls $0.08
*** RIVER *** [3s 4c 9s 7s] [Jh]
YOHONSON: checks 
Redvin33: bets $0.18
YOHONSON: calls $0.18
*** SHOW DOWN ***
Redvin33: shows [As Js] (a flush, Ace high)
YOHONSON: mucks hand 
Redvin33 collected $0.90 from pot
*** SUMMARY ***
Total pot $0.93 | Rake $0.03 
Board [3s 4c 9s 7s Jh]
Seat 1: leha197555 (button) folded before Flop (didn't bet)
Seat 2: YOHONSON (small blind) mucked [9c Ad]
Seat 3: Rurius (big blind) folded before Flop
Seat 4: dumbik89 folded before Flop (didn't bet)
Seat 5: livingod00p folded before Flop (didn't bet)
Seat 6: serking.ds folded before Flop (didn't bet)
Seat 7: Redvin33 showed [As Js] and won ($0.90) with a flush, Ace high
Seat 8: kangen333 folded on the Flop
Seat 9: Gelovek folded before Flop (didn't bet)



PokerStars Zoom Hand #172845318948:  Hold'em No Limit ($0.01/$0.02) - 2017/07/10 8:36:47 ET
Table 'McNaught' 9-max Seat #1 is the button
Seat 1: nezaratustra ($1.53 in chips) 
Seat 2: ppoker_fac3 ($2.01 in chips) 
Seat 3: Redvin33 ($1.90 in chips) 
Seat 4: DASTALA ($1.20 in chips) 
Seat 5: winkiAA ($2 in chips) 
Seat 6: YOHONSON ($2 in chips) 
Seat 7: bubufish91 ($3.07 in chips) 
Seat 8: mr.cuslya ($10.61 in chips) 
Seat 9: DenBoss77 ($2 in chips) 
ppoker_fac3: posts small blind $0.01
Redvin33: posts big blind $0.02
*** HOLE CARDS ***
Dealt to Redvin33 [3d Td]
DASTALA: folds 
winkiAA: folds 
YOHONSON: raises $0.03 to $0.05
bubufish91: folds 
mr.cuslya: calls $0.05
DenBoss77: folds 
nezaratustra: folds 
ppoker_fac3: folds 
Redvin33: folds 
*** FLOP *** [Jc 7s Qc]
YOHONSON: bets $0.09
mr.cuslya: calls $0.09
*** TURN *** [Jc 7s Qc] [Qh]
YOHONSON: bets $0.22
mr.cuslya: calls $0.22
*** RIVER *** [Jc 7s Qc Qh] [Th]
YOHONSON: bets $0.40
mr.cuslya: folds 
Uncalled bet ($0.40) returned to YOHONSON
YOHONSON collected $0.72 from pot
YOHONSON: doesn't show hand 
*** SUMMARY ***
Total pot $0.75 | Rake $0.03 
Board [Jc 7s Qc Qh Th]
Seat 1: nezaratustra (button) folded before Flop (didn't bet)
Seat 2: ppoker_fac3 (small blind) folded before Flop
Seat 3: Redvin33 (big blind) folded before Flop
Seat 4: DASTALA folded before Flop (didn't bet)
Seat 5: winkiAA folded before Flop (didn't bet)
Seat 6: YOHONSON collected ($0.72)
Seat 7: bubufish91 folded before Flop (didn't bet)
Seat 8: mr.cuslya folded on the River
Seat 9: DenBoss77 folded before Flop (didn't bet)



PokerStars Zoom Hand #172845324633:  Hold'em No Limit ($0.01/$0.02) - 2017/07/10 8:36:59 ET
Table 'McNaught' 9-max Seat #1 is the button
Seat 1: BraveGirl ($0.86 in chips) 
Seat 2: Redvin33 ($1.88 in chips) 
Seat 3: x@t@bich ($6.40 in chips) 
Seat 4: livingod00p ($1.58 in chips) 
Seat 5: patriot557 ($7.37 in chips) 
Seat 6: ericvanmoor ($1.47 in chips) 
Seat 7: fedosov_ivan ($2.03 in chips) 
Seat 8: DIMKA1488228 ($3.23 in chips) 
Seat 9: TheFr1Day ($2.09 in chips) 
Redvin33: posts small blind $0.01
x@t@bich: posts big blind $0.02
*** HOLE CARDS ***
Dealt to Redvin33 [Jd Qd]
livingod00p: folds 
patriot557: raises $0.04 to $0.06
ericvanmoor: folds 
fedosov_ivan: folds 
DIMKA1488228: folds 
TheFr1Day: folds 
BraveGirl: calls $0.06
Redvin33: calls $0.05
x@t@bich: folds 
*** FLOP *** [7s 5d Kh]
Redvin33: checks 
patriot557: bets $0.10
BraveGirl: folds 
Redvin33: folds 
Uncalled bet ($0.10) returned to patriot557
patriot557 collected $0.19 from pot
patriot557: doesn't show hand 
*** SUMMARY ***
Total pot $0.20 | Rake $0.01 
Board [7s 5d Kh]
Seat 1: BraveGirl (button) folded on the Flop
Seat 2: Redvin33 (small blind) folded on the Flop
Seat 3: x@t@bich (big blind) folded before Flop
Seat 4: livingod00p folded before Flop (didn't bet)
Seat 5: patriot557 collected ($0.19)
Seat 6: ericvanmoor folded before Flop (didn't bet)
Seat 7: fedosov_ivan folded before Flop (didn't bet)
Seat 8: DIMKA1488228 folded before Flop (didn't bet)
Seat 9: TheFr1Day folded before Flop (didn't bet)



PokerStars Zoom Hand #172845346135:  Hold'em No Limit ($0.01/$0.02) - 2017/07/10 8:37:45 ET
Table 'McNaught' 9-max Seat #1 is the button
Seat 1: Redvin33 ($1.82 in chips) 
Seat 2: 222bizon444 ($0.61 in chips) 
Seat 3: Lu4EV ($1.83 in chips) 
Seat 4: lexa opana ($0.69 in chips) 
Seat 5: Méry66 ($2.47 in chips) 
Seat 6: Lionvodoo ($2.03 in chips) 
Seat 7: dorro61966 ($1.76 in chips) 
Seat 8: aleekseenko ($0.79 in chips) 
Seat 9: ggood76 ($2.27 in chips) 
222bizon444: posts small blind $0.01
Lu4EV: posts big blind $0.02
*** HOLE CARDS ***
Dealt to Redvin33 [9c Th]
lexa opana: folds 
Méry66: calls $0.02
Lionvodoo: folds 
dorro61966: folds 
aleekseenko: folds 
ggood76: folds 
Redvin33: raises $0.04 to $0.06
222bizon444: calls $0.05
Lu4EV: folds 
Méry66: calls $0.04
*** FLOP *** [4h Ts 8d]
222bizon444: bets $0.55 and is all-in
Méry66: folds 
Redvin33: calls $0.55
*** TURN *** [4h Ts 8d] [Kh]
*** RIVER *** [4h Ts 8d Kh] [Kd]
*** SHOW DOWN ***
222bizon444: shows [8h Ac] (two pair, Kings and Eights)
Redvin33: shows [9c Th] (two pair, Kings and Tens)
Redvin33 collected $1.25 from pot
*** SUMMARY ***
Total pot $1.30 | Rake $0.05 
Board [4h Ts 8d Kh Kd]
Seat 1: Redvin33 (button) showed [9c Th] and won ($1.25) with two pair, Kings and Tens
Seat 2: 222bizon444 (small blind) showed [8h Ac] and lost with two pair, Kings and Eights
Seat 3: Lu4EV (big blind) folded before Flop
Seat 4: lexa opana folded before Flop (didn't bet)
Seat 5: Méry66 folded on the Flop
Seat 6: Lionvodoo folded before Flop (didn't bet)
Seat 7: dorro61966 folded before Flop (didn't bet)
Seat 8: aleekseenko folded before Flop (didn't bet)
Seat 9: ggood76 folded before Flop (didn't bet)



PokerStars Zoom Hand #172845340066:  Hold'em No Limit ($0.01/$0.02) - 2017/07/10 8:37:32 ET
Table 'McNaught' 9-max Seat #1 is the button
Seat 1: fedosov_ivan ($2 in chips) 
Seat 2: Danil548 ($1.98 in chips) 
Seat 3: ALEKS 1839 ($2 in chips) 
Seat 4: NearLin ($2.43 in chips) 
Seat 5: AST@r85 ($6.33 in chips) 
Seat 6: Bushika7 ($7.58 in chips) 
Seat 7: Mr.Red[404] ($2.07 in chips) 
Seat 8: DIMKA1488228 ($2.73 in chips) 
Seat 9: Redvin33 ($1.82 in chips) 
Danil548: posts small blind $0.01
ALEKS 1839: posts big blind $0.02
*** HOLE CARDS ***
Dealt to Redvin33 [Th Ks]
NearLin: folds 
AST@r85: folds 
Bushika7: raises $0.04 to $0.06
Mr.Red[404]: folds 
DIMKA1488228: calls $0.06
Redvin33: folds 
fedosov_ivan: folds 
Danil548: folds 
ALEKS 1839: folds 
*** FLOP *** [Js As Ah]
Bushika7: checks 
DIMKA1488228: bets $0.08
Bushika7: calls $0.08
*** TURN *** [Js As Ah] [6s]
Bushika7: bets $0.20
DIMKA1488228: folds 
Uncalled bet ($0.20) returned to Bushika7
Bushika7 collected $0.30 from pot
Bushika7: doesn't show hand 
*** SUMMARY ***
Total pot $0.31 | Rake $0.01 
Board [Js As Ah 6s]
Seat 1: fedosov_ivan (button) folded before Flop (didn't bet)
Seat 2: Danil548 (small blind) folded before Flop
Seat 3: ALEKS 1839 (big blind) folded before Flop
Seat 4: NearLin folded before Flop (didn't bet)
Seat 5: AST@r85 folded before Flop (didn't bet)
Seat 6: Bushika7 collected ($0.30)
Seat 7: Mr.Red[404] folded before Flop (didn't bet)
Seat 8: DIMKA1488228 folded on the Turn
Seat 9: Redvin33 folded before Flop (didn't bet)



PokerStars Zoom Hand #172845344232:  Hold'em No Limit ($0.01/$0.02) - 2017/07/10 8:37:41 ET
Table 'McNaught' 9-max Seat #1 is the button
Seat 1: Lionvodoo ($2.17 in chips) 
Seat 2: dragonlot ($2.29 in chips) 
Seat 3: serking.ds ($1.32 in chips) 
Seat 4: aleekseenko ($0.79 in chips) 
Seat 5: Redvin33 ($1.82 in chips) 
Seat 6: Mùúh 22 ($3.99 in chips) 
Seat 7: YOHONSON ($2.36 in chips) 
Seat 8: Fifflaren923 ($3.50 in chips) 
Seat 9: amarlean ($2.28 in chips) 
dragonlot: posts small blind $0.01
serking.ds: posts big blind $0.02
*** HOLE CARDS ***
Dealt to Redvin33 [Tc 5s]
aleekseenko: folds 
Redvin33: folds 
Mùúh 22: folds 
YOHONSON: folds 
Fifflaren923: raises $0.04 to $0.06
amarlean: folds 
Lionvodoo: folds 
dragonlot: folds 
serking.ds: raises $1.26 to $1.32 and is all-in
Fifflaren923: folds 
Uncalled bet ($1.26) returned to serking.ds
serking.ds collected $0.13 from pot
serking.ds: doesn't show hand 
*** SUMMARY ***
Total pot $0.13 | Rake $0 
Seat 1: Lionvodoo (button) folded before Flop (didn't bet)
Seat 2: dragonlot (small blind) folded before Flop
Seat 3: serking.ds (big blind) collected ($0.13)
Seat 4: aleekseenko folded before Flop (didn't bet)
Seat 5: Redvin33 folded before Flop (didn't bet)
Seat 6: Mùúh 22 folded before Flop (didn't bet)
Seat 7: YOHONSON folded before Flop (didn't bet)
Seat 8: Fifflaren923 folded before Flop
Seat 9: amarlean folded before Flop (didn't bet)



PokerStars Zoom Hand #172845357783:  Hold'em No Limit ($0.01/$0.02) - 2017/07/10 8:38:10 ET
Table 'McNaught' 9-max Seat #1 is the button
Seat 1: fedosov_ivan ($2.03 in chips) 
Seat 2: yuu0914 ($2 in chips) 
Seat 3: squeeer ($1.70 in chips) 
Seat 4: zen approach ($4.55 in chips) 
Seat 5: kolobok895 ($1.62 in chips) 
Seat 6: Redvin33 ($2.46 in chips) 
Seat 7: thetrumper77 ($1.99 in chips) 
Seat 8: TKoniWolf ($2 in chips) 
Seat 9: YOHONSON ($2.17 in chips) 
yuu0914: posts small blind $0.01
squeeer: posts big blind $0.02
*** HOLE CARDS ***
Dealt to Redvin33 [6d 2d]
zen approach: folds 
kolobok895: folds 
Redvin33: folds 
thetrumper77: folds 
TKoniWolf: folds 
YOHONSON: folds 
fedosov_ivan: raises $0.04 to $0.06
yuu0914: folds 
squeeer: folds 
Uncalled bet ($0.04) returned to fedosov_ivan
fedosov_ivan collected $0.05 from pot
fedosov_ivan: doesn't show hand 
*** SUMMARY ***
Total pot $0.05 | Rake $0 
Seat 1: fedosov_ivan (button) collected ($0.05)
Seat 2: yuu0914 (small blind) folded before Flop
Seat 3: squeeer (big blind) folded before Flop
Seat 4: zen approach folded before Flop (didn't bet)
Seat 5: kolobok895 folded before Flop (didn't bet)
Seat 6: Redvin33 folded before Flop (didn't bet)
Seat 7: thetrumper77 folded before Flop (didn't bet)
Seat 8: TKoniWolf folded before Flop (didn't bet)
Seat 9: YOHONSON folded before Flop (didn't bet)



PokerStars Zoom Hand #172845359676:  Hold'em No Limit ($0.01/$0.02) - 2017/07/10 8:38:14 ET
Table 'McNaught' 9-max Seat #1 is the button
Seat 1: Aves30 ($1.94 in chips) 
Seat 2: cardshaper77 ($2.29 in chips) 
Seat 3: dblthnkr ($2.40 in chips) 
Seat 4: amarlean ($2.24 in chips) 
Seat 5: AleksanderBY ($2 in chips) 
Seat 6: leha197555 ($1.63 in chips) 
Seat 7: Redvin33 ($2.46 in chips) 
Seat 8: Pet2403 ($2 in chips) 
Seat 9: NearLin ($2.40 in chips) 
cardshaper77: posts small blind $0.01
dblthnkr: posts big blind $0.02
*** HOLE CARDS ***
Dealt to Redvin33 [Tc Kh]
amarlean: folds 
AleksanderBY: folds 
leha197555: folds 
Redvin33: raises $0.03 to $0.05
Pet2403: folds 
NearLin: folds 
Aves30: raises $0.13 to $0.18
cardshaper77: folds 
dblthnkr: folds 
Redvin33: folds 
Uncalled bet ($0.13) returned to Aves30
Aves30 collected $0.13 from pot
Aves30: doesn't show hand 
*** SUMMARY ***
Total pot $0.13 | Rake $0 
Seat 1: Aves30 (button) collected ($0.13)
Seat 2: cardshaper77 (small blind) folded before Flop
Seat 3: dblthnkr (big blind) folded before Flop
Seat 4: amarlean folded before Flop (didn't bet)
Seat 5: AleksanderBY folded before Flop (didn't bet)
Seat 6: leha197555 folded before Flop (didn't bet)
Seat 7: Redvin33 folded before Flop
Seat 8: Pet2403 folded before Flop (didn't bet)
Seat 9: NearLin folded before Flop (didn't bet)



PokerStars Zoom Hand #172845371896:  Hold'em No Limit ($0.01/$0.02) - 2017/07/10 8:38:40 ET
Table 'McNaught' 9-max Seat #1 is the button
Seat 1: Rurius ($2.39 in chips) 
Seat 2: RmbJN90 ($1.98 in chips) 
Seat 3: BeWorry ($3.72 in chips) 
Seat 4: Redvin33 ($2.41 in chips) 
Seat 5: mig0672 ($2.61 in chips) 
Seat 6: Mr.Red[404] ($2.05 in chips) 
Seat 7: gelik32 ($2.27 in chips) 
Seat 8: ateist177 ($1.14 in chips) 
Seat 9: omlog ($2 in chips) 
RmbJN90: posts small blind $0.01
BeWorry: posts big blind $0.02
*** HOLE CARDS ***
Dealt to Redvin33 [Jc 9s]
Redvin33: folds 
mig0672: folds 
Mr.Red[404]: folds 
gelik32: folds 
ateist177: folds 
omlog: raises $0.03 to $0.05
Rurius: folds 
RmbJN90: folds 
BeWorry: folds 
Uncalled bet ($0.03) returned to omlog
omlog collected $0.05 from pot
omlog: doesn't show hand 
*** SUMMARY ***
Total pot $0.05 | Rake $0 
Seat 1: Rurius (button) folded before Flop (didn't bet)
Seat 2: RmbJN90 (small blind) folded before Flop
Seat 3: BeWorry (big blind) folded before Flop
Seat 4: Redvin33 folded before Flop (didn't bet)
Seat 5: mig0672 folded before Flop (didn't bet)
Seat 6: Mr.Red[404] folded before Flop (didn't bet)
Seat 7: gelik32 folded before Flop (didn't bet)
Seat 8: ateist177 folded before Flop (didn't bet)
Seat 9: omlog collected ($0.05)



PokerStars Zoom Hand #172845373710:  Hold'em No Limit ($0.01/$0.02) - 2017/07/10 8:38:44 ET
Table 'McNaught' 9-max Seat #1 is the button
Seat 1: Fifflaren923 ($3.72 in chips) 
Seat 2: dragonlot ($2.47 in chips) 
Seat 3: Redvin33 ($2.41 in chips) 
Seat 4: ClailtonA. ($2.11 in chips) 
Seat 5: godlikelo ($4.15 in chips) 
Seat 6: playpoker872 ($2.74 in chips) 
Seat 7: ppoker_fac3 ($2.88 in chips) 
Seat 8: ALEKS 1839 ($1.93 in chips) 
Seat 9: Méry66 ($2.37 in chips) 
dragonlot: posts small blind $0.01
Redvin33: posts big blind $0.02
*** HOLE CARDS ***
Dealt to Redvin33 [7d Th]
ClailtonA.: folds 
godlikelo: folds 
playpoker872: folds 
ppoker_fac3: folds 
ALEKS 1839: folds 
Méry66: folds 
Fifflaren923: folds 
dragonlot: folds 
Uncalled bet ($0.01) returned to Redvin33
Redvin33 collected $0.02 from pot
Redvin33: doesn't show hand 
*** SUMMARY ***
Total pot $0.02 | Rake $0 
Seat 1: Fifflaren923 (button) folded before Flop (didn't bet)
Seat 2: dragonlot (small blind) folded before Flop
Seat 3: Redvin33 (big blind) collected ($0.02)
Seat 4: ClailtonA. folded before Flop (didn't bet)
Seat 5: godlikelo folded before Flop (didn't bet)
Seat 6: playpoker872 folded before Flop (didn't bet)
Seat 7: ppoker_fac3 folded before Flop (didn't bet)
Seat 8: ALEKS 1839 folded before Flop (didn't bet)
Seat 9: Méry66 folded before Flop (didn't bet)



PokerStars Zoom Hand #172845370042:  Hold'em No Limit ($0.01/$0.02) - 2017/07/10 8:38:36 ET
Table 'McNaught' 9-max Seat #1 is the button
Seat 1: Lu4EV ($1.97 in chips) 
Seat 2: OnixLucky ($1.76 in chips) 
Seat 3: aleks_ply ($2.74 in chips) 
Seat 4: 45GARPUN45 ($4.16 in chips) 
Seat 5: Redvin33 ($2.41 in chips) 
Seat 6: Sparco771 ($2.02 in chips) 
Seat 7: ALEKS 1839 ($1.93 in chips) 
Seat 8: DenBoss77 ($2 in chips) 
Seat 9: AST@r85 ($6.39 in chips) 
OnixLucky: posts small blind $0.01
aleks_ply: posts big blind $0.02
*** HOLE CARDS ***
Dealt to Redvin33 [8d Qh]
45GARPUN45: folds 
Redvin33: folds 
Sparco771: folds 
ALEKS 1839: folds 
DenBoss77: folds 
AST@r85: raises $0.05 to $0.07
Lu4EV: folds 
OnixLucky: folds 
aleks_ply: folds 
Uncalled bet ($0.05) returned to AST@r85
AST@r85 collected $0.05 from pot
AST@r85: doesn't show hand 
*** SUMMARY ***
Total pot $0.05 | Rake $0 
Seat 1: Lu4EV (button) folded before Flop (didn't bet)
Seat 2: OnixLucky (small blind) folded before Flop
Seat 3: aleks_ply (big blind) folded before Flop
Seat 4: 45GARPUN45 folded before Flop (didn't bet)
Seat 5: Redvin33 folded before Flop (didn't bet)
Seat 6: Sparco771 folded before Flop (didn't bet)
Seat 7: ALEKS 1839 folded before Flop (didn't bet)
Seat 8: DenBoss77 folded before Flop (didn't bet)
Seat 9: AST@r85 collected ($0.05)



PokerStars Zoom Hand #172845383036:  Hold'em No Limit ($0.01/$0.02) - 2017/07/10 8:39:04 ET
Table 'McNaught' 9-max Seat #1 is the button
Seat 1: wander 121 ($0.19 in chips) 
Seat 2: gjkbyf ($1.06 in chips) 
Seat 3: zora1449 ($2.01 in chips) 
Seat 4: unlea5h ($2.16 in chips) 
Seat 5: Lionvodoo ($2.73 in chips) 
Seat 6: livingod00p ($3.01 in chips) 
Seat 7: AST@r85 ($6.42 in chips) 
Seat 8: Redvin33 ($2.41 in chips) 
Seat 9: Fifflaren923 ($3.44 in chips) 
gjkbyf: posts small blind $0.01
zora1449: posts big blind $0.02
*** HOLE CARDS ***
Dealt to Redvin33 [7d 2s]
unlea5h: folds 
Lionvodoo: folds 
livingod00p: folds 
AST@r85: folds 
Redvin33: folds 
Fifflaren923: folds 
wander 121: folds 
gjkbyf: folds 
Uncalled bet ($0.01) returned to zora1449
zora1449 collected $0.02 from pot
zora1449: doesn't show hand 
*** SUMMARY ***
Total pot $0.02 | Rake $0 
Seat 1: wander 121 (button) folded before Flop (didn't bet)
Seat 2: gjkbyf (small blind) folded before Flop
Seat 3: zora1449 (big blind) collected ($0.02)
Seat 4: unlea5h folded before Flop (didn't bet)
Seat 5: Lionvodoo folded before Flop (didn't bet)
Seat 6: livingod00p folded before Flop (didn't bet)
Seat 7: AST@r85 folded before Flop (didn't bet)
Seat 8: Redvin33 folded before Flop (didn't bet)
Seat 9: Fifflaren923 folded before Flop (didn't bet)



PokerStars Zoom Hand #172845384871:  Hold'em No Limit ($0.01/$0.02) - 2017/07/10 8:39:08 ET
Table 'McNaught' 9-max Seat #1 is the button
Seat 1: Redvin33 ($2.41 in chips) 
Seat 2: winkiAA ($3.09 in chips) 
Seat 3: unlea5h ($2.16 in chips) 
Seat 4: Beatsteak123 ($4.26 in chips) 
Seat 5: Kolya813 ($2 in chips) 
Seat 6: DenBoss77 ($2.51 in chips) 
Seat 7: YAAJ7 ($1.56 in chips) 
Seat 8: Fifflaren923 ($3.44 in chips) 
Seat 9: Burbulacus ($2.07 in chips) 
winkiAA: posts small blind $0.01
unlea5h: posts big blind $0.02
*** HOLE CARDS ***
Dealt to Redvin33 [3h 8c]
Beatsteak123: folds 
Kolya813: folds 
DenBoss77: folds 
YAAJ7: folds 
Fifflaren923: folds 
Burbulacus: folds 
Redvin33: folds 
winkiAA: folds 
Uncalled bet ($0.01) returned to unlea5h
unlea5h collected $0.02 from pot
unlea5h: doesn't show hand 
*** SUMMARY ***
Total pot $0.02 | Rake $0 
Seat 1: Redvin33 (button) folded before Flop (didn't bet)
Seat 2: winkiAA (small blind) folded before Flop
Seat 3: unlea5h (big blind) collected ($0.02)
Seat 4: Beatsteak123 folded before Flop (didn't bet)
Seat 5: Kolya813 folded before Flop (didn't bet)
Seat 6: DenBoss77 folded before Flop (didn't bet)
Seat 7: YAAJ7 folded before Flop (didn't bet)
Seat 8: Fifflaren923 folded before Flop (didn't bet)
Seat 9: Burbulacus folded before Flop (didn't bet)



PokerStars Zoom Hand #172845386758:  Hold'em No Limit ($0.01/$0.02) - 2017/07/10 8:39:12 ET
Table 'McNaught' 9-max Seat #1 is the button
Seat 1: kangen333 ($2 in chips) 
Seat 2: Fixitys ($1.59 in chips) 
Seat 3: Beatsteak123 ($4.26 in chips) 
Seat 4: P.Phantoms ($0.68 in chips) 
Seat 5: smopuim ($2.60 in chips) 
Seat 6: winkiAA ($2 in chips) 
Seat 7: Litwack ($2.20 in chips) 
Seat 8: dblthnkr ($2.52 in chips) 
Seat 9: Redvin33 ($2.41 in chips) 
Fixitys: posts small blind $0.01
Beatsteak123: posts big blind $0.02
*** HOLE CARDS ***
Dealt to Redvin33 [2c Jh]
P.Phantoms: folds 
smopuim: folds 
winkiAA: folds 
Litwack: folds 
dblthnkr has timed out
dblthnkr: folds 
Redvin33: folds 
kangen333: folds 
Fixitys: folds 
Uncalled bet ($0.01) returned to Beatsteak123
Beatsteak123 collected $0.02 from pot
Beatsteak123: doesn't show hand 
*** SUMMARY ***
Total pot $0.02 | Rake $0 
Seat 1: kangen333 (button) folded before Flop (didn't bet)
Seat 2: Fixitys (small blind) folded before Flop
Seat 3: Beatsteak123 (big blind) collected ($0.02)
Seat 4: P.Phantoms folded before Flop (didn't bet)
Seat 5: smopuim folded before Flop (didn't bet)
Seat 6: winkiAA folded before Flop (didn't bet)
Seat 7: Litwack folded before Flop (didn't bet)
Seat 8: dblthnkr folded before Flop (didn't bet)
Seat 9: Redvin33 folded before Flop (didn't bet)



PokerStars Zoom Hand #172845379289:  Hold'em No Limit ($0.01/$0.02) - 2017/07/10 8:38:56 ET
Table 'McNaught' 9-max Seat #1 is the button
Seat 1: DenBoss77 ($2.51 in chips) 
Seat 2: Redvin33 ($2.42 in chips) 
Seat 3: slavok7777 ($0.87 in chips) 
Seat 4: unlea5h ($2.16 in chips) 
Seat 5: godlikelo ($3.21 in chips) 
Seat 6: Guruy ($5.42 in chips) 
Seat 7: Quorthon_Zei ($3.16 in chips) 
Seat 8: JeckTen ($2 in chips) 
Seat 9: bilimb ($1.38 in chips) 
Redvin33: posts small blind $0.01
slavok7777: posts big blind $0.02
*** HOLE CARDS ***
Dealt to Redvin33 [9d 8h]
unlea5h: folds 
godlikelo: folds 
Guruy: raises $0.04 to $0.06
Quorthon_Zei: folds 
JeckTen: calls $0.06
bilimb: folds 
DenBoss77: folds 
Redvin33: folds 
slavok7777: calls $0.04
*** FLOP *** [3s 5d 9c]
slavok7777: checks 
Guruy: checks 
JeckTen: checks 
*** TURN *** [3s 5d 9c] [Ac]
slavok7777: checks 
Guruy: bets $0.09
JeckTen: calls $0.09
slavok7777: folds 
*** RIVER *** [3s 5d 9c Ac] [Jd]
Guruy: checks 
JeckTen: bets $0.17
Guruy: folds 
Uncalled bet ($0.17) returned to JeckTen
JeckTen collected $0.36 from pot
JeckTen: doesn't show hand 
*** SUMMARY ***
Total pot $0.37 | Rake $0.01 
Board [3s 5d 9c Ac Jd]
Seat 1: DenBoss77 (button) folded before Flop (didn't bet)
Seat 2: Redvin33 (small blind) folded before Flop
Seat 3: slavok7777 (big blind) folded on the Turn
Seat 4: unlea5h folded before Flop (didn't bet)
Seat 5: godlikelo folded before Flop (didn't bet)
Seat 6: Guruy folded on the River
Seat 7: Quorthon_Zei folded before Flop (didn't bet)
Seat 8: JeckTen collected ($0.36)
Seat 9: bilimb folded before Flop (didn't bet)



PokerStars Zoom Hand #172845388671:  Hold'em No Limit ($0.01/$0.02) - 2017/07/10 8:39:16 ET
Table 'McNaught' 9-max Seat #1 is the button
Seat 1: ateist177 ($1.74 in chips) 
Seat 2: Aleshjke88 ($2 in chips) 
Seat 3: Azazell0666 ($3.33 in chips) 
Seat 4: DIMKA1488228 ($3.12 in chips) 
Seat 5: bubufish91 ($5.03 in chips) 
Seat 6: Redvin33 ($2.41 in chips) 
Seat 7: noborder69 ($2.70 in chips) 
Seat 8: fedosov_ivan ($2.14 in chips) 
Seat 9: Poker in DNA ($3.94 in chips) 
Aleshjke88: posts small blind $0.01
Azazell0666: posts big blind $0.02
*** HOLE CARDS ***
Dealt to Redvin33 [Qh Ac]
DIMKA1488228: folds 
bubufish91: folds 
Redvin33: raises $0.03 to $0.05
noborder69: folds 
fedosov_ivan: calls $0.05
Poker in DNA: folds 
ateist177: folds 
Aleshjke88: folds 
Azazell0666: folds 
*** FLOP *** [As 4d 9c]
Redvin33: checks 
fedosov_ivan: bets $0.08
Redvin33: calls $0.08
*** TURN *** [As 4d 9c] [9s]
Redvin33: checks 
fedosov_ivan: checks 
*** RIVER *** [As 4d 9c 9s] [Kd]
Redvin33: checks 
fedosov_ivan: checks 
*** SHOW DOWN ***
Redvin33: shows [Qh Ac] (two pair, Aces and Nines)
fedosov_ivan: mucks hand 
Redvin33 collected $0.28 from pot
*** SUMMARY ***
Total pot $0.29 | Rake $0.01 
Board [As 4d 9c 9s Kd]
Seat 1: ateist177 (button) folded before Flop (didn't bet)
Seat 2: Aleshjke88 (small blind) folded before Flop
Seat 3: Azazell0666 (big blind) folded before Flop
Seat 4: DIMKA1488228 folded before Flop (didn't bet)
Seat 5: bubufish91 folded before Flop (didn't bet)
Seat 6: Redvin33 showed [Qh Ac] and won ($0.28) with two pair, Aces and Nines
Seat 7: noborder69 folded before Flop (didn't bet)
Seat 8: fedosov_ivan mucked [6s 6c]
Seat 9: Poker in DNA folded before Flop (didn't bet)



PokerStars Zoom Hand #172845413884:  Hold'em No Limit ($0.01/$0.02) - 2017/07/10 8:40:10 ET
Table 'McNaught' 9-max Seat #1 is the button
Seat 1: ZYMBAH ($0.87 in chips) 
Seat 2: JeckTen ($2.24 in chips) 
Seat 3: Panzagoth ($2.03 in chips) 
Seat 4: Patte6 ($2.15 in chips) 
Seat 5: Redvin33 ($2.56 in chips) 
Seat 6: Rominitakiss ($2.03 in chips) 
Seat 7: Kolya813 ($2.51 in chips) 
Seat 8: Alteroche ($2.24 in chips) 
Seat 9: geyza15 ($2 in chips) 
JeckTen: posts small blind $0.01
Panzagoth: posts big blind $0.02
*** HOLE CARDS ***
Dealt to Redvin33 [9d 9h]
Patte6: folds 
Redvin33: raises $0.04 to $0.06
Rominitakiss: folds 
Kolya813: folds 
Alteroche: calls $0.06
geyza15: folds 
ZYMBAH: calls $0.06
JeckTen: folds 
Panzagoth: folds 
*** FLOP *** [Kc 6s 7s]
Redvin33: bets $0.08
Alteroche: calls $0.08
ZYMBAH: folds 
*** TURN *** [Kc 6s 7s] [Ad]
Redvin33: checks 
Alteroche: checks 
*** RIVER *** [Kc 6s 7s Ad] [Qd]
Redvin33: checks 
Alteroche: checks 
*** SHOW DOWN ***
Redvin33: shows [9d 9h] (a pair of Nines)
Alteroche: shows [Ts Tc] (a pair of Tens)
Alteroche collected $0.36 from pot
*** SUMMARY ***
Total pot $0.37 | Rake $0.01 
Board [Kc 6s 7s Ad Qd]
Seat 1: ZYMBAH (button) folded on the Flop
Seat 2: JeckTen (small blind) folded before Flop
Seat 3: Panzagoth (big blind) folded before Flop
Seat 4: Patte6 folded before Flop (didn't bet)
Seat 5: Redvin33 showed [9d 9h] and lost with a pair of Nines
Seat 6: Rominitakiss folded before Flop (didn't bet)
Seat 7: Kolya813 folded before Flop (didn't bet)
Seat 8: Alteroche showed [Ts Tc] and won ($0.36) with a pair of Tens
Seat 9: geyza15 folded before Flop (didn't bet)



PokerStars Zoom Hand #172845442915:  Hold'em No Limit ($0.01/$0.02) - 2017/07/10 8:41:12 ET
Table 'McNaught' 9-max Seat #1 is the button
Seat 1: ClailtonA. ($2.79 in chips) 
Seat 2: DIMKA1488228 ($2.40 in chips) 
Seat 3: Redvin33 ($2.42 in chips) 
Seat 4: winkiAA ($3.84 in chips) 
Seat 5: Beatsteak123 ($2.09 in chips) 
Seat 6: nikmir34 ($1.77 in chips) 
Seat 7: Pet2403 ($2.97 in chips) 
Seat 8: Marthmer1 ($1.68 in chips) 
Seat 9: ppoker_fac3 ($2.09 in chips) 
DIMKA1488228: posts small blind $0.01
Redvin33: posts big blind $0.02
*** HOLE CARDS ***
Dealt to Redvin33 [8s Jh]
winkiAA: raises $0.04 to $0.06
Beatsteak123: folds 
nikmir34: folds 
Pet2403: folds 
Marthmer1: folds 
ppoker_fac3: folds 
ClailtonA.: folds 
DIMKA1488228: folds 
Redvin33: folds 
Uncalled bet ($0.04) returned to winkiAA
winkiAA collected $0.05 from pot
winkiAA: doesn't show hand 
*** SUMMARY ***
Total pot $0.05 | Rake $0 
Seat 1: ClailtonA. (button) folded before Flop (didn't bet)
Seat 2: DIMKA1488228 (small blind) folded before Flop
Seat 3: Redvin33 (big blind) folded before Flop
Seat 4: winkiAA collected ($0.05)
Seat 5: Beatsteak123 folded before Flop (didn't bet)
Seat 6: nikmir34 folded before Flop (didn't bet)
Seat 7: Pet2403 folded before Flop (didn't bet)
Seat 8: Marthmer1 folded before Flop (didn't bet)
Seat 9: ppoker_fac3 folded before Flop (didn't bet)



PokerStars Zoom Hand #172845447076:  Hold'em No Limit ($0.01/$0.02) - 2017/07/10 8:41:21 ET
Table 'McNaught' 9-max Seat #1 is the button
Seat 1: koyutaka ($0.85 in chips) 
Seat 2: Plmax94 ($1.68 in chips) 
Seat 3: DenBoss77 ($2.30 in chips) 
Seat 4: aleekseenko ($1.13 in chips) 
Seat 5: muoshulll ($0.95 in chips) 
Seat 6: mrhoseman ($1.73 in chips) 
Seat 7: Redvin33 ($2.40 in chips) 
Seat 8: Kazak0707 ($2.10 in chips) 
Seat 9: gelik32 ($2.67 in chips) 
Plmax94: posts small blind $0.01
DenBoss77: posts big blind $0.02
*** HOLE CARDS ***
Dealt to Redvin33 [As 4s]
aleekseenko: folds 
muoshulll: folds 
mrhoseman: folds 
Redvin33: raises $0.03 to $0.05
Kazak0707: folds 
gelik32: folds 
koyutaka: folds 
Plmax94: folds 
DenBoss77: folds 
Uncalled bet ($0.03) returned to Redvin33
Redvin33 collected $0.05 from pot
Redvin33: doesn't show hand 
*** SUMMARY ***
Total pot $0.05 | Rake $0 
Seat 1: koyutaka (button) folded before Flop (didn't bet)
Seat 2: Plmax94 (small blind) folded before Flop
Seat 3: DenBoss77 (big blind) folded before Flop
Seat 4: aleekseenko folded before Flop (didn't bet)
Seat 5: muoshulll folded before Flop (didn't bet)
Seat 6: mrhoseman folded before Flop (didn't bet)
Seat 7: Redvin33 collected ($0.05)
Seat 8: Kazak0707 folded before Flop (didn't bet)
Seat 9: gelik32 folded before Flop (didn't bet)



PokerStars Zoom Hand #172845445209:  Hold'em No Limit ($0.01/$0.02) - 2017/07/10 8:41:17 ET
Table 'McNaught' 9-max Seat #1 is the button
Seat 1: Fixitys ($2.34 in chips) 
Seat 2: pidaladi ($3.31 in chips) 
Seat 3: Yablonski141 ($2 in chips) 
Seat 4: Redvin33 ($2.40 in chips) 
Seat 5: CannonF0dder ($2 in chips) 
Seat 6: ClailtonA. ($2.79 in chips) 
Seat 7: TSvetkovRA ($0.36 in chips) 
Seat 8: zayaizraya ($2.75 in chips) 
Seat 9: BraveGirl ($0.63 in chips) 
pidaladi: posts small blind $0.01
Yablonski141: posts big blind $0.02
*** HOLE CARDS ***
Dealt to Redvin33 [5c 2c]
Redvin33: folds 
CannonF0dder: folds 
ClailtonA.: folds 
TSvetkovRA: raises $0.08 to $0.10
zayaizraya: folds 
BraveGirl: folds 
Fixitys: folds 
pidaladi: folds 
Yablonski141: calls $0.08
*** FLOP *** [6d 3s 8s]
Yablonski141: checks 
TSvetkovRA: checks 
*** TURN *** [6d 3s 8s] [5h]
Yablonski141: bets $0.10
TSvetkovRA: folds 
Uncalled bet ($0.10) returned to Yablonski141
Yablonski141 collected $0.20 from pot
Yablonski141: doesn't show hand 
*** SUMMARY ***
Total pot $0.21 | Rake $0.01 
Board [6d 3s 8s 5h]
Seat 1: Fixitys (button) folded before Flop (didn't bet)
Seat 2: pidaladi (small blind) folded before Flop
Seat 3: Yablonski141 (big blind) collected ($0.20)
Seat 4: Redvin33 folded before Flop (didn't bet)
Seat 5: CannonF0dder folded before Flop (didn't bet)
Seat 6: ClailtonA. folded before Flop (didn't bet)
Seat 7: TSvetkovRA folded on the Turn
Seat 8: zayaizraya folded before Flop (didn't bet)
Seat 9: BraveGirl folded before Flop (didn't bet)



PokerStars Zoom Hand #172845453236:  Hold'em No Limit ($0.01/$0.02) - 2017/07/10 8:41:34 ET
Table 'McNaught' 9-max Seat #1 is the button
Seat 1: STAIRUS1989 ($2 in chips) 
Seat 2: Rurius ($2.31 in chips) 
Seat 3: msk jeanke ($2.58 in chips) 
Seat 4: Strelok1983 ($2.03 in chips) 
Seat 5: Alteroche ($2 in chips) 
Seat 6: noborder69 ($2.43 in chips) 
Seat 7: Mùúh 22 ($3.85 in chips) 
Seat 8: P.Phantoms ($0.63 in chips) 
Seat 9: Redvin33 ($2.43 in chips) 
Rurius: posts small blind $0.01
msk jeanke: posts big blind $0.02
*** HOLE CARDS ***
Dealt to Redvin33 [7s 8s]
Strelok1983: folds 
Alteroche: folds 
noborder69: folds 
Mùúh 22: folds 
P.Phantoms: folds 
Redvin33: raises $0.03 to $0.05
STAIRUS1989: calls $0.05
Rurius: folds 
msk jeanke: folds 
*** FLOP *** [Js 5d 9h]
Redvin33: bets $0.04
STAIRUS1989: calls $0.04
*** TURN *** [Js 5d 9h] [4s]
Redvin33: bets $0.06
STAIRUS1989: calls $0.06
*** RIVER *** [Js 5d 9h 4s] [9c]
Redvin33: bets $0.12
STAIRUS1989: folds 
Uncalled bet ($0.12) returned to Redvin33
Redvin33 collected $0.32 from pot
Redvin33: doesn't show hand 
*** SUMMARY ***
Total pot $0.33 | Rake $0.01 
Board [Js 5d 9h 4s 9c]
Seat 1: STAIRUS1989 (button) folded on the River
Seat 2: Rurius (small blind) folded before Flop
Seat 3: msk jeanke (big blind) folded before Flop
Seat 4: Strelok1983 folded before Flop (didn't bet)
Seat 5: Alteroche folded before Flop (didn't bet)
Seat 6: noborder69 folded before Flop (didn't bet)
Seat 7: Mùúh 22 folded before Flop (didn't bet)
Seat 8: P.Phantoms folded before Flop (didn't bet)
Seat 9: Redvin33 collected ($0.32)



PokerStars Zoom Hand #172845476628:  Hold'em No Limit ($0.01/$0.02) - 2017/07/10 8:42:24 ET
Table 'McNaught' 9-max Seat #1 is the button
Seat 1: BeWorry ($3.70 in chips) 
Seat 2: Redvin33 ($2.60 in chips) 
Seat 3: MaKri11 ($1.21 in chips) 
Seat 4: BrightCat ($2 in chips) 
Seat 5: Mongalor ($1.27 in chips) 
Seat 6: Antovka ($2 in chips) 
Seat 7: nikmir34 ($3.12 in chips) 
Seat 8: unlea5h ($2.39 in chips) 
Seat 9: STAIRUS1989 ($3.18 in chips) 
Redvin33: posts small blind $0.01
MaKri11: posts big blind $0.02
*** HOLE CARDS ***
Dealt to Redvin33 [3h Kh]
BrightCat: folds 
Mongalor: folds 
Antovka: raises $0.04 to $0.06
nikmir34: folds 
unlea5h: folds 
STAIRUS1989: calls $0.06
BeWorry: folds 
Redvin33: folds 
MaKri11: folds 
*** FLOP *** [Kc 7c 4s]
Antovka: bets $0.07
STAIRUS1989: folds 
Uncalled bet ($0.07) returned to Antovka
Antovka collected $0.14 from pot
Antovka: doesn't show hand 
*** SUMMARY ***
Total pot $0.15 | Rake $0.01 
Board [Kc 7c 4s]
Seat 1: BeWorry (button) folded before Flop (didn't bet)
Seat 2: Redvin33 (small blind) folded before Flop
Seat 3: MaKri11 (big blind) folded before Flop
Seat 4: BrightCat folded before Flop (didn't bet)
Seat 5: Mongalor folded before Flop (didn't bet)
Seat 6: Antovka collected ($0.14)
Seat 7: nikmir34 folded before Flop (didn't bet)
Seat 8: unlea5h folded before Flop (didn't bet)
Seat 9: STAIRUS1989 folded on the Flop



PokerStars Zoom Hand #172845486643:  Hold'em No Limit ($0.01/$0.02) - 2017/07/10 8:42:45 ET
Table 'McNaught' 9-max Seat #1 is the button
Seat 1: kolobok895 ($2.05 in chips) 
Seat 2: Strelok1983 ($2.39 in chips) 
Seat 3: 1000000$ ANA ($2 in chips) 
Seat 4: dragonlot ($2.09 in chips) 
Seat 5: Redvin33 ($2.59 in chips) 
Seat 6: aleekseenko ($0.97 in chips) 
Seat 7: Antovka ($2 in chips) 
Seat 8: Panzagoth ($2.51 in chips) 
Seat 9: Lu4EV ($1.84 in chips) 
Strelok1983: posts small blind $0.01
1000000$ ANA: posts big blind $0.02
*** HOLE CARDS ***
Dealt to Redvin33 [Qc 3s]
dragonlot: folds 
Redvin33: folds 
aleekseenko: folds 
Antovka: folds 
Panzagoth: folds 
Lu4EV: folds 
kolobok895: folds 
Strelok1983: raises $0.02 to $0.04
1000000$ ANA: folds 
Uncalled bet ($0.02) returned to Strelok1983
Strelok1983 collected $0.04 from pot
Strelok1983: doesn't show hand 
*** SUMMARY ***
Total pot $0.04 | Rake $0 
Seat 1: kolobok895 (button) folded before Flop (didn't bet)
Seat 2: Strelok1983 (small blind) collected ($0.04)
Seat 3: 1000000$ ANA (big blind) folded before Flop
Seat 4: dragonlot folded before Flop (didn't bet)
Seat 5: Redvin33 folded before Flop (didn't bet)
Seat 6: aleekseenko folded before Flop (didn't bet)
Seat 7: Antovka folded before Flop (didn't bet)
Seat 8: Panzagoth folded before Flop (didn't bet)
Seat 9: Lu4EV folded before Flop (didn't bet)



PokerStars Zoom Hand #172845493140:  Hold'em No Limit ($0.01/$0.02) - 2017/07/10 8:42:59 ET
Table 'McNaught' 9-max Seat #1 is the button
Seat 1: Fixitys ($2.37 in chips) 
Seat 2: jaywu54091 ($2.39 in chips) 
Seat 3: dimaChess ($1.49 in chips) 
Seat 4: bubufish91 ($5.18 in chips) 
Seat 5: GRaf872 ($0.86 in chips) 
Seat 6: TKoniWolf ($2.16 in chips) 
Seat 7: Redvin33 ($2.59 in chips) 
Seat 8: Anarckus ($2 in chips) 
Seat 9: Burbulacus ($2.16 in chips) 
jaywu54091: posts small blind $0.01
dimaChess: posts big blind $0.02
*** HOLE CARDS ***
Dealt to Redvin33 [3c Jd]
bubufish91: folds 
GRaf872: folds 
TKoniWolf: folds 
Redvin33: folds 
Anarckus: folds 
Burbulacus: folds 
Fixitys: folds 
jaywu54091: folds 
Uncalled bet ($0.01) returned to dimaChess
dimaChess collected $0.02 from pot
dimaChess: doesn't show hand 
*** SUMMARY ***
Total pot $0.02 | Rake $0 
Seat 1: Fixitys (button) folded before Flop (didn't bet)
Seat 2: jaywu54091 (small blind) folded before Flop
Seat 3: dimaChess (big blind) collected ($0.02)
Seat 4: bubufish91 folded before Flop (didn't bet)
Seat 5: GRaf872 folded before Flop (didn't bet)
Seat 6: TKoniWolf folded before Flop (didn't bet)
Seat 7: Redvin33 folded before Flop (didn't bet)
Seat 8: Anarckus folded before Flop (didn't bet)
Seat 9: Burbulacus folded before Flop (didn't bet)



PokerStars Zoom Hand #172845495014:  Hold'em No Limit ($0.01/$0.02) - 2017/07/10 8:43:03 ET
Table 'McNaught' 9-max Seat #1 is the button
Seat 1: raful1 ($2.29 in chips) 
Seat 2: winkiAA ($2.45 in chips) 
Seat 3: Redvin33 ($2.59 in chips) 
Seat 4: djafar63 ($2.46 in chips) 
Seat 5: ocrimus ($4.43 in chips) 
Seat 6: fedosov_ivan ($2.04 in chips) 
Seat 7: Antovka ($2.16 in chips) 
Seat 8: Aleshjke88 ($1.97 in chips) 
Seat 9: ClailtonA. ($4.12 in chips) 
winkiAA: posts small blind $0.01
Redvin33: posts big blind $0.02
*** HOLE CARDS ***
Dealt to Redvin33 [Qc 2s]
djafar63: folds 
ocrimus: folds 
fedosov_ivan: folds 
Antovka: folds 
Aleshjke88: folds 
ClailtonA.: folds 
raful1: folds 
winkiAA: folds 
Uncalled bet ($0.01) returned to Redvin33
Redvin33 collected $0.02 from pot
Redvin33: doesn't show hand 
*** SUMMARY ***
Total pot $0.02 | Rake $0 
Seat 1: raful1 (button) folded before Flop (didn't bet)
Seat 2: winkiAA (small blind) folded before Flop
Seat 3: Redvin33 (big blind) collected ($0.02)
Seat 4: djafar63 folded before Flop (didn't bet)
Seat 5: ocrimus folded before Flop (didn't bet)
Seat 6: fedosov_ivan folded before Flop (didn't bet)
Seat 7: Antovka folded before Flop (didn't bet)
Seat 8: Aleshjke88 folded before Flop (didn't bet)
Seat 9: ClailtonA. folded before Flop (didn't bet)



PokerStars Zoom Hand #172845485196:  Hold'em No Limit ($0.01/$0.02) - 2017/07/10 8:42:42 ET
Table 'McNaught' 9-max Seat #1 is the button
Seat 1: livingod00p ($1.05 in chips) 
Seat 2: DARKLORRRD ($2.53 in chips) 
Seat 3: x@t@bich ($7.08 in chips) 
Seat 4: Rurius ($2.80 in chips) 
Seat 5: zayaizraya ($2.57 in chips) 
Seat 6: Redvin33 ($2.59 in chips) 
Seat 7: ppoker_fac3 ($2.12 in chips) 
Seat 8: mr.cuslya ($0.97 in chips) 
Seat 9: godlikelo ($4.19 in chips) 
DARKLORRRD: posts small blind $0.01
x@t@bich: posts big blind $0.02
*** HOLE CARDS ***
Dealt to Redvin33 [9d 2d]
Rurius: folds 
zayaizraya: calls $0.02
Redvin33: folds 
ppoker_fac3: folds 
mr.cuslya: folds 
godlikelo: folds 
livingod00p: folds 
DARKLORRRD: calls $0.01
x@t@bich: checks 
*** FLOP *** [8s 4d Jc]
DARKLORRRD: checks 
x@t@bich: checks 
zayaizraya: bets $0.02
DARKLORRRD: folds 
x@t@bich: folds 
Uncalled bet ($0.02) returned to zayaizraya
zayaizraya collected $0.06 from pot
zayaizraya: doesn't show hand 
*** SUMMARY ***
Total pot $0.06 | Rake $0 
Board [8s 4d Jc]
Seat 1: livingod00p (button) folded before Flop (didn't bet)
Seat 2: DARKLORRRD (small blind) folded on the Flop
Seat 3: x@t@bich (big blind) folded on the Flop
Seat 4: Rurius folded before Flop (didn't bet)
Seat 5: zayaizraya collected ($0.06)
Seat 6: Redvin33 folded before Flop (didn't bet)
Seat 7: ppoker_fac3 folded before Flop (didn't bet)
Seat 8: mr.cuslya folded before Flop (didn't bet)
Seat 9: godlikelo folded before Flop (didn't bet)



PokerStars Zoom Hand #172845491290:  Hold'em No Limit ($0.01/$0.02) - 2017/07/10 8:42:55 ET
Table 'McNaught' 9-max Seat #1 is the button
Seat 1: gen111728 ($0.66 in chips) 
Seat 2: javi_22_66 ($1.74 in chips) 
Seat 3: AvelinoAcess ($2 in chips) 
Seat 4: Redvin33 ($2.59 in chips) 
Seat 5: Burbulacus ($2.14 in chips) 
Seat 6: Matsusziro ($2.07 in chips) 
Seat 7: kisjoe96 ($1.07 in chips) 
Seat 8: Strelok1983 ($2.12 in chips) 
Seat 9: geyza15 ($2.03 in chips) 
javi_22_66: posts small blind $0.01
AvelinoAcess: posts big blind $0.02
*** HOLE CARDS ***
Dealt to Redvin33 [6d 4h]
Redvin33: folds 
Burbulacus: folds 
Matsusziro: folds 
kisjoe96: folds 
Strelok1983: folds 
geyza15: folds 
gen111728: folds 
javi_22_66: raises $0.06 to $0.08
AvelinoAcess: folds 
Uncalled bet ($0.06) returned to javi_22_66
javi_22_66 collected $0.04 from pot
javi_22_66: doesn't show hand 
*** SUMMARY ***
Total pot $0.04 | Rake $0 
Seat 1: gen111728 (button) folded before Flop (didn't bet)
Seat 2: javi_22_66 (small blind) collected ($0.04)
Seat 3: AvelinoAcess (big blind) folded before Flop
Seat 4: Redvin33 folded before Flop (didn't bet)
Seat 5: Burbulacus folded before Flop (didn't bet)
Seat 6: Matsusziro folded before Flop (didn't bet)
Seat 7: kisjoe96 folded before Flop (didn't bet)
Seat 8: Strelok1983 folded before Flop (didn't bet)
Seat 9: geyza15 folded before Flop (didn't bet)



PokerStars Zoom Hand #172845481868:  Hold'em No Limit ($0.01/$0.02) - 2017/07/10 8:42:35 ET
Table 'McNaught' 9-max Seat #1 is the button
Seat 1: Redvin33 ($2.59 in chips) 
Seat 2: TKoniWolf ($3.54 in chips) 
Seat 3: blsmur ($2.46 in chips) 
Seat 4: gjkbyf ($1.02 in chips) 
Seat 5: Mizepa ($2.01 in chips) 
Seat 6: Kadorci ($0.29 in chips) 
Seat 7: smopuim ($0.73 in chips) 
Seat 8: TatRus38 ($1.79 in chips) 
Seat 9: Antovka ($2.13 in chips) 
TKoniWolf: posts small blind $0.01
blsmur: posts big blind $0.02
*** HOLE CARDS ***
Dealt to Redvin33 [4d Jh]
gjkbyf: folds 
Mizepa: raises $0.04 to $0.06
Kadorci: folds 
smopuim: folds 
TatRus38: calls $0.06
Antovka: folds 
Redvin33: folds 
TKoniWolf: calls $0.05
blsmur: calls $0.04
*** FLOP *** [Kh 5s 4h]
TKoniWolf: checks 
blsmur: checks 
Mizepa: bets $0.12
TatRus38: folds 
TKoniWolf: folds 
blsmur: folds 
Uncalled bet ($0.12) returned to Mizepa
Mizepa collected $0.23 from pot
Mizepa: doesn't show hand 
*** SUMMARY ***
Total pot $0.24 | Rake $0.01 
Board [Kh 5s 4h]
Seat 1: Redvin33 (button) folded before Flop (didn't bet)
Seat 2: TKoniWolf (small blind) folded on the Flop
Seat 3: blsmur (big blind) folded on the Flop
Seat 4: gjkbyf folded before Flop (didn't bet)
Seat 5: Mizepa collected ($0.23)
Seat 6: Kadorci folded before Flop (didn't bet)
Seat 7: smopuim folded before Flop (didn't bet)
Seat 8: TatRus38 folded on the Flop
Seat 9: Antovka folded before Flop (didn't bet)



PokerStars Zoom Hand #172845483752:  Hold'em No Limit ($0.01/$0.02) - 2017/07/10 8:42:39 ET
Table 'McNaught' 9-max Seat #1 is the button
Seat 1: TSvetkovRA ($2.03 in chips) 
Seat 2: parkietapie ($3.07 in chips) 
Seat 3: Aleshjke88 ($1.99 in chips) 
Seat 4: max160381 ($2.30 in chips) 
Seat 5: CannonF0dder ($2 in chips) 
Seat 6: smopuim ($0.73 in chips) 
Seat 7: Azazell0666 ($3.45 in chips) 
Seat 8: Redvin33 ($2.59 in chips) 
Seat 9: Rominitakiss ($3.39 in chips) 
parkietapie: posts small blind $0.01
Aleshjke88: posts big blind $0.02
*** HOLE CARDS ***
Dealt to Redvin33 [Th 7s]
max160381: folds 
CannonF0dder: folds 
smopuim: folds 
Azazell0666: raises $0.04 to $0.06
Redvin33: folds 
Rominitakiss: calls $0.06
TSvetkovRA: calls $0.06
parkietapie: calls $0.05
Aleshjke88: folds 
*** FLOP *** [2s Kd 8c]
parkietapie: checks 
Azazell0666: checks 
Rominitakiss: bets $0.02
TSvetkovRA: folds 
parkietapie: folds 
Azazell0666: calls $0.02
*** TURN *** [2s Kd 8c] [5h]
Azazell0666: checks 
Rominitakiss: checks 
*** RIVER *** [2s Kd 8c 5h] [Qs]
Azazell0666: checks 
Rominitakiss: checks 
*** SHOW DOWN ***
Azazell0666: shows [As Ts] (high card Ace)
Rominitakiss: shows [8h 6h] (a pair of Eights)
Rominitakiss collected $0.29 from pot
*** SUMMARY ***
Total pot $0.30 | Rake $0.01 
Board [2s Kd 8c 5h Qs]
Seat 1: TSvetkovRA (button) folded on the Flop
Seat 2: parkietapie (small blind) folded on the Flop
Seat 3: Aleshjke88 (big blind) folded before Flop
Seat 4: max160381 folded before Flop (didn't bet)
Seat 5: CannonF0dder folded before Flop (didn't bet)
Seat 6: smopuim folded before Flop (didn't bet)
Seat 7: Azazell0666 showed [As Ts] and lost with high card Ace
Seat 8: Redvin33 folded before Flop (didn't bet)
Seat 9: Rominitakiss showed [8h 6h] and won ($0.29) with a pair of Eights



PokerStars Zoom Hand #172845488527:  Hold'em No Limit ($0.01/$0.02) - 2017/07/10 8:42:49 ET
Table 'McNaught' 9-max Seat #1 is the button
Seat 1: playpoker872 ($5.49 in chips) 
Seat 2: lberlin ($0.98 in chips) 
Seat 3: minunimi ($4.06 in chips) 
Seat 4: Redvin33 ($2.59 in chips) 
Seat 5: aleekseenko ($0.97 in chips) 
Seat 6: winkiAA ($2.58 in chips) 
Seat 7: AvelinoAcess ($2.01 in chips) 
Seat 8: farthomas ($2.71 in chips) 
Seat 9: Anarckus ($2 in chips) 
lberlin: posts small blind $0.01
minunimi: posts big blind $0.02
*** HOLE CARDS ***
Dealt to Redvin33 [Ks 3s]
Redvin33: folds 
aleekseenko: folds 
winkiAA: folds 
AvelinoAcess: folds 
farthomas: calls $0.02
Anarckus: folds 
playpoker872: calls $0.02
lberlin: calls $0.01
minunimi: checks 
*** FLOP *** [Jd 8c 5s]
lberlin: checks 
minunimi: checks 
farthomas: checks 
playpoker872: checks 
*** TURN *** [Jd 8c 5s] [Kd]
lberlin: bets $0.06
minunimi: folds 
farthomas: calls $0.06
playpoker872: folds 
*** RIVER *** [Jd 8c 5s Kd] [9h]
lberlin: bets $0.19
farthomas: calls $0.19
*** SHOW DOWN ***
lberlin: shows [Kc 9d] (two pair, Kings and Nines)
farthomas: mucks hand 
lberlin collected $0.56 from pot
*** SUMMARY ***
Total pot $0.58 | Rake $0.02 
Board [Jd 8c 5s Kd 9h]
Seat 1: playpoker872 (button) folded on the Turn
Seat 2: lberlin (small blind) showed [Kc 9d] and won ($0.56) with two pair, Kings and Nines
Seat 3: minunimi (big blind) folded on the Turn
Seat 4: Redvin33 folded before Flop (didn't bet)
Seat 5: aleekseenko folded before Flop (didn't bet)
Seat 6: winkiAA folded before Flop (didn't bet)
Seat 7: AvelinoAcess folded before Flop (didn't bet)
Seat 8: farthomas mucked [Qc Ah]
Seat 9: Anarckus folded before Flop (didn't bet)



PokerStars Zoom Hand #172845500572:  Hold'em No Limit ($0.01/$0.02) - 2017/07/10 8:43:15 ET
Table 'McNaught' 9-max Seat #1 is the button
Seat 1: AvelinoAcess ($2 in chips) 
Seat 2: Redvin33 ($2.60 in chips) 
Seat 3: Vikta8 ($0.48 in chips) 
Seat 4: YAAJ7 ($1.47 in chips) 
Seat 5: AST@r85 ($6.30 in chips) 
Seat 6: NearLin ($4.42 in chips) 
Seat 7: Burbulacus ($2.25 in chips) 
Seat 8: aleks_ply ($3.05 in chips) 
Seat 9: SaxpianikonR ($12.56 in chips) 
Redvin33: posts small blind $0.01
Vikta8: posts big blind $0.02
*** HOLE CARDS ***
Dealt to Redvin33 [9s 8h]
YAAJ7: folds 
AST@r85: folds 
NearLin: folds 
Burbulacus: folds 
aleks_ply: raises $0.04 to $0.06
SaxpianikonR: calls $0.06
AvelinoAcess: folds 
Redvin33: calls $0.05
Vikta8: folds 
*** FLOP *** [2s 3c 7c]
Redvin33: checks 
aleks_ply: bets $0.13
SaxpianikonR: folds 
Redvin33: folds 
Uncalled bet ($0.13) returned to aleks_ply
aleks_ply collected $0.19 from pot
aleks_ply: doesn't show hand 
*** SUMMARY ***
Total pot $0.20 | Rake $0.01 
Board [2s 3c 7c]
Seat 1: AvelinoAcess (button) folded before Flop (didn't bet)
Seat 2: Redvin33 (small blind) folded on the Flop
Seat 3: Vikta8 (big blind) folded before Flop
Seat 4: YAAJ7 folded before Flop (didn't bet)
Seat 5: AST@r85 folded before Flop (didn't bet)
Seat 6: NearLin folded before Flop (didn't bet)
Seat 7: Burbulacus folded before Flop (didn't bet)
Seat 8: aleks_ply collected ($0.19)
Seat 9: SaxpianikonR folded on the Flop



PokerStars Zoom Hand #172845518725:  Hold'em No Limit ($0.01/$0.02) - 2017/07/10 8:43:53 ET
Table 'McNaught' 9-max Seat #1 is the button
Seat 1: Redvin33 ($2.54 in chips) 
Seat 2: SanDmitri4 ($3.59 in chips) 
Seat 3: Tigriana ($1.94 in chips) 
Seat 4: Raketa57 ($5.71 in chips) 
Seat 5: Ames21x ($3.07 in chips) 
Seat 6: gelik32 ($2.26 in chips) 
Seat 7: TKoniWolf ($2.02 in chips) 
Seat 8: AvelinoAcess ($2 in chips) 
Seat 9: Plmax94 ($2.20 in chips) 
SanDmitri4: posts small blind $0.01
Tigriana: posts big blind $0.02
*** HOLE CARDS ***
Dealt to Redvin33 [3h Qh]
Raketa57: calls $0.02
Ames21x: folds 
gelik32: folds 
TKoniWolf: folds 
AvelinoAcess: folds 
Plmax94: folds 
Redvin33: folds 
SanDmitri4: folds 
Tigriana: checks 
*** FLOP *** [3d 6s 2s]
Tigriana: checks 
Raketa57: bets $0.02
Tigriana: folds 
Uncalled bet ($0.02) returned to Raketa57
Raketa57 collected $0.05 from pot
Raketa57: doesn't show hand 
*** SUMMARY ***
Total pot $0.05 | Rake $0 
Board [3d 6s 2s]
Seat 1: Redvin33 (button) folded before Flop (didn't bet)
Seat 2: SanDmitri4 (small blind) folded before Flop
Seat 3: Tigriana (big blind) folded on the Flop
Seat 4: Raketa57 collected ($0.05)
Seat 5: Ames21x folded before Flop (didn't bet)
Seat 6: gelik32 folded before Flop (didn't bet)
Seat 7: TKoniWolf folded before Flop (didn't bet)
Seat 8: AvelinoAcess folded before Flop (didn't bet)
Seat 9: Plmax94 folded before Flop (didn't bet)



PokerStars Zoom Hand #172845520572:  Hold'em No Limit ($0.01/$0.02) - 2017/07/10 8:43:57 ET
Table 'McNaught' 9-max Seat #1 is the button
Seat 1: Profit775391 ($2.21 in chips) 
Seat 2: Bendi86 ($1.98 in chips) 
Seat 3: YOHONSON ($2.04 in chips) 
Seat 4: Lu4EV ($1.29 in chips) 
Seat 5: trevor987 ($2.30 in chips) 
Seat 6: zibertmen ($2.40 in chips) 
Seat 7: mercurio0359 ($1.69 in chips) 
Seat 8: fedosov_ivan ($2 in chips) 
Seat 9: Redvin33 ($2.54 in chips) 
Bendi86: posts small blind $0.01
YOHONSON: posts big blind $0.02
*** HOLE CARDS ***
Dealt to Redvin33 [2d Js]
Lu4EV: folds 
trevor987: folds 
zibertmen: folds 
mercurio0359: raises $0.04 to $0.06
fedosov_ivan: folds 
Redvin33: folds 
Profit775391: folds 
Bendi86: folds 
YOHONSON: folds 
Uncalled bet ($0.04) returned to mercurio0359
mercurio0359 collected $0.05 from pot
mercurio0359: doesn't show hand 
*** SUMMARY ***
Total pot $0.05 | Rake $0 
Seat 1: Profit775391 (button) folded before Flop (didn't bet)
Seat 2: Bendi86 (small blind) folded before Flop
Seat 3: YOHONSON (big blind) folded before Flop
Seat 4: Lu4EV folded before Flop (didn't bet)
Seat 5: trevor987 folded before Flop (didn't bet)
Seat 6: zibertmen folded before Flop (didn't bet)
Seat 7: mercurio0359 collected ($0.05)
Seat 8: fedosov_ivan folded before Flop (didn't bet)
Seat 9: Redvin33 folded before Flop (didn't bet)



PokerStars Zoom Hand #172845521937:  Hold'em No Limit ($0.01/$0.02) - 2017/07/10 8:44:00 ET
Table 'McNaught' 9-max Seat #1 is the button
Seat 1: STAIRUS1989 ($3.10 in chips) 
Seat 2: blsmur ($2.40 in chips) 
Seat 3: kangen333 ($2 in chips) 
Seat 4: tina86722 ($0.80 in chips) 
Seat 5: DenBoss77 ($2 in chips) 
Seat 6: Lionvodoo ($2.53 in chips) 
Seat 7: TKoniWolf ($2.11 in chips) 
Seat 8: Redvin33 ($2.54 in chips) 
Seat 9: yuu0914 ($3.11 in chips) 
blsmur: posts small blind $0.01
kangen333: posts big blind $0.02
*** HOLE CARDS ***
Dealt to Redvin33 [7d Ah]
tina86722: raises $0.05 to $0.07
DenBoss77: folds 
Lionvodoo: calls $0.07
TKoniWolf: folds 
Redvin33: calls $0.07
yuu0914: folds 
STAIRUS1989: folds 
blsmur: folds 
kangen333: folds 
*** FLOP *** [Tc Td 7s]
tina86722: checks 
Lionvodoo: checks 
Redvin33: bets $0.06
tina86722: calls $0.06
Lionvodoo: calls $0.06
*** TURN *** [Tc Td 7s] [Qs]
tina86722: checks 
Lionvodoo: checks 
Redvin33: checks 
*** RIVER *** [Tc Td 7s Qs] [5s]
tina86722: checks 
Lionvodoo: bets $0.16
Redvin33: calls $0.16
tina86722: folds 
*** SHOW DOWN ***
Lionvodoo: shows [5h 5c] (a full house, Fives full of Tens)
Redvin33: mucks hand 
Lionvodoo collected $0.71 from pot
*** SUMMARY ***
Total pot $0.74 | Rake $0.03 
Board [Tc Td 7s Qs 5s]
Seat 1: STAIRUS1989 (button) folded before Flop (didn't bet)
Seat 2: blsmur (small blind) folded before Flop
Seat 3: kangen333 (big blind) folded before Flop
Seat 4: tina86722 folded on the River
Seat 5: DenBoss77 folded before Flop (didn't bet)
Seat 6: Lionvodoo showed [5h 5c] and won ($0.71) with a full house, Fives full of Tens
Seat 7: TKoniWolf folded before Flop (didn't bet)
Seat 8: Redvin33 mucked [7d Ah]
Seat 9: yuu0914 folded before Flop (didn't bet)



PokerStars Zoom Hand #172845546536:  Hold'em No Limit ($0.01/$0.02) - 2017/07/10 8:44:52 ET
Table 'McNaught' 9-max Seat #1 is the button
Seat 1: Strelok1983 ($2.38 in chips) 
Seat 2: ppoker_fac3 ($2.31 in chips) 
Seat 3: godlikelo ($4.15 in chips) 
Seat 4: parkietapie ($2.74 in chips) 
Seat 5: DenBoss77 ($2 in chips) 
Seat 6: Redvin33 ($2.25 in chips) 
Seat 7: amarlean ($2.29 in chips) 
Seat 8: mikvesik ($2.02 in chips) 
Seat 9: ggood76 ($3.90 in chips) 
ppoker_fac3: posts small blind $0.01
godlikelo: posts big blind $0.02
*** HOLE CARDS ***
Dealt to Redvin33 [Ac Jc]
parkietapie: folds 
DenBoss77: folds 
Redvin33: raises $0.03 to $0.05
amarlean: folds 
mikvesik: folds 
ggood76: folds 
Strelok1983: folds 
ppoker_fac3: folds 
godlikelo: folds 
Uncalled bet ($0.03) returned to Redvin33
Redvin33 collected $0.05 from pot
Redvin33: doesn't show hand 
*** SUMMARY ***
Total pot $0.05 | Rake $0 
Seat 1: Strelok1983 (button) folded before Flop (didn't bet)
Seat 2: ppoker_fac3 (small blind) folded before Flop
Seat 3: godlikelo (big blind) folded before Flop
Seat 4: parkietapie folded before Flop (didn't bet)
Seat 5: DenBoss77 folded before Flop (didn't bet)
Seat 6: Redvin33 collected ($0.05)
Seat 7: amarlean folded before Flop (didn't bet)
Seat 8: mikvesik folded before Flop (didn't bet)
Seat 9: ggood76 folded before Flop (didn't bet)



PokerStars Zoom Hand #172845544651:  Hold'em No Limit ($0.01/$0.02) - 2017/07/10 8:44:48 ET
Table 'McNaught' 9-max Seat #1 is the button
Seat 1: AvelinoAcess ($2.03 in chips) 
Seat 2: mikvesik ($1.86 in chips) 
Seat 3: javi_22_66 ($1.72 in chips) 
Seat 4: Lionvodoo ($2.95 in chips) 
Seat 5: zen approach ($4.60 in chips) 
Seat 6: fedosov_ivan ($2.04 in chips) 
Seat 7: Redvin33 ($2.25 in chips) 
Seat 8: NearLin ($5.62 in chips) 
Seat 9: zora1449 ($2.07 in chips) 
mikvesik: posts small blind $0.01
javi_22_66: posts big blind $0.02
*** HOLE CARDS ***
Dealt to Redvin33 [7s 5d]
Lionvodoo: folds 
zen approach: folds 
fedosov_ivan: folds 
Redvin33: folds 
NearLin: folds 
zora1449: folds 
AvelinoAcess: raises $0.04 to $0.06
mikvesik: folds 
javi_22_66: folds 
Uncalled bet ($0.04) returned to AvelinoAcess
AvelinoAcess collected $0.05 from pot
AvelinoAcess: doesn't show hand 
*** SUMMARY ***
Total pot $0.05 | Rake $0 
Seat 1: AvelinoAcess (button) collected ($0.05)
Seat 2: mikvesik (small blind) folded before Flop
Seat 3: javi_22_66 (big blind) folded before Flop
Seat 4: Lionvodoo folded before Flop (didn't bet)
Seat 5: zen approach folded before Flop (didn't bet)
Seat 6: fedosov_ivan folded before Flop (didn't bet)
Seat 7: Redvin33 folded before Flop (didn't bet)
Seat 8: NearLin folded before Flop (didn't bet)
Seat 9: zora1449 folded before Flop (didn't bet)



PokerStars Zoom Hand #172845554867:  Hold'em No Limit ($0.01/$0.02) - 2017/07/10 8:45:10 ET
Table 'McNaught' 9-max Seat #1 is the button
Seat 1: Azazell0666 ($3.47 in chips) 
Seat 2: raful1 ($2.30 in chips) 
Seat 3: Danil548 ($2.04 in chips) 
Seat 4: C-class man ($2.01 in chips) 
Seat 5: dimaChess ($1.52 in chips) 
Seat 6: Redvin33 ($2.28 in chips) 
Seat 7: Stan.Rudy ($1.46 in chips) 
Seat 8: Mr.Aran73 ($2 in chips) 
Seat 9: thetrumper77 ($1.65 in chips) 
raful1: posts small blind $0.01
Danil548: posts big blind $0.02
*** HOLE CARDS ***
Dealt to Redvin33 [Ts Td]
C-class man: folds 
dimaChess: folds 
Redvin33: raises $0.03 to $0.05
Stan.Rudy: calls $0.05
Mr.Aran73: folds 
thetrumper77: folds 
Azazell0666: folds 
raful1: folds 
Danil548: folds 
*** FLOP *** [Qh 7s Jc]
Redvin33: checks 
Stan.Rudy: checks 
*** TURN *** [Qh 7s Jc] [4d]
Redvin33: bets $0.04
Stan.Rudy: calls $0.04
*** RIVER *** [Qh 7s Jc 4d] [8c]
Redvin33: bets $0.04
Stan.Rudy: calls $0.04
*** SHOW DOWN ***
Redvin33: shows [Ts Td] (a pair of Tens)
Stan.Rudy: shows [Jd Kd] (a pair of Jacks)
Stan.Rudy collected $0.28 from pot
*** SUMMARY ***
Total pot $0.29 | Rake $0.01 
Board [Qh 7s Jc 4d 8c]
Seat 1: Azazell0666 (button) folded before Flop (didn't bet)
Seat 2: raful1 (small blind) folded before Flop
Seat 3: Danil548 (big blind) folded before Flop
Seat 4: C-class man folded before Flop (didn't bet)
Seat 5: dimaChess folded before Flop (didn't bet)
Seat 6: Redvin33 showed [Ts Td] and lost with a pair of Tens
Seat 7: Stan.Rudy showed [Jd Kd] and won ($0.28) with a pair of Jacks
Seat 8: Mr.Aran73 folded before Flop (didn't bet)
Seat 9: thetrumper77 folded before Flop (didn't bet)



PokerStars Zoom Hand #172845570296:  Hold'em No Limit ($0.01/$0.02) - 2017/07/10 8:45:43 ET
Table 'McNaught' 9-max Seat #1 is the button
Seat 1: DenBoss77 ($2.02 in chips) 
Seat 2: ktho55 ($1.73 in chips) 
Seat 3: Redvin33 ($2.15 in chips) 
Seat 4: dragonlot ($2 in chips) 
Seat 5: Danil548 ($1.90 in chips) 
Seat 6: godlikelo ($3.88 in chips) 
Seat 7: kisjoe96 ($1 in chips) 
Seat 8: yuu0914 ($3.60 in chips) 
Seat 9: Méry66 ($1.41 in chips) 
ktho55: posts small blind $0.01
Redvin33: posts big blind $0.02
*** HOLE CARDS ***
Dealt to Redvin33 [Kc 6c]
dragonlot: folds 
Danil548: folds 
godlikelo: folds 
kisjoe96: folds 
yuu0914: folds 
Méry66: folds 
DenBoss77: folds 
ktho55: folds 
Uncalled bet ($0.01) returned to Redvin33
Redvin33 collected $0.02 from pot
Redvin33: doesn't show hand 
*** SUMMARY ***
Total pot $0.02 | Rake $0 
Seat 1: DenBoss77 (button) folded before Flop (didn't bet)
Seat 2: ktho55 (small blind) folded before Flop
Seat 3: Redvin33 (big blind) collected ($0.02)
Seat 4: dragonlot folded before Flop (didn't bet)
Seat 5: Danil548 folded before Flop (didn't bet)
Seat 6: godlikelo folded before Flop (didn't bet)
Seat 7: kisjoe96 folded before Flop (didn't bet)
Seat 8: yuu0914 folded before Flop (didn't bet)
Seat 9: Méry66 folded before Flop (didn't bet)



PokerStars Zoom Hand #172845582218:  Hold'em No Limit ($0.01/$0.02) - 2017/07/10 8:46:08 ET
Table 'McNaught' 9-max Seat #1 is the button
Seat 1: Bushika7 ($7.30 in chips) 
Seat 2: muoshulll ($1.05 in chips) 
Seat 3: Fifflaren923 ($4.15 in chips) 
Seat 4: SanDmitri4 ($4.12 in chips) 
Seat 5: smopuim ($2.51 in chips) 
Seat 6: raful1 ($2.27 in chips) 
Seat 7: NearLin ($2.10 in chips) 
Seat 8: Redvin33 ($2.15 in chips) 
Seat 9: dumbik89 ($4.67 in chips) 
muoshulll: posts small blind $0.01
Fifflaren923: posts big blind $0.02
*** HOLE CARDS ***
Dealt to Redvin33 [5s Qc]
SanDmitri4: folds 
smopuim: folds 
raful1: folds 
NearLin: folds 
Redvin33: folds 
dumbik89: folds 
Bushika7: folds 
muoshulll: folds 
Uncalled bet ($0.01) returned to Fifflaren923
Fifflaren923 collected $0.02 from pot
Fifflaren923: doesn't show hand 
*** SUMMARY ***
Total pot $0.02 | Rake $0 
Seat 1: Bushika7 (button) folded before Flop (didn't bet)
Seat 2: muoshulll (small blind) folded before Flop
Seat 3: Fifflaren923 (big blind) collected ($0.02)
Seat 4: SanDmitri4 folded before Flop (didn't bet)
Seat 5: smopuim folded before Flop (didn't bet)
Seat 6: raful1 folded before Flop (didn't bet)
Seat 7: NearLin folded before Flop (didn't bet)
Seat 8: Redvin33 folded before Flop (didn't bet)
Seat 9: dumbik89 folded before Flop (didn't bet)



PokerStars Zoom Hand #172845580272:  Hold'em No Limit ($0.01/$0.02) - 2017/07/10 8:46:04 ET
Table 'McNaught' 9-max Seat #1 is the button
Seat 1: Lionvodoo ($3.11 in chips) 
Seat 2: Redvin33 ($2.16 in chips) 
Seat 3: mikvesik ($1.69 in chips) 
Seat 4: levikeeeLOL ($2 in chips) 
Seat 5: TSvetkovRA ($1 in chips) 
Seat 6: mrhoseman ($2.30 in chips) 
Seat 7: VV888V ($1.24 in chips) 
Seat 8: Fifflaren923 ($4.15 in chips) 
Seat 9: ocrimus ($2.18 in chips) 
Redvin33: posts small blind $0.01
mikvesik: posts big blind $0.02
*** HOLE CARDS ***
Dealt to Redvin33 [5s 8s]
levikeeeLOL: folds 
TSvetkovRA: raises $0.08 to $0.10
mrhoseman: folds 
VV888V: folds 
Fifflaren923: folds 
ocrimus: folds 
Lionvodoo: folds 
Redvin33: folds 
mikvesik: folds 
Uncalled bet ($0.08) returned to TSvetkovRA
TSvetkovRA collected $0.05 from pot
TSvetkovRA: doesn't show hand 
*** SUMMARY ***
Total pot $0.05 | Rake $0 
Seat 1: Lionvodoo (button) folded before Flop (didn't bet)
Seat 2: Redvin33 (small blind) folded before Flop
Seat 3: mikvesik (big blind) folded before Flop
Seat 4: levikeeeLOL folded before Flop (didn't bet)
Seat 5: TSvetkovRA collected ($0.05)
Seat 6: mrhoseman folded before Flop (didn't bet)
Seat 7: VV888V folded before Flop (didn't bet)
Seat 8: Fifflaren923 folded before Flop (didn't bet)
Seat 9: ocrimus folded before Flop (didn't bet)



PokerStars Zoom Hand #172845584075:  Hold'em No Limit ($0.01/$0.02) - 2017/07/10 8:46:12 ET
Table 'McNaught' 9-max Seat #1 is the button
Seat 1: ktho55 ($1.72 in chips) 
Seat 2: Bushika7 ($7.30 in chips) 
Seat 3: smopuim ($2.51 in chips) 
Seat 4: pidaladi ($2.56 in chips) 
Seat 5: godlikelo ($3.91 in chips) 
Seat 6: geyza15 ($2.03 in chips) 
Seat 7: Mr.Red[404] ($2 in chips) 
Seat 8: BrightCat ($2 in chips) 
Seat 9: Redvin33 ($2.15 in chips) 
Bushika7: posts small blind $0.01
smopuim: posts big blind $0.02
*** HOLE CARDS ***
Dealt to Redvin33 [6s 8d]
pidaladi: folds 
godlikelo: folds 
geyza15: raises $0.04 to $0.06
Mr.Red[404]: folds 
BrightCat: folds 
Redvin33: folds 
ktho55: folds 
Bushika7: folds 
smopuim: folds 
Uncalled bet ($0.04) returned to geyza15
geyza15 collected $0.05 from pot
geyza15: doesn't show hand 
*** SUMMARY ***
Total pot $0.05 | Rake $0 
Seat 1: ktho55 (button) folded before Flop (didn't bet)
Seat 2: Bushika7 (small blind) folded before Flop
Seat 3: smopuim (big blind) folded before Flop
Seat 4: pidaladi folded before Flop (didn't bet)
Seat 5: godlikelo folded before Flop (didn't bet)
Seat 6: geyza15 collected ($0.05)
Seat 7: Mr.Red[404] folded before Flop (didn't bet)
Seat 8: BrightCat folded before Flop (didn't bet)
Seat 9: Redvin33 folded before Flop (didn't bet)



PokerStars Zoom Hand #172845585925:  Hold'em No Limit ($0.01/$0.02) - 2017/07/10 8:46:16 ET
Table 'McNaught' 9-max Seat #1 is the button
Seat 1: Redvin33 ($2.15 in chips) 
Seat 2: Tigriana ($1.93 in chips) 
Seat 3: RmbJN90 ($3.35 in chips) 
Seat 4: gelik32 ($2 in chips) 
Seat 5: Aenari ($1.24 in chips) 
Seat 6: dai2173 ($1.66 in chips) 
Seat 7: STAIRUS1989 ($2.49 in chips) 
Seat 8: dumbik89 ($4.67 in chips) 
Seat 9: AST@r85 ($6.41 in chips) 
Tigriana: posts small blind $0.01
RmbJN90: posts big blind $0.02
*** HOLE CARDS ***
Dealt to Redvin33 [7d 6s]
gelik32: folds 
Aenari: folds 
dai2173: folds 
STAIRUS1989: folds 
dumbik89: raises $0.04 to $0.06
AST@r85: calls $0.06
Redvin33: folds 
Tigriana: folds 
RmbJN90: folds 
*** FLOP *** [8h 4c 9s]
dumbik89: bets $0.08
AST@r85: folds 
Uncalled bet ($0.08) returned to dumbik89
dumbik89 collected $0.14 from pot
dumbik89: doesn't show hand 
*** SUMMARY ***
Total pot $0.15 | Rake $0.01 
Board [8h 4c 9s]
Seat 1: Redvin33 (button) folded before Flop (didn't bet)
Seat 2: Tigriana (small blind) folded before Flop
Seat 3: RmbJN90 (big blind) folded before Flop
Seat 4: gelik32 folded before Flop (didn't bet)
Seat 5: Aenari folded before Flop (didn't bet)
Seat 6: dai2173 folded before Flop (didn't bet)
Seat 7: STAIRUS1989 folded before Flop (didn't bet)
Seat 8: dumbik89 collected ($0.14)
Seat 9: AST@r85 folded on the Flop



PokerStars Zoom Hand #172845594593:  Hold'em No Limit ($0.01/$0.02) - 2017/07/10 8:46:34 ET
Table 'McNaught' 9-max Seat #1 is the button
Seat 1: Kazak0707 ($2 in chips) 
Seat 2: aleekseenko ($0.93 in chips) 
Seat 3: dai2173 ($1.66 in chips) 
Seat 4: teperweb1966 ($1.05 in chips) 
Seat 5: Redvin33 ($2.15 in chips) 
Seat 6: Bushika7 ($7.29 in chips) 
Seat 7: ateist177 ($2.25 in chips) 
Seat 8: Méry66 ($2.40 in chips) 
Seat 9: geyza15 ($2.02 in chips) 
aleekseenko: posts small blind $0.01
dai2173: posts big blind $0.02
*** HOLE CARDS ***
Dealt to Redvin33 [7s Th]
teperweb1966: folds 
Redvin33: folds 
Bushika7: folds 
ateist177: folds 
Méry66: folds 
geyza15: folds 
Kazak0707: folds 
aleekseenko: folds 
Uncalled bet ($0.01) returned to dai2173
dai2173 collected $0.02 from pot
dai2173: doesn't show hand 
*** SUMMARY ***
Total pot $0.02 | Rake $0 
Seat 1: Kazak0707 (button) folded before Flop (didn't bet)
Seat 2: aleekseenko (small blind) folded before Flop
Seat 3: dai2173 (big blind) collected ($0.02)
Seat 4: teperweb1966 folded before Flop (didn't bet)
Seat 5: Redvin33 folded before Flop (didn't bet)
Seat 6: Bushika7 folded before Flop (didn't bet)
Seat 7: ateist177 folded before Flop (didn't bet)
Seat 8: Méry66 folded before Flop (didn't bet)
Seat 9: geyza15 folded before Flop (didn't bet)



PokerStars Zoom Hand #172845596461:  Hold'em No Limit ($0.01/$0.02) - 2017/07/10 8:46:38 ET
Table 'McNaught' 9-max Seat #1 is the button
Seat 1: csssap ($3.18 in chips) 
Seat 2: Daedeo ($2.40 in chips) 
Seat 3: Beatsteak123 ($5.32 in chips) 
Seat 4: TKoniWolf ($2.11 in chips) 
Seat 5: Redvin33 ($2.15 in chips) 
Seat 6: amarlean ($2.26 in chips) 
Seat 7: rembo120 ($0.90 in chips) 
Seat 8: aleekseenko ($0.92 in chips) 
Seat 9: Poker in DNA ($3.78 in chips) 
Daedeo: posts small blind $0.01
Beatsteak123: posts big blind $0.02
*** HOLE CARDS ***
Dealt to Redvin33 [Qs 9s]
TKoniWolf: folds 
Redvin33: calls $0.02
amarlean: folds 
rembo120: folds 
aleekseenko: folds 
Poker in DNA: folds 
csssap: folds 
Daedeo: folds 
Beatsteak123: checks 
*** FLOP *** [4s 5d 9d]
Beatsteak123: checks 
Redvin33: bets $0.05
Beatsteak123: folds 
Uncalled bet ($0.05) returned to Redvin33
Redvin33 collected $0.05 from pot
Redvin33: doesn't show hand 
*** SUMMARY ***
Total pot $0.05 | Rake $0 
Board [4s 5d 9d]
Seat 1: csssap (button) folded before Flop (didn't bet)
Seat 2: Daedeo (small blind) folded before Flop
Seat 3: Beatsteak123 (big blind) folded on the Flop
Seat 4: TKoniWolf folded before Flop (didn't bet)
Seat 5: Redvin33 collected ($0.05)
Seat 6: amarlean folded before Flop (didn't bet)
Seat 7: rembo120 folded before Flop (didn't bet)
Seat 8: aleekseenko folded before Flop (didn't bet)
Seat 9: Poker in DNA folded before Flop (didn't bet)



PokerStars Zoom Hand #172845605532:  Hold'em No Limit ($0.01/$0.02) - 2017/07/10 8:46:57 ET
Table 'McNaught' 9-max Seat #1 is the button
Seat 1: Sparco771 ($2.15 in chips) 
Seat 2: BIS84 ($2 in chips) 
Seat 3: Méry66 ($1.38 in chips) 
Seat 4: Redvin33 ($2.18 in chips) 
Seat 5: GaliRah ($2.14 in chips) 
Seat 6: Tyoma_Kovach ($2.27 in chips) 
Seat 7: thetrumper77 ($1.70 in chips) 
Seat 8: raful1 ($2.24 in chips) 
Seat 9: JakeAV_8228 ($2 in chips) 
BIS84: posts small blind $0.01
Méry66: posts big blind $0.02
*** HOLE CARDS ***
Dealt to Redvin33 [Qc 5h]
Redvin33: folds 
GaliRah: folds 
Tyoma_Kovach: folds 
thetrumper77: folds 
raful1: folds 
JakeAV_8228: raises $0.06 to $0.08
Sparco771: folds 
BIS84: folds 
Méry66: folds 
Uncalled bet ($0.06) returned to JakeAV_8228
JakeAV_8228 collected $0.05 from pot
JakeAV_8228: doesn't show hand 
*** SUMMARY ***
Total pot $0.05 | Rake $0 
Seat 1: Sparco771 (button) folded before Flop (didn't bet)
Seat 2: BIS84 (small blind) folded before Flop
Seat 3: Méry66 (big blind) folded before Flop
Seat 4: Redvin33 folded before Flop (didn't bet)
Seat 5: GaliRah folded before Flop (didn't bet)
Seat 6: Tyoma_Kovach folded before Flop (didn't bet)
Seat 7: thetrumper77 folded before Flop (didn't bet)
Seat 8: raful1 folded before Flop (didn't bet)
Seat 9: JakeAV_8228 collected ($0.05)



PokerStars Zoom Hand #172845610803:  Hold'em No Limit ($0.01/$0.02) - 2017/07/10 8:47:08 ET
Table 'McNaught' 9-max Seat #1 is the button
Seat 1: Danil548 ($1.96 in chips) 
Seat 2: fedosov_ivan ($2.28 in chips) 
Seat 3: 45GARPUN45 ($3.17 in chips) 
Seat 4: Trallalak ($1.92 in chips) 
Seat 5: Redvin33 ($2.18 in chips) 
Seat 6: Kolya813 ($2 in chips) 
Seat 7: WinterCake ($4.06 in chips) 
Seat 8: enjoymeee ($1.62 in chips) 
Seat 9: Brianezi ($1.72 in chips) 
fedosov_ivan: posts small blind $0.01
45GARPUN45: posts big blind $0.02
*** HOLE CARDS ***
Dealt to Redvin33 [5s 6h]
Trallalak: folds 
Redvin33: folds 
Kolya813: folds 
WinterCake: folds 
enjoymeee: raises $0.04 to $0.06
Brianezi: folds 
Danil548: folds 
fedosov_ivan: folds 
45GARPUN45: folds 
Uncalled bet ($0.04) returned to enjoymeee
enjoymeee collected $0.05 from pot
enjoymeee: doesn't show hand 
*** SUMMARY ***
Total pot $0.05 | Rake $0 
Seat 1: Danil548 (button) folded before Flop (didn't bet)
Seat 2: fedosov_ivan (small blind) folded before Flop
Seat 3: 45GARPUN45 (big blind) folded before Flop
Seat 4: Trallalak folded before Flop (didn't bet)
Seat 5: Redvin33 folded before Flop (didn't bet)
Seat 6: Kolya813 folded before Flop (didn't bet)
Seat 7: WinterCake folded before Flop (didn't bet)
Seat 8: enjoymeee collected ($0.05)
Seat 9: Brianezi folded before Flop (didn't bet)



PokerStars Zoom Hand #172845609320:  Hold'em No Limit ($0.01/$0.02) - 2017/07/10 8:47:05 ET
Table 'McNaught' 9-max Seat #1 is the button
Seat 1: x@t@bich ($6.89 in chips) 
Seat 2: DARKLORRRD ($2.34 in chips) 
Seat 3: 45GARPUN45 ($4.31 in chips) 
Seat 4: Redvin33 ($2.18 in chips) 
Seat 5: Mizepa ($1.89 in chips) 
Seat 6: Lionvodoo ($2.76 in chips) 
Seat 7: ppoker_fac3 ($2.11 in chips) 
Seat 8: geyza15 ($2.04 in chips) 
Seat 9: TKoniWolf ($2.18 in chips) 
DARKLORRRD: posts small blind $0.01
45GARPUN45: posts big blind $0.02
*** HOLE CARDS ***
Dealt to Redvin33 [5d 3c]
Redvin33: folds 
Mizepa: folds 
Lionvodoo: folds 
ppoker_fac3: folds 
geyza15: raises $0.04 to $0.06
TKoniWolf: folds 
x@t@bich: folds 
DARKLORRRD: folds 
45GARPUN45: folds 
Uncalled bet ($0.04) returned to geyza15
geyza15 collected $0.05 from pot
geyza15: doesn't show hand 
*** SUMMARY ***
Total pot $0.05 | Rake $0 
Seat 1: x@t@bich (button) folded before Flop (didn't bet)
Seat 2: DARKLORRRD (small blind) folded before Flop
Seat 3: 45GARPUN45 (big blind) folded before Flop
Seat 4: Redvin33 folded before Flop (didn't bet)
Seat 5: Mizepa folded before Flop (didn't bet)
Seat 6: Lionvodoo folded before Flop (didn't bet)
Seat 7: ppoker_fac3 folded before Flop (didn't bet)
Seat 8: geyza15 collected ($0.05)
Seat 9: TKoniWolf folded before Flop (didn't bet)



PokerStars Zoom Hand #172845607436:  Hold'em No Limit ($0.01/$0.02) - 2017/07/10 8:47:01 ET
Table 'McNaught' 9-max Seat #1 is the button
Seat 1: komarilio ($2.90 in chips) 
Seat 2: Marthmer1 ($1.58 in chips) 
Seat 3: 157001 ($2 in chips) 
Seat 4: livingod00p ($2.21 in chips) 
Seat 5: Golon.Ro ($2.03 in chips) 
Seat 6: C-class man ($2 in chips) 
Seat 7: Redvin33 ($2.18 in chips) 
Seat 8: playpoker872 ($2.80 in chips) 
Seat 9: yuu0914 ($2.34 in chips) 
Marthmer1: posts small blind $0.01
157001: posts big blind $0.02
*** HOLE CARDS ***
Dealt to Redvin33 [7s Qh]
livingod00p has timed out
livingod00p: folds 
Golon.Ro: raises $0.02 to $0.04
C-class man: folds 
Redvin33: folds 
playpoker872: calls $0.04
yuu0914: folds 
komarilio: folds 
Marthmer1: folds 
157001: folds 
*** FLOP *** [Ah 6c Ac]
Golon.Ro: checks 
playpoker872: bets $0.06
Golon.Ro: calls $0.06
*** TURN *** [Ah 6c Ac] [Qc]
Golon.Ro: checks 
playpoker872: bets $0.10
Golon.Ro: raises $0.10 to $0.20
playpoker872: folds 
Uncalled bet ($0.10) returned to Golon.Ro
Golon.Ro collected $0.41 from pot
Golon.Ro: doesn't show hand 
*** SUMMARY ***
Total pot $0.43 | Rake $0.02 
Board [Ah 6c Ac Qc]
Seat 1: komarilio (button) folded before Flop (didn't bet)
Seat 2: Marthmer1 (small blind) folded before Flop
Seat 3: 157001 (big blind) folded before Flop
Seat 4: livingod00p folded before Flop (didn't bet)
Seat 5: Golon.Ro collected ($0.41)
Seat 6: C-class man folded before Flop (didn't bet)
Seat 7: Redvin33 folded before Flop (didn't bet)
Seat 8: playpoker872 folded on the Turn
Seat 9: yuu0914 folded before Flop (didn't bet)



PokerStars Zoom Hand #172845612725:  Hold'em No Limit ($0.01/$0.02) - 2017/07/10 8:47:12 ET
Table 'McNaught' 9-max Seat #1 is the button
Seat 1: GRaf872 ($1.56 in chips) 
Seat 2: Poker in DNA ($3.62 in chips) 
Seat 3: Redvin33 ($2.18 in chips) 
Seat 4: zibertmen ($1.86 in chips) 
Seat 5: RandomSteve8 ($0.88 in chips) 
Seat 6: CALL-09 ($1.76 in chips) 
Seat 7: CannonF0dder ($2 in chips) 
Seat 8: Tyoma_Kovach ($2.27 in chips) 
Seat 9: angrey867 ($1.44 in chips) 
Poker in DNA: posts small blind $0.01
Redvin33: posts big blind $0.02
*** HOLE CARDS ***
Dealt to Redvin33 [Th Ac]
zibertmen: folds 
RandomSteve8: folds 
CALL-09: folds 
CannonF0dder: folds 
Tyoma_Kovach: raises $0.04 to $0.06
angrey867: raises $0.04 to $0.10
GRaf872: folds 
Poker in DNA: folds 
Redvin33: calls $0.08
Tyoma_Kovach: calls $0.04
*** FLOP *** [Kd 9d 5d]
Redvin33: bets $0.13
Tyoma_Kovach: calls $0.13
angrey867: calls $0.13
*** TURN *** [Kd 9d 5d] [Td]
Redvin33: checks 
Tyoma_Kovach: bets $0.23
angrey867: calls $0.23
Redvin33: folds 
*** RIVER *** [Kd 9d 5d Td] [4d]
Tyoma_Kovach: bets $0.98
angrey867: folds 
Uncalled bet ($0.98) returned to Tyoma_Kovach
Tyoma_Kovach collected $1.12 from pot
Tyoma_Kovach: doesn't show hand 
*** SUMMARY ***
Total pot $1.16 | Rake $0.04 
Board [Kd 9d 5d Td 4d]
Seat 1: GRaf872 (button) folded before Flop (didn't bet)
Seat 2: Poker in DNA (small blind) folded before Flop
Seat 3: Redvin33 (big blind) folded on the Turn
Seat 4: zibertmen folded before Flop (didn't bet)
Seat 5: RandomSteve8 folded before Flop (didn't bet)
Seat 6: CALL-09 folded before Flop (didn't bet)
Seat 7: CannonF0dder folded before Flop (didn't bet)
Seat 8: Tyoma_Kovach collected ($1.12)
Seat 9: angrey867 folded on the River



PokerStars Zoom Hand #172845639211:  Hold'em No Limit ($0.01/$0.02) - 2017/07/10 8:48:08 ET
Table 'McNaught' 9-max Seat #1 is the button
Seat 1: Redvin33 ($1.94 in chips) 
Seat 2: Remi Martyn ($2 in chips) 
Seat 3: Anarckus ($2 in chips) 
Seat 4: muoshulll ($1.02 in chips) 
Seat 5: NearLin ($2.05 in chips) 
Seat 6: U_CTAC79 ($1.02 in chips) 
Seat 7: Ames21x ($2.92 in chips) 
Seat 8: Bendi86 ($1.97 in chips) 
Seat 9: ClailtonA. ($4.12 in chips) 
Remi Martyn: posts small blind $0.01
Anarckus: posts big blind $0.02
*** HOLE CARDS ***
Dealt to Redvin33 [3s 5s]
muoshulll: folds 
NearLin: folds 
U_CTAC79: folds 
Ames21x: folds 
Bendi86: folds 
ClailtonA.: folds 
Redvin33: folds 
Remi Martyn: raises $0.04 to $0.06
Anarckus: folds 
Uncalled bet ($0.04) returned to Remi Martyn
Remi Martyn collected $0.04 from pot
Remi Martyn: doesn't show hand 
*** SUMMARY ***
Total pot $0.04 | Rake $0 
Seat 1: Redvin33 (button) folded before Flop (didn't bet)
Seat 2: Remi Martyn (small blind) collected ($0.04)
Seat 3: Anarckus (big blind) folded before Flop
Seat 4: muoshulll folded before Flop (didn't bet)
Seat 5: NearLin folded before Flop (didn't bet)
Seat 6: U_CTAC79 folded before Flop (didn't bet)
Seat 7: Ames21x folded before Flop (didn't bet)
Seat 8: Bendi86 folded before Flop (didn't bet)
Seat 9: ClailtonA. folded before Flop (didn't bet)



PokerStars Zoom Hand #172845641052:  Hold'em No Limit ($0.01/$0.02) - 2017/07/10 8:48:12 ET
Table 'McNaught' 9-max Seat #1 is the button
Seat 1: Antovka ($2 in chips) 
Seat 2: aleekseenko ($0.64 in chips) 
Seat 3: TatRus38 ($1.80 in chips) 
Seat 4: DenBoss77 ($2.07 in chips) 
Seat 5: dai2173 ($2.12 in chips) 
Seat 6: TKoniWolf ($3.47 in chips) 
Seat 7: oceanman666 ($1.31 in chips) 
Seat 8: Mr.Aran73 ($2.40 in chips) 
Seat 9: Redvin33 ($1.94 in chips) 
aleekseenko: posts small blind $0.01
TatRus38: posts big blind $0.02
*** HOLE CARDS ***
Dealt to Redvin33 [2s 2c]
DenBoss77: folds 
dai2173: folds 
TKoniWolf: folds 
oceanman666: folds 
Mr.Aran73: raises $0.02 to $0.04
Redvin33: calls $0.04
Antovka: folds 
aleekseenko: folds 
TatRus38: calls $0.02
*** FLOP *** [Qc 2d 4d]
TatRus38: checks 
Mr.Aran73: checks 
Redvin33: bets $0.02
TatRus38: calls $0.02
Mr.Aran73: raises $0.08 to $0.10
Redvin33: raises $0.08 to $0.18
TatRus38: folds 
Mr.Aran73: calls $0.08
*** TURN *** [Qc 2d 4d] [3c]
Mr.Aran73: checks 
Redvin33: bets $0.12
Mr.Aran73: calls $0.12
*** RIVER *** [Qc 2d 4d 3c] [5d]
Mr.Aran73: checks 
Redvin33: checks 
*** SHOW DOWN ***
Mr.Aran73: shows [7h 7s] (a pair of Sevens)
Redvin33: shows [2s 2c] (three of a kind, Deuces)
Redvin33 collected $0.72 from pot
*** SUMMARY ***
Total pot $0.75 | Rake $0.03 
Board [Qc 2d 4d 3c 5d]
Seat 1: Antovka (button) folded before Flop (didn't bet)
Seat 2: aleekseenko (small blind) folded before Flop
Seat 3: TatRus38 (big blind) folded on the Flop
Seat 4: DenBoss77 folded before Flop (didn't bet)
Seat 5: dai2173 folded before Flop (didn't bet)
Seat 6: TKoniWolf folded before Flop (didn't bet)
Seat 7: oceanman666 folded before Flop (didn't bet)
Seat 8: Mr.Aran73 showed [7h 7s] and lost with a pair of Sevens
Seat 9: Redvin33 showed [2s 2c] and won ($0.72) with three of a kind, Deuces



PokerStars Zoom Hand #172845636851:  Hold'em No Limit ($0.01/$0.02) - 2017/07/10 8:48:03 ET
Table 'McNaught' 9-max Seat #1 is the button
Seat 1: BrightCat ($2.15 in chips) 
Seat 2: Redvin33 ($1.95 in chips) 
Seat 3: Mizepa ($2 in chips) 
Seat 4: godlikelo ($3.85 in chips) 
Seat 5: Anarckus ($2 in chips) 
Seat 6: STAIRUS1989 ($2.13 in chips) 
Seat 7: omlog ($2.93 in chips) 
Seat 8: Fixitys ($2.25 in chips) 
Seat 9: ms1272 ($2 in chips) 
Redvin33: posts small blind $0.01
Mizepa: posts big blind $0.02
*** HOLE CARDS ***
Dealt to Redvin33 [4h Kh]
godlikelo: folds 
Anarckus: folds 
STAIRUS1989: folds 
omlog: raises $0.04 to $0.06
Fixitys: folds 
ms1272: folds 
BrightCat: folds 
Redvin33: folds 
Mizepa: calls $0.04
*** FLOP *** [5h 4d 8d]
Mizepa: bets $0.07
omlog: calls $0.07
*** TURN *** [5h 4d 8d] [Ad]
Mizepa: bets $0.13
omlog: calls $0.13
*** RIVER *** [5h 4d 8d Ad] [Th]
Mizepa: checks 
omlog: bets $0.28
Mizepa: calls $0.28
*** SHOW DOWN ***
omlog: shows [Jd Td] (a flush, Ace high)
Mizepa: mucks hand 
omlog collected $1.05 from pot
*** SUMMARY ***
Total pot $1.09 | Rake $0.04 
Board [5h 4d 8d Ad Th]
Seat 1: BrightCat (button) folded before Flop (didn't bet)
Seat 2: Redvin33 (small blind) folded before Flop
Seat 3: Mizepa (big blind) mucked [Js As]
Seat 4: godlikelo folded before Flop (didn't bet)
Seat 5: Anarckus folded before Flop (didn't bet)
Seat 6: STAIRUS1989 folded before Flop (didn't bet)
Seat 7: omlog showed [Jd Td] and won ($1.05) with a flush, Ace high
Seat 8: Fixitys folded before Flop (didn't bet)
Seat 9: ms1272 folded before Flop (didn't bet)



PokerStars Zoom Hand #172845661738:  Hold'em No Limit ($0.01/$0.02) - 2017/07/10 8:48:56 ET
Table 'McNaught' 9-max Seat #1 is the button
Seat 1: smopuim ($2.40 in chips) 
Seat 2: Gibsondelux ($1.95 in chips) 
Seat 3: playpoker872 ($2.59 in chips) 
Seat 4: Plmax94 ($1.63 in chips) 
Seat 5: noborder69 ($3.17 in chips) 
Seat 6: bleuvie ($1.92 in chips) 
Seat 7: BIS84 ($2 in chips) 
Seat 8: Redvin33 ($2.32 in chips) 
Seat 9: Azazell0666 ($4.12 in chips) 
Gibsondelux: posts small blind $0.01
playpoker872: posts big blind $0.02
*** HOLE CARDS ***
Dealt to Redvin33 [Ac Jd]
Plmax94: folds 
noborder69: folds 
bleuvie: folds 
BIS84: folds 
Redvin33: raises $0.03 to $0.05
Azazell0666: calls $0.05
smopuim: folds 
Gibsondelux: folds 
playpoker872: folds 
*** FLOP *** [4c 6h 2c]
Redvin33: bets $0.04
Azazell0666: calls $0.04
*** TURN *** [4c 6h 2c] [2s]
Redvin33: bets $0.12
Azazell0666: calls $0.12
*** RIVER *** [4c 6h 2c 2s] [Qd]
Redvin33: checks 
Azazell0666: checks 
*** SHOW DOWN ***
Redvin33: shows [Ac Jd] (a pair of Deuces)
Azazell0666: mucks hand 
Redvin33 collected $0.43 from pot
*** SUMMARY ***
Total pot $0.45 | Rake $0.02 
Board [4c 6h 2c 2s Qd]
Seat 1: smopuim (button) folded before Flop (didn't bet)
Seat 2: Gibsondelux (small blind) folded before Flop
Seat 3: playpoker872 (big blind) folded before Flop
Seat 4: Plmax94 folded before Flop (didn't bet)
Seat 5: noborder69 folded before Flop (didn't bet)
Seat 6: bleuvie folded before Flop (didn't bet)
Seat 7: BIS84 folded before Flop (didn't bet)
Seat 8: Redvin33 showed [Ac Jd] and won ($0.43) with a pair of Deuces
Seat 9: Azazell0666 mucked [7h Ah]



PokerStars Zoom Hand #172845677903:  Hold'em No Limit ($0.01/$0.02) - 2017/07/10 8:49:31 ET
Table 'McNaught' 9-max Seat #1 is the button
Seat 1: ocrimus ($4.10 in chips) 
Seat 2: amarlean ($2.11 in chips) 
Seat 3: RandomSteve8 ($0.90 in chips) 
Seat 4: zibertmen ($1.72 in chips) 
Seat 5: Kadorci ($0.76 in chips) 
Seat 6: RodeoBox ($6.12 in chips) 
Seat 7: Redvin33 ($2.54 in chips) 
Seat 8: livingod00p ($1.63 in chips) 
Seat 9: kolobok895 ($1.99 in chips) 
amarlean: posts small blind $0.01
RandomSteve8: posts big blind $0.02
*** HOLE CARDS ***
Dealt to Redvin33 [Ah Qs]
zibertmen: folds 
Kadorci: folds 
RodeoBox: folds 
Redvin33: raises $0.03 to $0.05
livingod00p: folds 
kolobok895: folds 
ocrimus: folds 
amarlean: folds 
RandomSteve8: calls $0.03
*** FLOP *** [3c Kh 5h]
RandomSteve8: checks 
Redvin33: checks 
*** TURN *** [3c Kh 5h] [2c]
RandomSteve8: checks 
Redvin33: bets $0.04
RandomSteve8: folds 
Uncalled bet ($0.04) returned to Redvin33
Redvin33 collected $0.11 from pot
Redvin33: doesn't show hand 
*** SUMMARY ***
Total pot $0.11 | Rake $0 
Board [3c Kh 5h 2c]
Seat 1: ocrimus (button) folded before Flop (didn't bet)
Seat 2: amarlean (small blind) folded before Flop
Seat 3: RandomSteve8 (big blind) folded on the Turn
Seat 4: zibertmen folded before Flop (didn't bet)
Seat 5: Kadorci folded before Flop (didn't bet)
Seat 6: RodeoBox folded before Flop (didn't bet)
Seat 7: Redvin33 collected ($0.11)
Seat 8: livingod00p folded before Flop (didn't bet)
Seat 9: kolobok895 folded before Flop (didn't bet)



PokerStars Zoom Hand #172845694299:  Hold'em No Limit ($0.01/$0.02) - 2017/07/10 8:50:06 ET
Table 'McNaught' 9-max Seat #1 is the button
Seat 1: Tigriana ($3.09 in chips) 
Seat 2: CALL-09 ($1.81 in chips) 
Seat 3: Marthmer1 ($1.75 in chips) 
Seat 4: FullHouse525 ($2 in chips) 
Seat 5: ms1272 ($2.22 in chips) 
Seat 6: Redvin33 ($2.60 in chips) 
Seat 7: Azazell0666 ($2.17 in chips) 
Seat 8: Rurius ($2.03 in chips) 
Seat 9: Kolya813 ($2.96 in chips) 
CALL-09: posts small blind $0.01
Marthmer1: posts big blind $0.02
*** HOLE CARDS ***
Dealt to Redvin33 [8c Ah]
FullHouse525: folds 
ms1272: folds 
Redvin33: raises $0.03 to $0.05
Azazell0666: folds 
Rurius: raises $0.13 to $0.18
Kolya813: folds 
Tigriana: folds 
CALL-09: folds 
Marthmer1: folds 
Redvin33: folds 
Uncalled bet ($0.13) returned to Rurius
Rurius collected $0.13 from pot
Rurius: doesn't show hand 
*** SUMMARY ***
Total pot $0.13 | Rake $0 
Seat 1: Tigriana (button) folded before Flop (didn't bet)
Seat 2: CALL-09 (small blind) folded before Flop
Seat 3: Marthmer1 (big blind) folded before Flop
Seat 4: FullHouse525 folded before Flop (didn't bet)
Seat 5: ms1272 folded before Flop (didn't bet)
Seat 6: Redvin33 folded before Flop
Seat 7: Azazell0666 folded before Flop (didn't bet)
Seat 8: Rurius collected ($0.13)
Seat 9: Kolya813 folded before Flop (didn't bet)



PokerStars Zoom Hand #172845702692:  Hold'em No Limit ($0.01/$0.02) - 2017/07/10 8:50:24 ET
Table 'McNaught' 9-max Seat #1 is the button
Seat 1: Danil548 ($1.96 in chips) 
Seat 2: garça409 ($1.11 in chips) 
Seat 3: keliosu2385 ($6.72 in chips) 
Seat 4: koyutaka ($0.57 in chips) 
Seat 5: Tigriana ($3.09 in chips) 
Seat 6: Redvin33 ($2.55 in chips) 
Seat 7: tina86722 ($0.76 in chips) 
Seat 8: amarlean ($2.17 in chips) 
Seat 9: mikvesik ($2.03 in chips) 
garça409: posts small blind $0.01
keliosu2385: posts big blind $0.02
*** HOLE CARDS ***
Dealt to Redvin33 [Ts Js]
koyutaka: folds 
Tigriana: raises $0.02 to $0.04
Redvin33: raises $0.02 to $0.06
tina86722: folds 
amarlean: folds 
mikvesik: folds 
Danil548: folds 
garça409: folds 
keliosu2385: folds 
Tigriana: calls $0.02
*** FLOP *** [5c 7s 4h]
Tigriana: checks 
Redvin33: bets $0.06
Tigriana: calls $0.06
*** TURN *** [5c 7s 4h] [3d]
Tigriana: checks 
Redvin33: checks 
*** RIVER *** [5c 7s 4h 3d] [6s]
Tigriana: bets $0.06
Redvin33: calls $0.06
*** SHOW DOWN ***
Tigriana: shows [9c 9d] (a straight, Three to Seven)
Redvin33: shows [Ts Js] (a straight, Three to Seven)
Tigriana collected $0.19 from pot
Redvin33 collected $0.19 from pot
*** SUMMARY ***
Total pot $0.39 | Rake $0.01 
Board [5c 7s 4h 3d 6s]
Seat 1: Danil548 (button) folded before Flop (didn't bet)
Seat 2: garça409 (small blind) folded before Flop
Seat 3: keliosu2385 (big blind) folded before Flop
Seat 4: koyutaka folded before Flop (didn't bet)
Seat 5: Tigriana showed [9c 9d] and won ($0.19) with a straight, Three to Seven
Seat 6: Redvin33 showed [Ts Js] and won ($0.19) with a straight, Three to Seven
Seat 7: tina86722 folded before Flop (didn't bet)
Seat 8: amarlean folded before Flop (didn't bet)
Seat 9: mikvesik folded before Flop (didn't bet)



PokerStars Zoom Hand #172845722254:  Hold'em No Limit ($0.01/$0.02) - 2017/07/10 8:51:06 ET
Table 'McNaught' 9-max Seat #1 is the button
Seat 1: DenBoss77 ($2.21 in chips) 
Seat 2: WinterCake ($2.39 in chips) 
Seat 3: Lu4EV ($1.99 in chips) 
Seat 4: Redvin33 ($2.56 in chips) 
Seat 5: dragonlot ($3.07 in chips) 
Seat 6: Lionvodoo ($4.79 in chips) 
Seat 7: dumbik89 ($3.95 in chips) 
Seat 8: levikeeeLOL ($2.32 in chips) 
Seat 9: Panzagoth ($2.47 in chips) 
WinterCake: posts small blind $0.01
Lu4EV: posts big blind $0.02
*** HOLE CARDS ***
Dealt to Redvin33 [Td 8h]
Redvin33: raises $0.04 to $0.06
dragonlot: folds 
Lionvodoo: folds 
dumbik89: folds 
levikeeeLOL: folds 
Panzagoth: calls $0.06
DenBoss77: folds 
WinterCake: calls $0.05
Lu4EV: folds 
*** FLOP *** [Ah Qc Tc]
WinterCake: checks 
Redvin33: bets $0.06
Panzagoth: folds 
WinterCake: calls $0.06
*** TURN *** [Ah Qc Tc] [5s]
WinterCake: checks 
Redvin33: checks 
*** RIVER *** [Ah Qc Tc 5s] [Jc]
WinterCake: checks 
Redvin33: checks 
*** SHOW DOWN ***
WinterCake: shows [9h Jh] (a pair of Jacks)
Redvin33: mucks hand 
WinterCake collected $0.31 from pot
*** SUMMARY ***
Total pot $0.32 | Rake $0.01 
Board [Ah Qc Tc 5s Jc]
Seat 1: DenBoss77 (button) folded before Flop (didn't bet)
Seat 2: WinterCake (small blind) showed [9h Jh] and won ($0.31) with a pair of Jacks
Seat 3: Lu4EV (big blind) folded before Flop
Seat 4: Redvin33 mucked [Td 8h]
Seat 5: dragonlot folded before Flop (didn't bet)
Seat 6: Lionvodoo folded before Flop (didn't bet)
Seat 7: dumbik89 folded before Flop (didn't bet)
Seat 8: levikeeeLOL folded before Flop (didn't bet)
Seat 9: Panzagoth folded on the Flop



PokerStars Zoom Hand #172845720406:  Hold'em No Limit ($0.01/$0.02) - 2017/07/10 8:51:02 ET
Table 'McNaught' 9-max Seat #1 is the button
Seat 1: Jugla112 ($1.55 in chips) 
Seat 2: Aves30 ($1.87 in chips) 
Seat 3: Yroslav Mudr ($2 in chips) 
Seat 4: Litwack ($2 in chips) 
Seat 5: Lu4EV ($1.99 in chips) 
Seat 6: nicky3020 ($1.97 in chips) 
Seat 7: CALL-09 ($1.61 in chips) 
Seat 8: keliosu2385 ($6.73 in chips) 
Seat 9: Redvin33 ($2.56 in chips) 
Aves30: posts small blind $0.01
Yroslav Mudr: posts big blind $0.02
*** HOLE CARDS ***
Dealt to Redvin33 [5s 7c]
Litwack: folds 
Lu4EV: folds 
nicky3020: folds 
CALL-09: raises $0.02 to $0.04
keliosu2385: calls $0.04
Redvin33: folds 
Jugla112: folds 
Aves30 is disconnected 
Aves30 is connected 
Aves30 has timed out
Aves30: folds 
Yroslav Mudr: folds 
*** FLOP *** [9s 9d 2c]
CALL-09: checks 
keliosu2385: checks 
*** TURN *** [9s 9d 2c] [5d]
CALL-09: checks 
keliosu2385: bets $0.10
CALL-09: folds 
Uncalled bet ($0.10) returned to keliosu2385
keliosu2385 collected $0.11 from pot
keliosu2385: doesn't show hand 
*** SUMMARY ***
Total pot $0.11 | Rake $0 
Board [9s 9d 2c 5d]
Seat 1: Jugla112 (button) folded before Flop (didn't bet)
Seat 2: Aves30 (small blind) folded before Flop
Seat 3: Yroslav Mudr (big blind) folded before Flop
Seat 4: Litwack folded before Flop (didn't bet)
Seat 5: Lu4EV folded before Flop (didn't bet)
Seat 6: nicky3020 folded before Flop (didn't bet)
Seat 7: CALL-09 folded on the Turn
Seat 8: keliosu2385 collected ($0.11)
Seat 9: Redvin33 folded before Flop (didn't bet)



PokerStars Zoom Hand #172845744244:  Hold'em No Limit ($0.01/$0.02) - 2017/07/10 8:51:53 ET
Table 'McNaught' 9-max Seat #1 is the button
Seat 1: 999VORON999 ($2.58 in chips) 
Seat 2: nicky3020 ($2 in chips) 
Seat 3: Redvin33 ($2.44 in chips) 
Seat 4: livingod00p ($3.49 in chips) 
Seat 5: x@t@bich ($7.09 in chips) 
Seat 6: fedosov_ivan ($2.35 in chips) 
Seat 7: KennYLance ($1.30 in chips) 
Seat 8: Beatsteak123 ($2.06 in chips) 
Seat 9: tim8526 ($2.19 in chips) 
nicky3020: posts small blind $0.01
Redvin33: posts big blind $0.02
*** HOLE CARDS ***
Dealt to Redvin33 [Kh 6h]
livingod00p has timed out
livingod00p: folds 
x@t@bich: folds 
fedosov_ivan: raises $0.04 to $0.06
KennYLance: folds 
Beatsteak123: folds 
tim8526: folds 
999VORON999: raises $0.15 to $0.21
nicky3020: folds 
Redvin33: folds 
fedosov_ivan: folds 
Uncalled bet ($0.15) returned to 999VORON999
999VORON999 collected $0.15 from pot
999VORON999: doesn't show hand 
*** SUMMARY ***
Total pot $0.15 | Rake $0 
Seat 1: 999VORON999 (button) collected ($0.15)
Seat 2: nicky3020 (small blind) folded before Flop
Seat 3: Redvin33 (big blind) folded before Flop
Seat 4: livingod00p folded before Flop (didn't bet)
Seat 5: x@t@bich folded before Flop (didn't bet)
Seat 6: fedosov_ivan folded before Flop
Seat 7: KennYLance folded before Flop (didn't bet)
Seat 8: Beatsteak123 folded before Flop (didn't bet)
Seat 9: tim8526 folded before Flop (didn't bet)



PokerStars Zoom Hand #172845765422:  Hold'em No Limit ($0.01/$0.02) - 2017/07/10 8:52:38 ET
Table 'McNaught' 9-max Seat #1 is the button
Seat 1: Redvin33 ($2.41 in chips) 
Seat 2: moya_muse ($2.01 in chips) 
Seat 3: Playground90 ($2 in chips) 
Seat 4: teperweb1966 ($1.12 in chips) 
Seat 5: Mizepa ($3.80 in chips) 
Seat 6: msk jeanke ($2.63 in chips) 
Seat 7: TKoniWolf ($2.09 in chips) 
Seat 8: Sparco771 ($2.08 in chips) 
Seat 9: dblthnkr ($2.11 in chips) 
moya_muse: posts small blind $0.01
Playground90: posts big blind $0.02
*** HOLE CARDS ***
Dealt to Redvin33 [4h 3s]
teperweb1966: folds 
Mizepa: folds 
msk jeanke: folds 
TKoniWolf: raises $0.04 to $0.06
Sparco771: folds 
dblthnkr: folds 
Redvin33: folds 
moya_muse: folds 
Playground90: folds 
Uncalled bet ($0.04) returned to TKoniWolf
TKoniWolf collected $0.05 from pot
TKoniWolf: doesn't show hand 
*** SUMMARY ***
Total pot $0.05 | Rake $0 
Seat 1: Redvin33 (button) folded before Flop (didn't bet)
Seat 2: moya_muse (small blind) folded before Flop
Seat 3: Playground90 (big blind) folded before Flop
Seat 4: teperweb1966 folded before Flop (didn't bet)
Seat 5: Mizepa folded before Flop (didn't bet)
Seat 6: msk jeanke folded before Flop (didn't bet)
Seat 7: TKoniWolf collected ($0.05)
Seat 8: Sparco771 folded before Flop (didn't bet)
Seat 9: dblthnkr folded before Flop (didn't bet)



PokerStars Zoom Hand #172845767242:  Hold'em No Limit ($0.01/$0.02) - 2017/07/10 8:52:42 ET
Table 'McNaught' 9-max Seat #1 is the button
Seat 1: Beatsteak123 ($5.15 in chips) 
Seat 2: SERGEY 26RUS ($4.72 in chips) 
Seat 3: petcook ($2.91 in chips) 
Seat 4: Lu4EV ($1.57 in chips) 
Seat 5: Ohmderohm ($2.15 in chips) 
Seat 6: kisjoe96 ($1.16 in chips) 
Seat 7: zibertmen ($5.48 in chips) 
Seat 8: Redvin33 ($2.41 in chips) 
Seat 9: hdjd6743 ($2.50 in chips) 
SERGEY 26RUS: posts small blind $0.01
petcook: posts big blind $0.02
*** HOLE CARDS ***
Dealt to Redvin33 [Th 9c]
Lu4EV: folds 
Ohmderohm: folds 
kisjoe96: folds 
zibertmen: folds 
Redvin33: raises $0.02 to $0.04
hdjd6743: raises $0.09 to $0.13
Beatsteak123: folds 
SERGEY 26RUS: folds 
petcook: folds 
Redvin33: folds 
Uncalled bet ($0.09) returned to hdjd6743
hdjd6743 collected $0.11 from pot
hdjd6743: doesn't show hand 
*** SUMMARY ***
Total pot $0.11 | Rake $0 
Seat 1: Beatsteak123 (button) folded before Flop (didn't bet)
Seat 2: SERGEY 26RUS (small blind) folded before Flop
Seat 3: petcook (big blind) folded before Flop
Seat 4: Lu4EV folded before Flop (didn't bet)
Seat 5: Ohmderohm folded before Flop (didn't bet)
Seat 6: kisjoe96 folded before Flop (didn't bet)
Seat 7: zibertmen folded before Flop (didn't bet)
Seat 8: Redvin33 folded before Flop
Seat 9: hdjd6743 collected ($0.11)



PokerStars Zoom Hand #172845763127:  Hold'em No Limit ($0.01/$0.02) - 2017/07/10 8:52:33 ET
Table 'McNaught' 9-max Seat #1 is the button
Seat 1: Antovka ($2 in chips) 
Seat 2: Redvin33 ($2.42 in chips) 
Seat 3: x@t@bich ($6.90 in chips) 
Seat 4: Burbulacus ($2.36 in chips) 
Seat 5: YOHONSON ($2 in chips) 
Seat 6: kweuf ($1.79 in chips) 
Seat 7: Vikta8 ($0.52 in chips) 
Seat 8: msk jeanke ($2.63 in chips) 
Seat 9: raven5175 ($0.87 in chips) 
Redvin33: posts small blind $0.01
x@t@bich: posts big blind $0.02
*** HOLE CARDS ***
Dealt to Redvin33 [Kd 8h]
Burbulacus: folds 
YOHONSON: folds 
kweuf: folds 
Vikta8: folds 
msk jeanke: folds 
raven5175: calls $0.02
Antovka: folds 
Redvin33: folds 
x@t@bich: checks 
*** FLOP *** [Ts Kh 7c]
x@t@bich: checks 
raven5175: checks 
*** TURN *** [Ts Kh 7c] [Ks]
x@t@bich: checks 
raven5175: checks 
*** RIVER *** [Ts Kh 7c Ks] [Kc]
x@t@bich: checks 
raven5175: checks 
*** SHOW DOWN ***
x@t@bich: shows [3s 2s] (three of a kind, Kings)
raven5175: shows [3d 3h] (a full house, Kings full of Threes)
raven5175 collected $0.05 from pot
*** SUMMARY ***
Total pot $0.05 | Rake $0 
Board [Ts Kh 7c Ks Kc]
Seat 1: Antovka (button) folded before Flop (didn't bet)
Seat 2: Redvin33 (small blind) folded before Flop
Seat 3: x@t@bich (big blind) showed [3s 2s] and lost with three of a kind, Kings
Seat 4: Burbulacus folded before Flop (didn't bet)
Seat 5: YOHONSON folded before Flop (didn't bet)
Seat 6: kweuf folded before Flop (didn't bet)
Seat 7: Vikta8 folded before Flop (didn't bet)
Seat 8: msk jeanke folded before Flop (didn't bet)
Seat 9: raven5175 showed [3d 3h] and won ($0.05) with a full house, Kings full of Threes



PokerStars Zoom Hand #172845773846:  Hold'em No Limit ($0.01/$0.02) - 2017/07/10 8:52:56 ET
Table 'McNaught' 9-max Seat #1 is the button
Seat 1: Remi Martyn ($2.07 in chips) 
Seat 2: VellGood ($2.96 in chips) 
Seat 3: nikmir34 ($2.27 in chips) 
Seat 4: mfgkk ($2.51 in chips) 
Seat 5: denibest ($2 in chips) 
Seat 6: SERGEY 26RUS ($4.71 in chips) 
Seat 7: Redvin33 ($2.37 in chips) 
Seat 8: aleekseenko ($0.49 in chips) 
Seat 9: ClailtonA. ($4.13 in chips) 
VellGood: posts small blind $0.01
nikmir34: posts big blind $0.02
*** HOLE CARDS ***
Dealt to Redvin33 [Jh Ts]
mfgkk: folds 
denibest: folds 
SERGEY 26RUS: folds 
Redvin33: folds 
aleekseenko: folds 
ClailtonA.: folds 
Remi Martyn: folds 
VellGood: folds 
Uncalled bet ($0.01) returned to nikmir34
nikmir34 collected $0.02 from pot
nikmir34: doesn't show hand 
*** SUMMARY ***
Total pot $0.02 | Rake $0 
Seat 1: Remi Martyn (button) folded before Flop (didn't bet)
Seat 2: VellGood (small blind) folded before Flop
Seat 3: nikmir34 (big blind) collected ($0.02)
Seat 4: mfgkk folded before Flop (didn't bet)
Seat 5: denibest folded before Flop (didn't bet)
Seat 6: SERGEY 26RUS folded before Flop (didn't bet)
Seat 7: Redvin33 folded before Flop (didn't bet)
Seat 8: aleekseenko folded before Flop (didn't bet)
Seat 9: ClailtonA. folded before Flop (didn't bet)



PokerStars Zoom Hand #172845776570:  Hold'em No Limit ($0.01/$0.02) - 2017/07/10 8:53:02 ET
Table 'McNaught' 9-max Seat #1 is the button
Seat 1: Beatsteak123 ($2.50 in chips) 
Seat 2: HODYS100 ($1.77 in chips) 
Seat 3: RDN Jonny ($2.04 in chips) 
Seat 4: Redvin33 ($2.37 in chips) 
Seat 5: Litwack ($2 in chips) 
Seat 6: C-class man ($2.44 in chips) 
Seat 7: amarlean ($2.20 in chips) 
Seat 8: bilimb ($1.04 in chips) 
Seat 9: gelik32 ($2 in chips) 
HODYS100: posts small blind $0.01
RDN Jonny: posts big blind $0.02
*** HOLE CARDS ***
Dealt to Redvin33 [Qs 8c]
Redvin33: folds 
Litwack: folds 
C-class man: folds 
amarlean: folds 
bilimb: folds 
gelik32: folds 
Beatsteak123: folds 
HODYS100: folds 
Uncalled bet ($0.01) returned to RDN Jonny
RDN Jonny collected $0.02 from pot
RDN Jonny: doesn't show hand 
*** SUMMARY ***
Total pot $0.02 | Rake $0 
Seat 1: Beatsteak123 (button) folded before Flop (didn't bet)
Seat 2: HODYS100 (small blind) folded before Flop
Seat 3: RDN Jonny (big blind) collected ($0.02)
Seat 4: Redvin33 folded before Flop (didn't bet)
Seat 5: Litwack folded before Flop (didn't bet)
Seat 6: C-class man folded before Flop (didn't bet)
Seat 7: amarlean folded before Flop (didn't bet)
Seat 8: bilimb folded before Flop (didn't bet)
Seat 9: gelik32 folded before Flop (didn't bet)



PokerStars Zoom Hand #172845780403:  Hold'em No Limit ($0.01/$0.02) - 2017/07/10 8:53:10 ET
Table 'McNaught' 9-max Seat #1 is the button
Seat 1: RemainTheSame ($1.78 in chips) 
Seat 2: aleekseenko ($1 in chips) 
Seat 3: Redvin33 ($2.37 in chips) 
Seat 4: Antovka ($2 in chips) 
Seat 5: JakeAV_8228 ($2 in chips) 
Seat 6: dimaChess ($1.52 in chips) 
Seat 7: yrec_f1 ($0.51 in chips) 
Seat 8: BeWorry ($2.59 in chips) 
Seat 9: DonAnris ($1.95 in chips) 
aleekseenko: posts small blind $0.01
Redvin33: posts big blind $0.02
*** HOLE CARDS ***
Dealt to Redvin33 [5d Td]
Antovka: folds 
JakeAV_8228: folds 
dimaChess: folds 
yrec_f1: folds 
BeWorry: folds 
DonAnris: folds 
RemainTheSame: folds 
aleekseenko: folds 
Uncalled bet ($0.01) returned to Redvin33
Redvin33 collected $0.02 from pot
Redvin33: doesn't show hand 
*** SUMMARY ***
Total pot $0.02 | Rake $0 
Seat 1: RemainTheSame (button) folded before Flop (didn't bet)
Seat 2: aleekseenko (small blind) folded before Flop
Seat 3: Redvin33 (big blind) collected ($0.02)
Seat 4: Antovka folded before Flop (didn't bet)
Seat 5: JakeAV_8228 folded before Flop (didn't bet)
Seat 6: dimaChess folded before Flop (didn't bet)
Seat 7: yrec_f1 folded before Flop (didn't bet)
Seat 8: BeWorry folded before Flop (didn't bet)
Seat 9: DonAnris folded before Flop (didn't bet)



PokerStars Zoom Hand #172845778506:  Hold'em No Limit ($0.01/$0.02) - 2017/07/10 8:53:06 ET
Table 'McNaught' 9-max Seat #1 is the button
Seat 1: JeckTen ($2 in chips) 
Seat 2: godlikelo ($3.90 in chips) 
Seat 3: STAIRUS1989 ($3.83 in chips) 
Seat 4: RmbJN90 ($2.88 in chips) 
Seat 5: Redvin33 ($2.37 in chips) 
Seat 6: Ames21x ($3.35 in chips) 
Seat 7: 1000000$ ANA ($2 in chips) 
Seat 8: Antovka ($2 in chips) 
Seat 9: SaxpianikonR ($12.82 in chips) 
godlikelo: posts small blind $0.01
STAIRUS1989: posts big blind $0.02
*** HOLE CARDS ***
Dealt to Redvin33 [5d Qc]
RmbJN90: folds 
Redvin33: folds 
Ames21x: folds 
1000000$ ANA: folds 
Antovka: folds 
SaxpianikonR: folds 
JeckTen: raises $0.03 to $0.05
godlikelo: calls $0.04
STAIRUS1989: folds 
*** FLOP *** [Qs Qd 9h]
godlikelo: checks 
JeckTen: bets $0.07
godlikelo: folds 
Uncalled bet ($0.07) returned to JeckTen
JeckTen collected $0.12 from pot
JeckTen: doesn't show hand 
*** SUMMARY ***
Total pot $0.12 | Rake $0 
Board [Qs Qd 9h]
Seat 1: JeckTen (button) collected ($0.12)
Seat 2: godlikelo (small blind) folded on the Flop
Seat 3: STAIRUS1989 (big blind) folded before Flop
Seat 4: RmbJN90 folded before Flop (didn't bet)
Seat 5: Redvin33 folded before Flop (didn't bet)
Seat 6: Ames21x folded before Flop (didn't bet)
Seat 7: 1000000$ ANA folded before Flop (didn't bet)
Seat 8: Antovka folded before Flop (didn't bet)
Seat 9: SaxpianikonR folded before Flop (didn't bet)



PokerStars Zoom Hand #172845785108:  Hold'em No Limit ($0.01/$0.02) - 2017/07/10 8:53:20 ET
Table 'McNaught' 9-max Seat #1 is the button
Seat 1: nikmir34 ($2.28 in chips) 
Seat 2: smopuim ($2.21 in chips) 
Seat 3: Litwack ($2.18 in chips) 
Seat 4: Redvin33 ($2.38 in chips) 
Seat 5: ionazun ($2 in chips) 
Seat 6: omlog ($2.01 in chips) 
Seat 7: BIS84 ($2.23 in chips) 
Seat 8: Anarckus ($2.29 in chips) 
Seat 9: DenBoss77 ($2.20 in chips) 
smopuim: posts small blind $0.01
Litwack: posts big blind $0.02
*** HOLE CARDS ***
Dealt to Redvin33 [Ad 2d]
Redvin33: calls $0.02
ionazun: folds 
omlog: folds 
BIS84: folds 
Anarckus: folds 
DenBoss77: raises $0.04 to $0.06
nikmir34: folds 
smopuim: calls $0.05
Litwack: folds 
Redvin33: calls $0.04
*** FLOP *** [8d 6s 4d]
smopuim: checks 
Redvin33: bets $0.06
DenBoss77: calls $0.06
smopuim: calls $0.06
*** TURN *** [8d 6s 4d] [Qc]
smopuim: checks 
Redvin33: bets $0.10
DenBoss77: raises $0.16 to $0.26
smopuim: folds 
Redvin33: folds 
Uncalled bet ($0.16) returned to DenBoss77
DenBoss77 collected $0.56 from pot
DenBoss77: doesn't show hand 
*** SUMMARY ***
Total pot $0.58 | Rake $0.02 
Board [8d 6s 4d Qc]
Seat 1: nikmir34 (button) folded before Flop (didn't bet)
Seat 2: smopuim (small blind) folded on the Turn
Seat 3: Litwack (big blind) folded before Flop
Seat 4: Redvin33 folded on the Turn
Seat 5: ionazun folded before Flop (didn't bet)
Seat 6: omlog folded before Flop (didn't bet)
Seat 7: BIS84 folded before Flop (didn't bet)
Seat 8: Anarckus folded before Flop (didn't bet)
Seat 9: DenBoss77 collected ($0.56)



PokerStars Zoom Hand #172845803515:  Hold'em No Limit ($0.01/$0.02) - 2017/07/10 8:53:59 ET
Table 'McNaught' 9-max Seat #1 is the button
Seat 1: KOL6KA ($1.97 in chips) 
Seat 2: Alex250783 ($1.57 in chips) 
Seat 3: Tyoma_Kovach ($3.18 in chips) 
Seat 4: Redvin33 ($2.16 in chips) 
Seat 5: Strelok1983 ($2.09 in chips) 
Seat 6: muoshulll ($1.10 in chips) 
Seat 7: RmbJN90 ($2.94 in chips) 
Seat 8: lucky25252 ($2.12 in chips) 
Seat 9: andrey 02087 ($0.82 in chips) 
Alex250783: posts small blind $0.01
Tyoma_Kovach: posts big blind $0.02
*** HOLE CARDS ***
Dealt to Redvin33 [5h Qd]
Redvin33: folds 
Strelok1983: folds 
muoshulll: raises $0.04 to $0.06
RmbJN90: folds 
lucky25252: folds 
andrey 02087: folds 
KOL6KA: folds 
Alex250783: folds 
Tyoma_Kovach: folds 
Uncalled bet ($0.04) returned to muoshulll
muoshulll collected $0.05 from pot
muoshulll: doesn't show hand 
*** SUMMARY ***
Total pot $0.05 | Rake $0 
Seat 1: KOL6KA (button) folded before Flop (didn't bet)
Seat 2: Alex250783 (small blind) folded before Flop
Seat 3: Tyoma_Kovach (big blind) folded before Flop
Seat 4: Redvin33 folded before Flop (didn't bet)
Seat 5: Strelok1983 folded before Flop (didn't bet)
Seat 6: muoshulll collected ($0.05)
Seat 7: RmbJN90 folded before Flop (didn't bet)
Seat 8: lucky25252 folded before Flop (didn't bet)
Seat 9: andrey 02087 folded before Flop (didn't bet)



PokerStars Zoom Hand #172845805463:  Hold'em No Limit ($0.01/$0.02) - 2017/07/10 8:54:03 ET
Table 'McNaught' 9-max Seat #1 is the button
Seat 1: Tyoma_Kovach ($2 in chips) 
Seat 2: Redvin33 ($2.16 in chips) 
Seat 3: DenBoss77 ($2.50 in chips) 
Seat 4: bilimb ($1.01 in chips) 
Seat 5: nikmir34 ($2.22 in chips) 
Seat 6: dai2173 ($1.48 in chips) 
Seat 7: TKoniWolf ($2 in chips) 
Seat 8: Rominitakiss ($1.74 in chips) 
Seat 9: Kolya813 ($2.92 in chips) 
Redvin33: posts small blind $0.01
DenBoss77: posts big blind $0.02
*** HOLE CARDS ***
Dealt to Redvin33 [4h Kc]
bilimb: raises $0.04 to $0.06
nikmir34: folds 
dai2173: folds 
TKoniWolf: folds 
Rominitakiss: folds 
Kolya813: folds 
Tyoma_Kovach: folds 
Redvin33: folds 
DenBoss77: folds 
Uncalled bet ($0.04) returned to bilimb
bilimb collected $0.05 from pot
bilimb: doesn't show hand 
*** SUMMARY ***
Total pot $0.05 | Rake $0 
Seat 1: Tyoma_Kovach (button) folded before Flop (didn't bet)
Seat 2: Redvin33 (small blind) folded before Flop
Seat 3: DenBoss77 (big blind) folded before Flop
Seat 4: bilimb collected ($0.05)
Seat 5: nikmir34 folded before Flop (didn't bet)
Seat 6: dai2173 folded before Flop (didn't bet)
Seat 7: TKoniWolf folded before Flop (didn't bet)
Seat 8: Rominitakiss folded before Flop (didn't bet)
Seat 9: Kolya813 folded before Flop (didn't bet)



PokerStars Zoom Hand #172845806828:  Hold'em No Limit ($0.01/$0.02) - 2017/07/10 8:54:06 ET
Table 'McNaught' 9-max Seat #1 is the button
Seat 1: noborder69 ($2.55 in chips) 
Seat 2: Remi Martyn ($2.08 in chips) 
Seat 3: geyza15 ($2.16 in chips) 
Seat 4: Bendi86 ($2.09 in chips) 
Seat 5: RmbJN90 ($1 in chips) 
Seat 6: fomikk ($2 in chips) 
Seat 7: Kkrisz90 ($2 in chips) 
Seat 8: kweuf ($1.38 in chips) 
Seat 9: Redvin33 ($2.15 in chips) 
Remi Martyn: posts small blind $0.01
geyza15: posts big blind $0.02
*** HOLE CARDS ***
Dealt to Redvin33 [Ac 3s]
Bendi86: folds 
RmbJN90: folds 
fomikk: folds 
Kkrisz90: folds 
kweuf: folds 
Redvin33: raises $0.02 to $0.04
noborder69: folds 
Remi Martyn: calls $0.03
geyza15: calls $0.02
*** FLOP *** [5c 8c Kd]
Remi Martyn: bets $0.10
geyza15: folds 
Redvin33: folds 
Uncalled bet ($0.10) returned to Remi Martyn
Remi Martyn collected $0.12 from pot
Remi Martyn: doesn't show hand 
*** SUMMARY ***
Total pot $0.12 | Rake $0 
Board [5c 8c Kd]
Seat 1: noborder69 (button) folded before Flop (didn't bet)
Seat 2: Remi Martyn (small blind) collected ($0.12)
Seat 3: geyza15 (big blind) folded on the Flop
Seat 4: Bendi86 folded before Flop (didn't bet)
Seat 5: RmbJN90 folded before Flop (didn't bet)
Seat 6: fomikk folded before Flop (didn't bet)
Seat 7: Kkrisz90 folded before Flop (didn't bet)
Seat 8: kweuf folded before Flop (didn't bet)
Seat 9: Redvin33 folded on the Flop



PokerStars Zoom Hand #172852421533:  Hold'em No Limit ($0.01/$0.02) - 2017/07/10 12:12:53 ET
Table 'McNaught' 9-max Seat #1 is the button
Seat 1: oghls ($2.07 in chips) 
Seat 2: Filonous ($2 in chips) 
Seat 3: Redvin33 ($1.56 in chips) 
Seat 4: alenastorm ($2.04 in chips) 
Seat 5: PSzpak ($2 in chips) 
Seat 6: Flleys ($2.33 in chips) 
Seat 7: 777uliana777 ($3.86 in chips) 
Seat 8: Nikolaj1976 ($1.56 in chips) 
Seat 9: ferventeg ($1.77 in chips) 
Filonous: posts small blind $0.01
Redvin33: posts big blind $0.02
*** HOLE CARDS ***
Dealt to Redvin33 [Qc 5h]
alenastorm: folds 
PSzpak: folds 
Flleys: folds 
777uliana777: folds 
Nikolaj1976: folds 
ferventeg: folds 
oghls: folds 
Filonous: folds 
Uncalled bet ($0.01) returned to Redvin33
Redvin33 collected $0.02 from pot
Redvin33: doesn't show hand 
*** SUMMARY ***
Total pot $0.02 | Rake $0 
Seat 1: oghls (button) folded before Flop (didn't bet)
Seat 2: Filonous (small blind) folded before Flop
Seat 3: Redvin33 (big blind) collected ($0.02)
Seat 4: alenastorm folded before Flop (didn't bet)
Seat 5: PSzpak folded before Flop (didn't bet)
Seat 6: Flleys folded before Flop (didn't bet)
Seat 7: 777uliana777 folded before Flop (didn't bet)
Seat 8: Nikolaj1976 folded before Flop (didn't bet)
Seat 9: ferventeg folded before Flop (didn't bet)



PokerStars Zoom Hand #172852433312:  Hold'em No Limit ($0.01/$0.02) - 2017/07/10 12:13:11 ET
Table 'McNaught' 9-max Seat #1 is the button
Seat 1: 12febraury ($0.62 in chips) 
Seat 2: Redvin33 ($1.57 in chips) 
Seat 3: gelik32 ($2 in chips) 
Seat 4: Illaryon ($1.63 in chips) 
Seat 5: KikiDB ($3.77 in chips) 
Seat 6: Neptune27 ($2.05 in chips) 
Seat 7: rekopocram ($1.22 in chips) 
Seat 8: MOU77Y ($2.31 in chips) 
Seat 9: Tamuca ($2.28 in chips) 
Redvin33: posts small blind $0.01
gelik32: posts big blind $0.02
*** HOLE CARDS ***
Dealt to Redvin33 [Kc Tc]
Illaryon: folds 
KikiDB: folds 
Neptune27: raises $0.03 to $0.05
rekopocram: folds 
MOU77Y: folds 
Tamuca: folds 
12febraury has timed out while disconnected
12febraury: folds 
Redvin33: calls $0.04
gelik32: folds 
*** FLOP *** [9h Qc 5d]
Redvin33: checks 
Neptune27: bets $0.06
Redvin33: folds 
Uncalled bet ($0.06) returned to Neptune27
Neptune27 collected $0.12 from pot
Neptune27: doesn't show hand 
*** SUMMARY ***
Total pot $0.12 | Rake $0 
Board [9h Qc 5d]
Seat 1: 12febraury (button) folded before Flop (didn't bet)
Seat 2: Redvin33 (small blind) folded on the Flop
Seat 3: gelik32 (big blind) folded before Flop
Seat 4: Illaryon folded before Flop (didn't bet)
Seat 5: KikiDB folded before Flop (didn't bet)
Seat 6: Neptune27 collected ($0.12)
Seat 7: rekopocram folded before Flop (didn't bet)
Seat 8: MOU77Y folded before Flop (didn't bet)
Seat 9: Tamuca folded before Flop (didn't bet)



PokerStars Zoom Hand #172852459763:  Hold'em No Limit ($0.01/$0.02) - 2017/07/10 12:13:52 ET
Table 'McNaught' 9-max Seat #1 is the button
Seat 1: guderian41 ($2.61 in chips) 
Seat 2: mousedriv636 ($1.65 in chips) 
Seat 3: h1_tech_1mba ($2.28 in chips) 
Seat 4: IPSC 74 ($0.39 in chips) 
Seat 5: CantStumpDis ($2.28 in chips) 
Seat 6: Allan Dallon ($2.53 in chips) 
Seat 7: Redvin33 ($1.52 in chips) 
Seat 8: pellion ($2 in chips) 
Seat 9: fraiz68 ($2.18 in chips) 
mousedriv636: posts small blind $0.01
h1_tech_1mba: posts big blind $0.02
*** HOLE CARDS ***
Dealt to Redvin33 [6s 5s]
IPSC 74: folds 
CantStumpDis: folds 
Allan Dallon: folds 
Redvin33: folds 
pellion: folds 
fraiz68: folds 
guderian41: folds 
mousedriv636: folds 
Uncalled bet ($0.01) returned to h1_tech_1mba
h1_tech_1mba collected $0.02 from pot
h1_tech_1mba: doesn't show hand 
*** SUMMARY ***
Total pot $0.02 | Rake $0 
Seat 1: guderian41 (button) folded before Flop (didn't bet)
Seat 2: mousedriv636 (small blind) folded before Flop
Seat 3: h1_tech_1mba (big blind) collected ($0.02)
Seat 4: IPSC 74 folded before Flop (didn't bet)
Seat 5: CantStumpDis folded before Flop (didn't bet)
Seat 6: Allan Dallon folded before Flop (didn't bet)
Seat 7: Redvin33 folded before Flop (didn't bet)
Seat 8: pellion folded before Flop (didn't bet)
Seat 9: fraiz68 folded before Flop (didn't bet)



PokerStars Zoom Hand #172852457111:  Hold'em No Limit ($0.01/$0.02) - 2017/07/10 12:13:48 ET
Table 'McNaught' 9-max Seat #1 is the button
Seat 1: laguna-38 ($1.30 in chips) 
Seat 2: trubobob ($2.06 in chips) 
Seat 3: yuu0914 ($2.53 in chips) 
Seat 4: chaika-lesbi ($1.80 in chips) 
Seat 5: 9th Kind ($1.24 in chips) 
Seat 6: GalaktionoW ($2.27 in chips) 
Seat 7: bubufish91 ($7.32 in chips) 
Seat 8: MTT73 ($2.88 in chips) 
Seat 9: Redvin33 ($1.52 in chips) 
trubobob: posts small blind $0.01
yuu0914: posts big blind $0.02
*** HOLE CARDS ***
Dealt to Redvin33 [Ad 2c]
chaika-lesbi: folds 
9th Kind: folds 
GalaktionoW: folds 
bubufish91: raises $0.06 to $0.08
MTT73: folds 
Redvin33: folds 
laguna-38: folds 
trubobob: folds 
yuu0914: folds 
Uncalled bet ($0.06) returned to bubufish91
bubufish91 collected $0.05 from pot
bubufish91: doesn't show hand 
*** SUMMARY ***
Total pot $0.05 | Rake $0 
Seat 1: laguna-38 (button) folded before Flop (didn't bet)
Seat 2: trubobob (small blind) folded before Flop
Seat 3: yuu0914 (big blind) folded before Flop
Seat 4: chaika-lesbi folded before Flop (didn't bet)
Seat 5: 9th Kind folded before Flop (didn't bet)
Seat 6: GalaktionoW folded before Flop (didn't bet)
Seat 7: bubufish91 collected ($0.05)
Seat 8: MTT73 folded before Flop (didn't bet)
Seat 9: Redvin33 folded before Flop (didn't bet)



PokerStars Zoom Hand #172852453863:  Hold'em No Limit ($0.01/$0.02) - 2017/07/10 12:13:43 ET
Table 'McNaught' 9-max Seat #1 is the button
Seat 1: Redvin33 ($1.52 in chips) 
Seat 2: SHADYST ($2.45 in chips) 
Seat 3: SilAnd ($2.08 in chips) 
Seat 4: Oresboroz ($2 in chips) 
Seat 5: GRaf872 ($1.97 in chips) 
Seat 6: lizzard0705 ($0.32 in chips) 
Seat 7: qpsq ($2.47 in chips) 
Seat 8: AleksandR*L8 ($2.68 in chips) 
Seat 9: ectomarkus ($1.50 in chips) 
SHADYST: posts small blind $0.01
SilAnd: posts big blind $0.02
*** HOLE CARDS ***
Dealt to Redvin33 [5h 6c]
Oresboroz: folds 
GRaf872: folds 
lizzard0705: folds 
qpsq: folds 
AleksandR*L8: calls $0.02
ectomarkus: folds 
Redvin33: folds 
SHADYST: folds 
SilAnd: checks 
*** FLOP *** [Ac 7s As]
SilAnd: checks 
AleksandR*L8: checks 
*** TURN *** [Ac 7s As] [8d]
SilAnd: checks 
AleksandR*L8: checks 
*** RIVER *** [Ac 7s As 8d] [Ah]
SilAnd: checks 
AleksandR*L8: bets $0.06
SilAnd: folds 
Uncalled bet ($0.06) returned to AleksandR*L8
AleksandR*L8 collected $0.05 from pot
AleksandR*L8: doesn't show hand 
*** SUMMARY ***
Total pot $0.05 | Rake $0 
Board [Ac 7s As 8d Ah]
Seat 1: Redvin33 (button) folded before Flop (didn't bet)
Seat 2: SHADYST (small blind) folded before Flop
Seat 3: SilAnd (big blind) folded on the River
Seat 4: Oresboroz folded before Flop (didn't bet)
Seat 5: GRaf872 folded before Flop (didn't bet)
Seat 6: lizzard0705 folded before Flop (didn't bet)
Seat 7: qpsq folded before Flop (didn't bet)
Seat 8: AleksandR*L8 collected ($0.05)
Seat 9: ectomarkus folded before Flop (didn't bet)



PokerStars Zoom Hand #172852461695:  Hold'em No Limit ($0.01/$0.02) - 2017/07/10 12:13:55 ET
Table 'McNaught' 9-max Seat #1 is the button
Seat 1: Hockeyberry ($2 in chips) 
Seat 2: gelik32 ($2 in chips) 
Seat 3: watchamigo ($3.49 in chips) 
Seat 4: ectomarkus ($1.50 in chips) 
Seat 5: RiversideG ($6.42 in chips) 
Seat 6: Tamuca ($2.32 in chips) 
Seat 7: DUMSTIK ($2.03 in chips) 
Seat 8: Redvin33 ($1.52 in chips) 
Seat 9: YOHONSON ($2 in chips) 
gelik32: posts small blind $0.01
watchamigo: posts big blind $0.02
*** HOLE CARDS ***
Dealt to Redvin33 [Jh Th]
ectomarkus: folds 
RiversideG: folds 
Tamuca: raises $0.04 to $0.06
DUMSTIK: folds 
Redvin33: calls $0.06
YOHONSON: folds 
Hockeyberry: folds 
gelik32: folds 
watchamigo: folds 
*** FLOP *** [2c 7d 8d]
Tamuca: checks 
Redvin33: checks 
*** TURN *** [2c 7d 8d] [Qd]
Tamuca: checks 
Redvin33: bets $0.06
Tamuca: folds 
Uncalled bet ($0.06) returned to Redvin33
Redvin33 collected $0.14 from pot
Redvin33: doesn't show hand 
*** SUMMARY ***
Total pot $0.15 | Rake $0.01 
Board [2c 7d 8d Qd]
Seat 1: Hockeyberry (button) folded before Flop (didn't bet)
Seat 2: gelik32 (small blind) folded before Flop
Seat 3: watchamigo (big blind) folded before Flop
Seat 4: ectomarkus folded before Flop (didn't bet)
Seat 5: RiversideG folded before Flop (didn't bet)
Seat 6: Tamuca folded on the Turn
Seat 7: DUMSTIK folded before Flop (didn't bet)
Seat 8: Redvin33 collected ($0.14)
Seat 9: YOHONSON folded before Flop (didn't bet)



PokerStars Zoom Hand #172852486166:  Hold'em No Limit ($0.01/$0.02) - 2017/07/10 12:14:33 ET
Table 'McNaught' 9-max Seat #1 is the button
Seat 1: BluffOnTable ($2 in chips) 
Seat 2: x@t@bich ($2.71 in chips) 
Seat 3: Bridgy23 ($4.38 in chips) 
Seat 4: Tamuca ($3.88 in chips) 
Seat 5: kaosluntik ($3.05 in chips) 
Seat 6: Redvin33 ($1.60 in chips) 
Seat 7: valera_9696@ ($2.36 in chips) 
Seat 8: cyd13 ($2.45 in chips) 
Seat 9: levikeeeLOL ($2.23 in chips) 
x@t@bich: posts small blind $0.01
Bridgy23: posts big blind $0.02
*** HOLE CARDS ***
Dealt to Redvin33 [8d 6h]
Tamuca: folds 
kaosluntik: raises $0.04 to $0.06
Redvin33: folds 
valera_9696@: folds 
cyd13: folds 
levikeeeLOL: folds 
BluffOnTable: folds 
x@t@bich: folds 
Bridgy23: folds 
Uncalled bet ($0.04) returned to kaosluntik
kaosluntik collected $0.05 from pot
kaosluntik: doesn't show hand 
*** SUMMARY ***
Total pot $0.05 | Rake $0 
Seat 1: BluffOnTable (button) folded before Flop (didn't bet)
Seat 2: x@t@bich (small blind) folded before Flop
Seat 3: Bridgy23 (big blind) folded before Flop
Seat 4: Tamuca folded before Flop (didn't bet)
Seat 5: kaosluntik collected ($0.05)
Seat 6: Redvin33 folded before Flop (didn't bet)
Seat 7: valera_9696@ folded before Flop (didn't bet)
Seat 8: cyd13 folded before Flop (didn't bet)
Seat 9: levikeeeLOL folded before Flop (didn't bet)



PokerStars Zoom Hand #172852488716:  Hold'em No Limit ($0.01/$0.02) - 2017/07/10 12:14:37 ET
Table 'McNaught' 9-max Seat #1 is the button
Seat 1: paze ($1.99 in chips) 
Seat 2: 777uliana777 ($2.42 in chips) 
Seat 3: SonTNkts ($3.34 in chips) 
Seat 4: VORon056 ($1.35 in chips) 
Seat 5: Redvin33 ($1.60 in chips) 
Seat 6: K@pblch ($2.05 in chips) 
Seat 7: whotrust?mee ($4.28 in chips) 
Seat 8: 19/20/21 ($2.01 in chips) 
Seat 9: bubufish91 ($12.40 in chips) 
777uliana777: posts small blind $0.01
SonTNkts: posts big blind $0.02
*** HOLE CARDS ***
Dealt to Redvin33 [9d 7d]
VORon056: calls $0.02
Redvin33: raises $0.02 to $0.04
K@pblch: folds 
whotrust?mee: folds 
19/20/21: folds 
bubufish91: folds 
paze: folds 
777uliana777: folds 
SonTNkts: folds 
VORon056: calls $0.02
*** FLOP *** [7c 8d Kd]
VORon056: checks 
Redvin33: bets $0.02
VORon056: folds 
Uncalled bet ($0.02) returned to Redvin33
Redvin33 collected $0.11 from pot
Redvin33: doesn't show hand 
*** SUMMARY ***
Total pot $0.11 | Rake $0 
Board [7c 8d Kd]
Seat 1: paze (button) folded before Flop (didn't bet)
Seat 2: 777uliana777 (small blind) folded before Flop
Seat 3: SonTNkts (big blind) folded before Flop
Seat 4: VORon056 folded on the Flop
Seat 5: Redvin33 collected ($0.11)
Seat 6: K@pblch folded before Flop (didn't bet)
Seat 7: whotrust?mee folded before Flop (didn't bet)
Seat 8: 19/20/21 folded before Flop (didn't bet)
Seat 9: bubufish91 folded before Flop (didn't bet)



PokerStars Zoom Hand #172852504966:  Hold'em No Limit ($0.01/$0.02) - 2017/07/10 12:15:02 ET
Table 'McNaught' 9-max Seat #1 is the button
Seat 1: Scouserslfc ($2 in chips) 
Seat 2: grote monkey ($1.88 in chips) 
Seat 3: Redvin33 ($1.67 in chips) 
Seat 4: PSzpak ($2.36 in chips) 
Seat 5: wat-steel ($2 in chips) 
Seat 6: hdjd6743 ($2.06 in chips) 
Seat 7: Kazanchik777 ($1.92 in chips) 
Seat 8: 19Vladimir83 ($2 in chips) 
Seat 9: SHADYST ($2.02 in chips) 
grote monkey: posts small blind $0.01
Redvin33: posts big blind $0.02
*** HOLE CARDS ***
Dealt to Redvin33 [5s 3s]
PSzpak: folds 
wat-steel: folds 
hdjd6743: folds 
Kazanchik777: folds 
19Vladimir83: folds 
SHADYST: folds 
Scouserslfc: folds 
grote monkey: folds 
Uncalled bet ($0.01) returned to Redvin33
Redvin33 collected $0.02 from pot
Redvin33: doesn't show hand 
*** SUMMARY ***
Total pot $0.02 | Rake $0 
Seat 1: Scouserslfc (button) folded before Flop (didn't bet)
Seat 2: grote monkey (small blind) folded before Flop
Seat 3: Redvin33 (big blind) collected ($0.02)
Seat 4: PSzpak folded before Flop (didn't bet)
Seat 5: wat-steel folded before Flop (didn't bet)
Seat 6: hdjd6743 folded before Flop (didn't bet)
Seat 7: Kazanchik777 folded before Flop (didn't bet)
Seat 8: 19Vladimir83 folded before Flop (didn't bet)
Seat 9: SHADYST folded before Flop (didn't bet)



PokerStars Zoom Hand #172852502384:  Hold'em No Limit ($0.01/$0.02) - 2017/07/10 12:14:58 ET
Table 'McNaught' 9-max Seat #1 is the button
Seat 1: valera_9696@ ($2.06 in chips) 
Seat 2: bubufish91 ($2.55 in chips) 
Seat 3: 11The11 ($2.50 in chips) 
Seat 4: watchamigo ($3.45 in chips) 
Seat 5: Redvin33 ($1.67 in chips) 
Seat 6: Kazanchik777 ($2.44 in chips) 
Seat 7: Bear4943 ($4.34 in chips) 
Seat 8: mcTrack ($0.89 in chips) 
Seat 9: ocrimus ($2.14 in chips) 
bubufish91: posts small blind $0.01
11The11: posts big blind $0.02
*** HOLE CARDS ***
Dealt to Redvin33 [3h 7s]
watchamigo: folds 
Redvin33: folds 
Kazanchik777: folds 
Bear4943: folds 
mcTrack: folds 
ocrimus: raises $0.04 to $0.06
valera_9696@: folds 
bubufish91: folds 
11The11: folds 
Uncalled bet ($0.04) returned to ocrimus
ocrimus collected $0.05 from pot
ocrimus: doesn't show hand 
*** SUMMARY ***
Total pot $0.05 | Rake $0 
Seat 1: valera_9696@ (button) folded before Flop (didn't bet)
Seat 2: bubufish91 (small blind) folded before Flop
Seat 3: 11The11 (big blind) folded before Flop
Seat 4: watchamigo folded before Flop (didn't bet)
Seat 5: Redvin33 folded before Flop (didn't bet)
Seat 6: Kazanchik777 folded before Flop (didn't bet)
Seat 7: Bear4943 folded before Flop (didn't bet)
Seat 8: mcTrack folded before Flop (didn't bet)
Seat 9: ocrimus collected ($0.05)



PokerStars Zoom Hand #172852512066:  Hold'em No Limit ($0.01/$0.02) - 2017/07/10 12:15:13 ET
Table 'McNaught' 9-max Seat #1 is the button
Seat 1: Redvin33 ($1.68 in chips) 
Seat 2: 11The11 ($2.48 in chips) 
Seat 3: Flikers ($2.97 in chips) 
Seat 4: RiversideG ($2.13 in chips) 
Seat 5: spIeeNy ($3.13 in chips) 
Seat 6: Flleys ($2.15 in chips) 
Seat 7: KikiDB ($2.64 in chips) 
Seat 8: jaywu54091 ($2.26 in chips) 
Seat 9: carmazen ($1.98 in chips) 
11The11: posts small blind $0.01
Flikers: posts big blind $0.02
*** HOLE CARDS ***
Dealt to Redvin33 [7d Th]
RiversideG: folds 
spIeeNy: folds 
Flleys: folds 
KikiDB: folds 
jaywu54091: folds 
carmazen: folds 
Redvin33: folds 
11The11: raises $0.03 to $0.05
Flikers: folds 
Uncalled bet ($0.03) returned to 11The11
11The11 collected $0.04 from pot
11The11: doesn't show hand 
*** SUMMARY ***
Total pot $0.04 | Rake $0 
Seat 1: Redvin33 (button) folded before Flop (didn't bet)
Seat 2: 11The11 (small blind) collected ($0.04)
Seat 3: Flikers (big blind) folded before Flop
Seat 4: RiversideG folded before Flop (didn't bet)
Seat 5: spIeeNy folded before Flop (didn't bet)
Seat 6: Flleys folded before Flop (didn't bet)
Seat 7: KikiDB folded before Flop (didn't bet)
Seat 8: jaywu54091 folded before Flop (didn't bet)
Seat 9: carmazen folded before Flop (didn't bet)



PokerStars Zoom Hand #172852514618:  Hold'em No Limit ($0.01/$0.02) - 2017/07/10 12:15:17 ET
Table 'McNaught' 9-max Seat #1 is the button
Seat 1: Oresboroz ($2 in chips) 
Seat 2: Redvin33 ($1.68 in chips) 
Seat 3: SanDmitri4 ($5.06 in chips) 
Seat 4: ggood76 ($2.85 in chips) 
Seat 5: Grom662-662 ($2.16 in chips) 
Seat 6: Scouserslfc ($2 in chips) 
Seat 7: Flleys ($2.15 in chips) 
Seat 8: carmazen ($1.98 in chips) 
Seat 9: gogapok ($0.50 in chips) 
Redvin33: posts small blind $0.01
SanDmitri4: posts big blind $0.02
*** HOLE CARDS ***
Dealt to Redvin33 [5s 6h]
ggood76: folds 
Grom662-662: folds 
Scouserslfc: folds 
Flleys: folds 
carmazen: folds 
gogapok: folds 
Oresboroz: folds 
Redvin33: raises $0.02 to $0.04
SanDmitri4: folds 
Uncalled bet ($0.02) returned to Redvin33
Redvin33 collected $0.04 from pot
Redvin33: doesn't show hand 
*** SUMMARY ***
Total pot $0.04 | Rake $0 
Seat 1: Oresboroz (button) folded before Flop (didn't bet)
Seat 2: Redvin33 (small blind) collected ($0.04)
Seat 3: SanDmitri4 (big blind) folded before Flop
Seat 4: ggood76 folded before Flop (didn't bet)
Seat 5: Grom662-662 folded before Flop (didn't bet)
Seat 6: Scouserslfc folded before Flop (didn't bet)
Seat 7: Flleys folded before Flop (didn't bet)
Seat 8: carmazen folded before Flop (didn't bet)
Seat 9: gogapok folded before Flop (didn't bet)



PokerStars Zoom Hand #172852528282:  Hold'em No Limit ($0.01/$0.02) - 2017/07/10 12:15:38 ET
Table 'McNaught' 9-max Seat #1 is the button
Seat 1: SonTNkts ($3.35 in chips) 
Seat 2: lma321 ($2 in chips) 
Seat 3: KVK1960 ($2.12 in chips) 
Seat 4: Vovchello13 ($2.19 in chips) 
Seat 5: ArchFish ($2.84 in chips) 
Seat 6: Kolya813 ($2.11 in chips) 
Seat 7: Donni Brett ($2 in chips) 
Seat 8: Redvin33 ($1.70 in chips) 
Seat 9: Kirya2790 ($1.97 in chips) 
lma321: posts small blind $0.01
KVK1960: posts big blind $0.02
*** HOLE CARDS ***
Dealt to Redvin33 [9h Th]
Vovchello13: folds 
ArchFish: folds 
Kolya813: folds 
Donni Brett: folds 
Redvin33: raises $0.03 to $0.05
Kirya2790: folds 
SonTNkts: folds 
lma321: folds 
KVK1960: folds 
Uncalled bet ($0.03) returned to Redvin33
Redvin33 collected $0.05 from pot
Redvin33: doesn't show hand 
*** SUMMARY ***
Total pot $0.05 | Rake $0 
Seat 1: SonTNkts (button) folded before Flop (didn't bet)
Seat 2: lma321 (small blind) folded before Flop
Seat 3: KVK1960 (big blind) folded before Flop
Seat 4: Vovchello13 folded before Flop (didn't bet)
Seat 5: ArchFish folded before Flop (didn't bet)
Seat 6: Kolya813 folded before Flop (didn't bet)
Seat 7: Donni Brett folded before Flop (didn't bet)
Seat 8: Redvin33 collected ($0.05)
Seat 9: Kirya2790 folded before Flop (didn't bet)



PokerStars Zoom Hand #172852525655:  Hold'em No Limit ($0.01/$0.02) - 2017/07/10 12:15:34 ET
Table 'McNaught' 9-max Seat #1 is the button
Seat 1: 7prokhorov ($1.89 in chips) 
Seat 2: Scouserslfc ($5.94 in chips) 
Seat 3: SmallDaceZ ($1.09 in chips) 
Seat 4: oghls ($2.28 in chips) 
Seat 5: JBaconn ($3.32 in chips) 
Seat 6: spIeeNy ($2 in chips) 
Seat 7: GalaktionoW ($2.19 in chips) 
Seat 8: jaywu54091 ($3.83 in chips) 
Seat 9: Redvin33 ($1.70 in chips) 
Scouserslfc: posts small blind $0.01
SmallDaceZ: posts big blind $0.02
*** HOLE CARDS ***
Dealt to Redvin33 [3h Th]
oghls: folds 
JBaconn: folds 
spIeeNy: folds 
GalaktionoW: folds 
jaywu54091: folds 
Redvin33: folds 
7prokhorov: raises $0.03 to $0.05
Scouserslfc: calls $0.04
SmallDaceZ: folds 
*** FLOP *** [As 7h Qd]
Scouserslfc: checks 
7prokhorov: bets $0.07
Scouserslfc: folds 
Uncalled bet ($0.07) returned to 7prokhorov
7prokhorov collected $0.12 from pot
7prokhorov: doesn't show hand 
*** SUMMARY ***
Total pot $0.12 | Rake $0 
Board [As 7h Qd]
Seat 1: 7prokhorov (button) collected ($0.12)
Seat 2: Scouserslfc (small blind) folded on the Flop
Seat 3: SmallDaceZ (big blind) folded before Flop
Seat 4: oghls folded before Flop (didn't bet)
Seat 5: JBaconn folded before Flop (didn't bet)
Seat 6: spIeeNy folded before Flop (didn't bet)
Seat 7: GalaktionoW folded before Flop (didn't bet)
Seat 8: jaywu54091 folded before Flop (didn't bet)
Seat 9: Redvin33 folded before Flop (didn't bet)



PokerStars Zoom Hand #172852545109:  Hold'em No Limit ($0.01/$0.02) - 2017/07/10 12:16:04 ET
Table 'McNaught' 9-max Seat #1 is the button
Seat 1: Flleys ($2.21 in chips) 
Seat 2: tina86722 ($0.83 in chips) 
Seat 3: 11The11 ($2.39 in chips) 
Seat 4: Redvin33 ($1.73 in chips) 
Seat 5: AgressoRun ($2.22 in chips) 
Seat 6: wat-steel ($2.13 in chips) 
Seat 7: MOU77Y ($2.35 in chips) 
Seat 8: oghls ($2.25 in chips) 
Seat 9: SHADYST ($2.37 in chips) 
tina86722: posts small blind $0.01
11The11: posts big blind $0.02
*** HOLE CARDS ***
Dealt to Redvin33 [9c Ah]
Redvin33: raises $0.03 to $0.05
AgressoRun: calls $0.05
wat-steel: folds 
MOU77Y: folds 
oghls: folds 
SHADYST: calls $0.05
Flleys: folds 
tina86722: folds 
11The11: folds 
*** FLOP *** [Qc 2d 7c]
Redvin33: bets $0.06
AgressoRun: raises $0.09 to $0.15
SHADYST: folds 
Redvin33: folds 
Uncalled bet ($0.09) returned to AgressoRun
AgressoRun collected $0.29 from pot
AgressoRun: doesn't show hand 
*** SUMMARY ***
Total pot $0.30 | Rake $0.01 
Board [Qc 2d 7c]
Seat 1: Flleys (button) folded before Flop (didn't bet)
Seat 2: tina86722 (small blind) folded before Flop
Seat 3: 11The11 (big blind) folded before Flop
Seat 4: Redvin33 folded on the Flop
Seat 5: AgressoRun collected ($0.29)
Seat 6: wat-steel folded before Flop (didn't bet)
Seat 7: MOU77Y folded before Flop (didn't bet)
Seat 8: oghls folded before Flop (didn't bet)
Seat 9: SHADYST folded on the Flop



PokerStars Zoom Hand #172852542461:  Hold'em No Limit ($0.01/$0.02) - 2017/07/10 12:16:00 ET
Table 'McNaught' 9-max Seat #1 is the button
Seat 1: JBaconn ($2.81 in chips) 
Seat 2: PSzpak ($2.40 in chips) 
Seat 3: Oresboroz ($2.22 in chips) 
Seat 4: Pandaruo ($2.82 in chips) 
Seat 5: valera_9696@ ($2.01 in chips) 
Seat 6: mousedriv636 ($1.68 in chips) 
Seat 7: Redvin33 ($1.73 in chips) 
Seat 8: Katelpiller ($3.51 in chips) 
Seat 9: golddrakon ($2.65 in chips) 
PSzpak: posts small blind $0.01
Oresboroz: posts big blind $0.02
*** HOLE CARDS ***
Dealt to Redvin33 [Js 4c]
Pandaruo: raises $0.04 to $0.06
valera_9696@: folds 
mousedriv636: folds 
Redvin33: folds 
Katelpiller: calls $0.06
golddrakon: folds 
JBaconn: calls $0.06
PSzpak: folds 
Oresboroz: calls $0.04
*** FLOP *** [Kh 7c Qh]
Oresboroz: checks 
Pandaruo: bets $0.16
Katelpiller: folds 
JBaconn: folds 
Oresboroz: folds 
Uncalled bet ($0.16) returned to Pandaruo
Pandaruo collected $0.24 from pot
Pandaruo: doesn't show hand 
*** SUMMARY ***
Total pot $0.25 | Rake $0.01 
Board [Kh 7c Qh]
Seat 1: JBaconn (button) folded on the Flop
Seat 2: PSzpak (small blind) folded before Flop
Seat 3: Oresboroz (big blind) folded on the Flop
Seat 4: Pandaruo collected ($0.24)
Seat 5: valera_9696@ folded before Flop (didn't bet)
Seat 6: mousedriv636 folded before Flop (didn't bet)
Seat 7: Redvin33 folded before Flop (didn't bet)
Seat 8: Katelpiller folded on the Flop
Seat 9: golddrakon folded before Flop (didn't bet)



PokerStars Zoom Hand #172852571638:  Hold'em No Limit ($0.01/$0.02) - 2017/07/10 12:16:45 ET
Table 'McNaught' 9-max Seat #1 is the button
Seat 1: carmazen ($1.92 in chips) 
Seat 2: sasha7670 ($2.15 in chips) 
Seat 3: Flleys ($2.64 in chips) 
Seat 4: 9th Kind ($0.92 in chips) 
Seat 5: MOU77Y ($2.35 in chips) 
Seat 6: Redvin33 ($1.60 in chips) 
Seat 7: AndrewAstron ($2 in chips) 
Seat 8: ArchFish ($2.81 in chips) 
Seat 9: Himik30 ($1.88 in chips) 
sasha7670: posts small blind $0.01
Flleys: posts big blind $0.02
*** HOLE CARDS ***
Dealt to Redvin33 [Tc 5s]
9th Kind: raises $0.05 to $0.07
MOU77Y: folds 
Redvin33: folds 
AndrewAstron: folds 
ArchFish: folds 
Himik30: folds 
carmazen: folds 
sasha7670: folds 
Flleys: folds 
Uncalled bet ($0.05) returned to 9th Kind
9th Kind collected $0.05 from pot
9th Kind: doesn't show hand 
*** SUMMARY ***
Total pot $0.05 | Rake $0 
Seat 1: carmazen (button) folded before Flop (didn't bet)
Seat 2: sasha7670 (small blind) folded before Flop
Seat 3: Flleys (big blind) folded before Flop
Seat 4: 9th Kind collected ($0.05)
Seat 5: MOU77Y folded before Flop (didn't bet)
Seat 6: Redvin33 folded before Flop (didn't bet)
Seat 7: AndrewAstron folded before Flop (didn't bet)
Seat 8: ArchFish folded before Flop (didn't bet)
Seat 9: Himik30 folded before Flop (didn't bet)



PokerStars Zoom Hand #172852564529:  Hold'em No Limit ($0.01/$0.02) - 2017/07/10 12:16:34 ET
Table 'McNaught' 9-max Seat #1 is the button
Seat 1: spIeeNy ($2 in chips) 
Seat 2: Filonous ($2.34 in chips) 
Seat 3: Redvin33 ($1.62 in chips) 
Seat 4: valera_9696@ ($2 in chips) 
Seat 5: SanDmitri4 ($5.68 in chips) 
Seat 6: tamaska01 ($1.39 in chips) 
Seat 7: SHADYST ($2.32 in chips) 
Seat 8: golddrakon ($2.68 in chips) 
Seat 9: Patte6 ($2.12 in chips) 
Filonous: posts small blind $0.01
Redvin33: posts big blind $0.02
*** HOLE CARDS ***
Dealt to Redvin33 [3s Ks]
valera_9696@: folds 
SanDmitri4: folds 
tamaska01: folds 
SHADYST: folds 
golddrakon: folds 
Patte6: raises $0.04 to $0.06
spIeeNy: calls $0.06
Filonous: folds 
Redvin33: folds 
*** FLOP *** [4h 8s 8c]
Patte6: bets $0.08
spIeeNy: folds 
Uncalled bet ($0.08) returned to Patte6
Patte6 collected $0.14 from pot
Patte6: doesn't show hand 
*** SUMMARY ***
Total pot $0.15 | Rake $0.01 
Board [4h 8s 8c]
Seat 1: spIeeNy (button) folded on the Flop
Seat 2: Filonous (small blind) folded before Flop
Seat 3: Redvin33 (big blind) folded before Flop
Seat 4: valera_9696@ folded before Flop (didn't bet)
Seat 5: SanDmitri4 folded before Flop (didn't bet)
Seat 6: tamaska01 folded before Flop (didn't bet)
Seat 7: SHADYST folded before Flop (didn't bet)
Seat 8: golddrakon folded before Flop (didn't bet)
Seat 9: Patte6 collected ($0.14)



PokerStars Zoom Hand #172852574285:  Hold'em No Limit ($0.01/$0.02) - 2017/07/10 12:16:49 ET
Table 'McNaught' 9-max Seat #1 is the button
Seat 1: PSzpak ($2 in chips) 
Seat 2: Redvin33 ($1.60 in chips) 
Seat 3: AgressoRun ($2.52 in chips) 
Seat 4: SanDmitri4 ($15.03 in chips) 
Seat 5: pellion ($1.97 in chips) 
Seat 6: Grom662-662 ($2.27 in chips) 
Seat 7: rixard6 ($2.25 in chips) 
Seat 8: whotrust?mee ($2.29 in chips) 
Seat 9: nikmir34 ($2.38 in chips) 
Redvin33: posts small blind $0.01
AgressoRun: posts big blind $0.02
*** HOLE CARDS ***
Dealt to Redvin33 [7c 5c]
SanDmitri4: folds 
pellion: folds 
Grom662-662: raises $0.04 to $0.06
rixard6: folds 
whotrust?mee: folds 
nikmir34: folds 
PSzpak: folds 
Redvin33: calls $0.05
AgressoRun: calls $0.04
*** FLOP *** [Qc Kh 4c]
Redvin33: bets $0.06
AgressoRun: folds 
Grom662-662: calls $0.06
*** TURN *** [Qc Kh 4c] [7h]
Redvin33: checks 
Grom662-662: checks 
*** RIVER *** [Qc Kh 4c 7h] [7s]
Redvin33: bets $0.08
Grom662-662: calls $0.08
*** SHOW DOWN ***
Redvin33: shows [7c 5c] (three of a kind, Sevens)
Grom662-662: mucks hand 
Redvin33 collected $0.44 from pot
*** SUMMARY ***
Total pot $0.46 | Rake $0.02 
Board [Qc Kh 4c 7h 7s]
Seat 1: PSzpak (button) folded before Flop (didn't bet)
Seat 2: Redvin33 (small blind) showed [7c 5c] and won ($0.44) with three of a kind, Sevens
Seat 3: AgressoRun (big blind) folded on the Flop
Seat 4: SanDmitri4 folded before Flop (didn't bet)
Seat 5: pellion folded before Flop (didn't bet)
Seat 6: Grom662-662 mucked [Qd Ac]
Seat 7: rixard6 folded before Flop (didn't bet)
Seat 8: whotrust?mee folded before Flop (didn't bet)
Seat 9: nikmir34 folded before Flop (didn't bet)



PokerStars Zoom Hand #172852611811:  Hold'em No Limit ($0.01/$0.02) - 2017/07/10 12:17:47 ET
Table 'McNaught' 9-max Seat #1 is the button
Seat 1: Redvin33 ($1.84 in chips) 
Seat 2: AgressoRun ($2.09 in chips) 
Seat 3: 19Vladimir83 ($3.03 in chips) 
Seat 4: Flleys ($2.44 in chips) 
Seat 5: RMDvD ($2.24 in chips) 
Seat 6: kupca38 ($1.96 in chips) 
Seat 7: Vovchello13 ($2.30 in chips) 
Seat 8: taenzer64 ($1.79 in chips) 
Seat 9: RiversideG ($2.59 in chips) 
AgressoRun: posts small blind $0.01
19Vladimir83: posts big blind $0.02
*** HOLE CARDS ***
Dealt to Redvin33 [9c Jd]
Flleys: folds 
RMDvD: folds 
kupca38: folds 
Vovchello13: folds 
taenzer64: folds 
RiversideG: folds 
Redvin33: folds 
AgressoRun: folds 
Uncalled bet ($0.01) returned to 19Vladimir83
19Vladimir83 collected $0.02 from pot
19Vladimir83: doesn't show hand 
*** SUMMARY ***
Total pot $0.02 | Rake $0 
Seat 1: Redvin33 (button) folded before Flop (didn't bet)
Seat 2: AgressoRun (small blind) folded before Flop
Seat 3: 19Vladimir83 (big blind) collected ($0.02)
Seat 4: Flleys folded before Flop (didn't bet)
Seat 5: RMDvD folded before Flop (didn't bet)
Seat 6: kupca38 folded before Flop (didn't bet)
Seat 7: Vovchello13 folded before Flop (didn't bet)
Seat 8: taenzer64 folded before Flop (didn't bet)
Seat 9: RiversideG folded before Flop (didn't bet)



PokerStars Zoom Hand #172852617789:  Hold'em No Limit ($0.01/$0.02) - 2017/07/10 12:17:56 ET
Table 'McNaught' 9-max Seat #1 is the button
Seat 1: zhassakon ($2 in chips) 
Seat 2: Mepo12th ($1.92 in chips) 
Seat 3: laguna-38 ($0.65 in chips) 
Seat 4: SanDmitri4 ($15.03 in chips) 
Seat 5: Nikolaj1976 ($1.92 in chips) 
Seat 6: Himik30 ($1.94 in chips) 
Seat 7: x@t@bich ($8.13 in chips) 
Seat 8: 11The11 ($2.54 in chips) 
Seat 9: Redvin33 ($1.84 in chips) 
Mepo12th: posts small blind $0.01
laguna-38: posts big blind $0.02
*** HOLE CARDS ***
Dealt to Redvin33 [8c Ks]
SanDmitri4: folds 
Nikolaj1976: folds 
Himik30: folds 
x@t@bich: raises $0.04 to $0.06
11The11: folds 
Redvin33: folds 
zhassakon: calls $0.06
Mepo12th: folds 
laguna-38: folds 
*** FLOP *** [8s 6d 7s]
x@t@bich: bets $0.10
zhassakon: folds 
Uncalled bet ($0.10) returned to x@t@bich
x@t@bich collected $0.14 from pot
x@t@bich: doesn't show hand 
*** SUMMARY ***
Total pot $0.15 | Rake $0.01 
Board [8s 6d 7s]
Seat 1: zhassakon (button) folded on the Flop
Seat 2: Mepo12th (small blind) folded before Flop
Seat 3: laguna-38 (big blind) folded before Flop
Seat 4: SanDmitri4 folded before Flop (didn't bet)
Seat 5: Nikolaj1976 folded before Flop (didn't bet)
Seat 6: Himik30 folded before Flop (didn't bet)
Seat 7: x@t@bich collected ($0.14)
Seat 8: 11The11 folded before Flop (didn't bet)
Seat 9: Redvin33 folded before Flop (didn't bet)



PokerStars Zoom Hand #172852620386:  Hold'em No Limit ($0.01/$0.02) - 2017/07/10 12:18:00 ET
Table 'McNaught' 9-max Seat #1 is the button
Seat 1: luiskell ($1.91 in chips) 
Seat 2: AgressoRun ($2.39 in chips) 
Seat 3: Alex250783 ($1.16 in chips) 
Seat 4: MYRAIIIKA ($3.16 in chips) 
Seat 5: Redvin33 ($1.84 in chips) 
Seat 6: FoldCase ($4.21 in chips) 
Seat 7: caiska ($2 in chips) 
Seat 8: patriot557 ($3.19 in chips) 
Seat 9: Oresboroz ($2.13 in chips) 
AgressoRun: posts small blind $0.01
Alex250783: posts big blind $0.02
*** HOLE CARDS ***
Dealt to Redvin33 [Ks Qs]
MYRAIIIKA: folds 
Redvin33: raises $0.03 to $0.05
FoldCase: folds 
caiska: folds 
patriot557: calls $0.05
Oresboroz: folds 
luiskell: folds 
AgressoRun: folds 
Alex250783: folds 
*** FLOP *** [4h 5c 2d]
Redvin33: checks 
patriot557: bets $0.07
Redvin33: folds 
Uncalled bet ($0.07) returned to patriot557
patriot557 collected $0.13 from pot
patriot557: doesn't show hand 
*** SUMMARY ***
Total pot $0.13 | Rake $0 
Board [4h 5c 2d]
Seat 1: luiskell (button) folded before Flop (didn't bet)
Seat 2: AgressoRun (small blind) folded before Flop
Seat 3: Alex250783 (big blind) folded before Flop
Seat 4: MYRAIIIKA folded before Flop (didn't bet)
Seat 5: Redvin33 folded on the Flop
Seat 6: FoldCase folded before Flop (didn't bet)
Seat 7: caiska folded before Flop (didn't bet)
Seat 8: patriot557 collected ($0.13)
Seat 9: Oresboroz folded before Flop (didn't bet)



PokerStars Zoom Hand #172852615134:  Hold'em No Limit ($0.01/$0.02) - 2017/07/10 12:17:52 ET
Table 'McNaught' 9-max Seat #1 is the button
Seat 1: lexy615 ($2.86 in chips) 
Seat 2: gelik32 ($4.69 in chips) 
Seat 3: tape ruvicha ($2 in chips) 
Seat 4: Flikers ($2.07 in chips) 
Seat 5: maxik1309 ($2.33 in chips) 
Seat 6: seshAD ($3.28 in chips) 
Seat 7: Redvin33 ($1.84 in chips) 
Seat 8: Flleys ($2 in chips) 
Seat 9: GalaktionoW ($5.31 in chips) 
gelik32: posts small blind $0.01
tape ruvicha: posts big blind $0.02
*** HOLE CARDS ***
Dealt to Redvin33 [9d 7c]
Flikers: raises $0.04 to $0.06
maxik1309: calls $0.06
seshAD: folds 
Redvin33: folds 
Flleys: folds 
GalaktionoW: folds 
lexy615 has timed out
lexy615: folds 
gelik32: folds 
tape ruvicha: folds 
*** FLOP *** [Qd 2s Qc]
Flikers: bets $0.07
maxik1309: calls $0.07
*** TURN *** [Qd 2s Qc] [6h]
Flikers: checks 
maxik1309: checks 
*** RIVER *** [Qd 2s Qc 6h] [8c]
Flikers: bets $0.12
maxik1309: folds 
Uncalled bet ($0.12) returned to Flikers
Flikers collected $0.28 from pot
Flikers: doesn't show hand 
*** SUMMARY ***
Total pot $0.29 | Rake $0.01 
Board [Qd 2s Qc 6h 8c]
Seat 1: lexy615 (button) folded before Flop (didn't bet)
Seat 2: gelik32 (small blind) folded before Flop
Seat 3: tape ruvicha (big blind) folded before Flop
Seat 4: Flikers collected ($0.28)
Seat 5: maxik1309 folded on the River
Seat 6: seshAD folded before Flop (didn't bet)
Seat 7: Redvin33 folded before Flop (didn't bet)
Seat 8: Flleys folded before Flop (didn't bet)
Seat 9: GalaktionoW folded before Flop (didn't bet)



PokerStars Zoom Hand #172852639214:  Hold'em No Limit ($0.01/$0.02) - 2017/07/10 12:18:29 ET
Table 'McNaught' 9-max Seat #1 is the button
Seat 1: Hockeyberry ($5.92 in chips) 
Seat 2: marchela441 ($1.64 in chips) 
Seat 3: baik1211 ($2 in chips) 
Seat 4: Poker in DNA ($2.62 in chips) 
Seat 5: oghls ($2.08 in chips) 
Seat 6: tolik372 ($0.69 in chips) 
Seat 7: MOU77Y ($2.18 in chips) 
Seat 8: Redvin33 ($1.79 in chips) 
Seat 9: Himik30 ($2.25 in chips) 
marchela441: posts small blind $0.01
baik1211: posts big blind $0.02
*** HOLE CARDS ***
Dealt to Redvin33 [4c 4s]
Poker in DNA: folds 
oghls: raises $0.04 to $0.06
tolik372: folds 
MOU77Y: folds 
Redvin33: calls $0.06
Himik30: folds 
Hockeyberry: folds 
marchela441: folds 
baik1211: calls $0.04
*** FLOP *** [9h 2s Kd]
baik1211: checks 
oghls: checks 
Redvin33: bets $0.06
baik1211: calls $0.06
oghls: calls $0.06
*** TURN *** [9h 2s Kd] [3c]
baik1211: checks 
oghls: checks 
Redvin33: checks 
*** RIVER *** [9h 2s Kd 3c] [Ac]
baik1211: checks 
oghls: checks 
Redvin33: checks 
*** SHOW DOWN ***
baik1211: shows [8d 9d] (a pair of Nines)
oghls: shows [Ah Jh] (a pair of Aces)
Redvin33: mucks hand 
oghls collected $0.36 from pot
*** SUMMARY ***
Total pot $0.37 | Rake $0.01 
Board [9h 2s Kd 3c Ac]
Seat 1: Hockeyberry (button) folded before Flop (didn't bet)
Seat 2: marchela441 (small blind) folded before Flop
Seat 3: baik1211 (big blind) showed [8d 9d] and lost with a pair of Nines
Seat 4: Poker in DNA folded before Flop (didn't bet)
Seat 5: oghls showed [Ah Jh] and won ($0.36) with a pair of Aces
Seat 6: tolik372 folded before Flop (didn't bet)
Seat 7: MOU77Y folded before Flop (didn't bet)
Seat 8: Redvin33 mucked [4c 4s]
Seat 9: Himik30 folded before Flop (didn't bet)



PokerStars Zoom Hand #172852675675:  Hold'em No Limit ($0.01/$0.02) - 2017/07/10 12:19:25 ET
Table 'McNaught' 9-max Seat #1 is the button
Seat 1: Filonous ($3 in chips) 
Seat 2: dakama_po ($2.12 in chips) 
Seat 3: Katelpiller ($3.42 in chips) 
Seat 4: ocrimus ($2 in chips) 
Seat 5: Nikolaj1976 ($1.58 in chips) 
Seat 6: Redvin33 ($1.67 in chips) 
Seat 7: RiversideG ($3.25 in chips) 
Seat 8: GalaktionoW ($8.83 in chips) 
Seat 9: Vovchello13 ($2 in chips) 
dakama_po: posts small blind $0.01
Katelpiller: posts big blind $0.02
*** HOLE CARDS ***
Dealt to Redvin33 [Kh 7c]
ocrimus: folds 
Nikolaj1976: folds 
Redvin33: folds 
RiversideG: folds 
GalaktionoW: folds 
Vovchello13: folds 
Filonous: raises $0.03 to $0.05
dakama_po: folds 
Katelpiller: folds 
Uncalled bet ($0.03) returned to Filonous
Filonous collected $0.05 from pot
Filonous: doesn't show hand 
*** SUMMARY ***
Total pot $0.05 | Rake $0 
Seat 1: Filonous (button) collected ($0.05)
Seat 2: dakama_po (small blind) folded before Flop
Seat 3: Katelpiller (big blind) folded before Flop
Seat 4: ocrimus folded before Flop (didn't bet)
Seat 5: Nikolaj1976 folded before Flop (didn't bet)
Seat 6: Redvin33 folded before Flop (didn't bet)
Seat 7: RiversideG folded before Flop (didn't bet)
Seat 8: GalaktionoW folded before Flop (didn't bet)
Seat 9: Vovchello13 folded before Flop (didn't bet)



PokerStars Zoom Hand #172852679008:  Hold'em No Limit ($0.01/$0.02) - 2017/07/10 12:19:30 ET
Table 'McNaught' 9-max Seat #1 is the button
Seat 1: baik1211 ($1.87 in chips) 
Seat 2: solyom217 ($2 in chips) 
Seat 3: LoveBadBeat0 ($6.68 in chips) 
Seat 4: seshAD ($2.08 in chips) 
Seat 5: Redvin33 ($1.67 in chips) 
Seat 6: Grigoris1962 ($3.80 in chips) 
Seat 7: VORon056 ($0.48 in chips) 
Seat 8: NAHALUGA ($2.18 in chips) 
Seat 9: moyasyndrome ($2.11 in chips) 
solyom217: posts small blind $0.01
LoveBadBeat0: posts big blind $0.02
*** HOLE CARDS ***
Dealt to Redvin33 [Th 6d]
seshAD: folds 
Redvin33: folds 
Grigoris1962: calls $0.02
VORon056: folds 
NAHALUGA: folds 
moyasyndrome: folds 
baik1211: folds 
solyom217: folds 
LoveBadBeat0: raises $0.10 to $0.12
Grigoris1962: folds 
Uncalled bet ($0.10) returned to LoveBadBeat0
LoveBadBeat0 collected $0.05 from pot
LoveBadBeat0: doesn't show hand 
*** SUMMARY ***
Total pot $0.05 | Rake $0 
Seat 1: baik1211 (button) folded before Flop (didn't bet)
Seat 2: solyom217 (small blind) folded before Flop
Seat 3: LoveBadBeat0 (big blind) collected ($0.05)
Seat 4: seshAD folded before Flop (didn't bet)
Seat 5: Redvin33 folded before Flop (didn't bet)
Seat 6: Grigoris1962 folded before Flop
Seat 7: VORon056 folded before Flop (didn't bet)
Seat 8: NAHALUGA folded before Flop (didn't bet)
Seat 9: moyasyndrome folded before Flop (didn't bet)



PokerStars Zoom Hand #172852681641:  Hold'em No Limit ($0.01/$0.02) - 2017/07/10 12:19:34 ET
Table 'McNaught' 9-max Seat #1 is the button
Seat 1: Redvin33 ($1.67 in chips) 
Seat 2: Flikers ($2.32 in chips) 
Seat 3: Kolya813 ($4.25 in chips) 
Seat 4: zsermano ($2.05 in chips) 
Seat 5: Filonous ($2.77 in chips) 
Seat 6: denzell574 ($1.70 in chips) 
Seat 7: NAHALUGA ($2.18 in chips) 
Seat 8: gogapok ($2.12 in chips) 
Seat 9: AgressoRun ($2.04 in chips) 
Flikers: posts small blind $0.01
Kolya813: posts big blind $0.02
*** HOLE CARDS ***
Dealt to Redvin33 [Kd Js]
zsermano: folds 
Filonous: folds 
denzell574: folds 
NAHALUGA: folds 
gogapok: folds 
AgressoRun: folds 
Redvin33: raises $0.02 to $0.04
Flikers: folds 
Kolya813: raises $0.09 to $0.13
Redvin33: calls $0.09
*** FLOP *** [Qc 4d Th]
Kolya813: bets $0.09
Redvin33: calls $0.09
*** TURN *** [Qc 4d Th] [8s]
Kolya813: bets $0.15
Redvin33: calls $0.15
*** RIVER *** [Qc 4d Th 8s] [Jc]
Kolya813: bets $0.52
Redvin33: folds 
Uncalled bet ($0.52) returned to Kolya813
Kolya813 collected $0.72 from pot
Kolya813: doesn't show hand 
*** SUMMARY ***
Total pot $0.75 | Rake $0.03 
Board [Qc 4d Th 8s Jc]
Seat 1: Redvin33 (button) folded on the River
Seat 2: Flikers (small blind) folded before Flop
Seat 3: Kolya813 (big blind) collected ($0.72)
Seat 4: zsermano folded before Flop (didn't bet)
Seat 5: Filonous folded before Flop (didn't bet)
Seat 6: denzell574 folded before Flop (didn't bet)
Seat 7: NAHALUGA folded before Flop (didn't bet)
Seat 8: gogapok folded before Flop (didn't bet)
Seat 9: AgressoRun folded before Flop (didn't bet)



PokerStars Zoom Hand #172852708423:  Hold'em No Limit ($0.01/$0.02) - 2017/07/10 12:20:15 ET
Table 'McNaught' 9-max Seat #1 is the button
Seat 1: BluffOnTable ($2.15 in chips) 
Seat 2: rekopocram ($2.08 in chips) 
Seat 3: dagordin ($3.89 in chips) 
Seat 4: Grigoris1962 ($3.78 in chips) 
Seat 5: Moltyaninov ($1.29 in chips) 
Seat 6: Redvin33 ($1.30 in chips) 
Seat 7: ryokun@tps ($3.60 in chips) 
Seat 8: vsegda_olin ($3.97 in chips) 
Seat 9: 11The11 ($2.21 in chips) 
rekopocram: posts small blind $0.01
dagordin: posts big blind $0.02
*** HOLE CARDS ***
Dealt to Redvin33 [7d 4s]
Grigoris1962: folds 
Moltyaninov: folds 
Redvin33: folds 
ryokun@tps: folds 
vsegda_olin: folds 
11The11: folds 
BluffOnTable: folds 
rekopocram: raises $0.02 to $0.04
dagordin: calls $0.02
*** FLOP *** [6s Jd As]
rekopocram: checks 
dagordin: bets $0.04
rekopocram: raises $0.04 to $0.08
dagordin: calls $0.04
*** TURN *** [6s Jd As] [7h]
rekopocram: bets $0.09
dagordin: folds 
Uncalled bet ($0.09) returned to rekopocram
rekopocram collected $0.23 from pot
rekopocram: doesn't show hand 
*** SUMMARY ***
Total pot $0.24 | Rake $0.01 
Board [6s Jd As 7h]
Seat 1: BluffOnTable (button) folded before Flop (didn't bet)
Seat 2: rekopocram (small blind) collected ($0.23)
Seat 3: dagordin (big blind) folded on the Turn
Seat 4: Grigoris1962 folded before Flop (didn't bet)
Seat 5: Moltyaninov folded before Flop (didn't bet)
Seat 6: Redvin33 folded before Flop (didn't bet)
Seat 7: ryokun@tps folded before Flop (didn't bet)
Seat 8: vsegda_olin folded before Flop (didn't bet)
Seat 9: 11The11 folded before Flop (didn't bet)



PokerStars Zoom Hand #172852711065:  Hold'em No Limit ($0.01/$0.02) - 2017/07/10 12:20:19 ET
Table 'McNaught' 9-max Seat #1 is the button
Seat 1: 08600 ($1.55 in chips) 
Seat 2: abramsen ($0.94 in chips) 
Seat 3: Redvin33 ($1.30 in chips) 
Seat 4: medicina1992 ($2.53 in chips) 
Seat 5: golddrakon ($2.45 in chips) 
Seat 6: flayTilt ($2.28 in chips) 
Seat 7: 11The11 ($2.21 in chips) 
Seat 8: Oresboroz ($2.13 in chips) 
Seat 9: Scouserslfc ($4.46 in chips) 
abramsen: posts small blind $0.01
Redvin33: posts big blind $0.02
*** HOLE CARDS ***
Dealt to Redvin33 [7c 6d]
medicina1992: folds 
golddrakon: folds 
flayTilt: raises $0.05 to $0.07
11The11: raises $0.11 to $0.18
Oresboroz: folds 
Scouserslfc: folds 
08600: folds 
abramsen: folds 
Redvin33: folds 
flayTilt: folds 
Uncalled bet ($0.11) returned to 11The11
11The11 collected $0.17 from pot
11The11: doesn't show hand 
*** SUMMARY ***
Total pot $0.17 | Rake $0 
Seat 1: 08600 (button) folded before Flop (didn't bet)
Seat 2: abramsen (small blind) folded before Flop
Seat 3: Redvin33 (big blind) folded before Flop
Seat 4: medicina1992 folded before Flop (didn't bet)
Seat 5: golddrakon folded before Flop (didn't bet)
Seat 6: flayTilt folded before Flop
Seat 7: 11The11 collected ($0.17)
Seat 8: Oresboroz folded before Flop (didn't bet)
Seat 9: Scouserslfc folded before Flop (didn't bet)



PokerStars Zoom Hand #172852722716:  Hold'em No Limit ($0.01/$0.02) - 2017/07/10 12:20:37 ET
Table 'McNaught' 9-max Seat #1 is the button
Seat 1: rekopocram ($1.24 in chips) 
Seat 2: Truthanclan9 ($1.21 in chips) 
Seat 3: Flikers ($2.28 in chips) 
Seat 4: gelik32 ($2.13 in chips) 
Seat 5: Neptune27 ($2.18 in chips) 
Seat 6: Grom662-662 ($2.63 in chips) 
Seat 7: Redvin33 ($1.28 in chips) 
Seat 8: SilAnd ($1.96 in chips) 
Seat 9: MCFI ($2.25 in chips) 
Truthanclan9: posts small blind $0.01
Flikers: posts big blind $0.02
*** HOLE CARDS ***
Dealt to Redvin33 [3s 2h]
gelik32: folds 
Neptune27: folds 
Grom662-662: folds 
Redvin33: folds 
SilAnd: raises $0.04 to $0.06
MCFI: calls $0.06
rekopocram: folds 
Truthanclan9: folds 
Flikers: folds 
*** FLOP *** [Ah 2c 5c]
SilAnd: bets $0.09
MCFI: calls $0.09
*** TURN *** [Ah 2c 5c] [7c]
SilAnd: checks 
MCFI: checks 
*** RIVER *** [Ah 2c 5c 7c] [6d]
SilAnd: checks 
MCFI: checks 
*** SHOW DOWN ***
SilAnd: shows [4h 5h] (a pair of Fives)
MCFI: shows [Ac Qs] (a pair of Aces)
MCFI collected $0.32 from pot
*** SUMMARY ***
Total pot $0.33 | Rake $0.01 
Board [Ah 2c 5c 7c 6d]
Seat 1: rekopocram (button) folded before Flop (didn't bet)
Seat 2: Truthanclan9 (small blind) folded before Flop
Seat 3: Flikers (big blind) folded before Flop
Seat 4: gelik32 folded before Flop (didn't bet)
Seat 5: Neptune27 folded before Flop (didn't bet)
Seat 6: Grom662-662 folded before Flop (didn't bet)
Seat 7: Redvin33 folded before Flop (didn't bet)
Seat 8: SilAnd showed [4h 5h] and lost with a pair of Fives
Seat 9: MCFI showed [Ac Qs] and won ($0.32) with a pair of Aces



PokerStars Zoom Hand #172852726016:  Hold'em No Limit ($0.01/$0.02) - 2017/07/10 12:20:42 ET
Table 'McNaught' 9-max Seat #1 is the button
Seat 1: GaliRah ($2.49 in chips) 
Seat 2: Redvin33 ($1.28 in chips) 
Seat 3: kanatbig ($2 in chips) 
Seat 4: evgennn1410 ($2.06 in chips) 
Seat 5: gogapok ($2.09 in chips) 
Seat 6: privatenergo ($2.84 in chips) 
Seat 7: baik1211 ($1.88 in chips) 
Seat 8: blueviewer ($1.93 in chips) 
Seat 9: hjpalmer23 ($9.06 in chips) 
Redvin33: posts small blind $0.01
kanatbig: posts big blind $0.02
*** HOLE CARDS ***
Dealt to Redvin33 [Ah As]
evgennn1410: raises $0.04 to $0.06
gogapok: folds 
privatenergo: folds 
baik1211: folds 
blueviewer: folds 
hjpalmer23: folds 
GaliRah: folds 
Redvin33: raises $0.06 to $0.12
kanatbig: folds 
evgennn1410: calls $0.06
*** FLOP *** [Qc 9h Qd]
Redvin33: checks 
evgennn1410: checks 
*** TURN *** [Qc 9h Qd] [4h]
Redvin33: bets $0.10
evgennn1410: calls $0.10
*** RIVER *** [Qc 9h Qd 4h] [2d]
Redvin33: bets $0.10
evgennn1410: folds 
Uncalled bet ($0.10) returned to Redvin33
Redvin33 collected $0.44 from pot
Redvin33: doesn't show hand 
*** SUMMARY ***
Total pot $0.46 | Rake $0.02 
Board [Qc 9h Qd 4h 2d]
Seat 1: GaliRah (button) folded before Flop (didn't bet)
Seat 2: Redvin33 (small blind) collected ($0.44)
Seat 3: kanatbig (big blind) folded before Flop
Seat 4: evgennn1410 folded on the River
Seat 5: gogapok folded before Flop (didn't bet)
Seat 6: privatenergo folded before Flop (didn't bet)
Seat 7: baik1211 folded before Flop (didn't bet)
Seat 8: blueviewer folded before Flop (didn't bet)
Seat 9: hjpalmer23 folded before Flop (didn't bet)



PokerStars Zoom Hand #172852765157:  Hold'em No Limit ($0.01/$0.02) - 2017/07/10 12:21:42 ET
Table 'McNaught' 9-max Seat #1 is the button
Seat 1: triny9 ($4.26 in chips) 
Seat 2: fomikk ($3.57 in chips) 
Seat 3: Oresboroz ($2 in chips) 
Seat 4: rrrr1958 ($1.47 in chips) 
Seat 5: Redvin33 ($1.50 in chips) 
Seat 6: MikhMaster ($2.23 in chips) 
Seat 7: pellion ($2.04 in chips) 
Seat 8: A.V.LIN ($2.03 in chips) 
Seat 9: GalaktionoW ($5.40 in chips) 
fomikk: posts small blind $0.01
Oresboroz: posts big blind $0.02
*** HOLE CARDS ***
Dealt to Redvin33 [2c 3h]
rrrr1958: folds 
Redvin33: folds 
MikhMaster: folds 
pellion: folds 
A.V.LIN: folds 
GalaktionoW: raises $0.04 to $0.06
triny9: folds 
fomikk: raises $0.13 to $0.19
Oresboroz: folds 
GalaktionoW: folds 
Uncalled bet ($0.13) returned to fomikk
fomikk collected $0.14 from pot
fomikk: doesn't show hand 
*** SUMMARY ***
Total pot $0.14 | Rake $0 
Seat 1: triny9 (button) folded before Flop (didn't bet)
Seat 2: fomikk (small blind) collected ($0.14)
Seat 3: Oresboroz (big blind) folded before Flop
Seat 4: rrrr1958 folded before Flop (didn't bet)
Seat 5: Redvin33 folded before Flop (didn't bet)
Seat 6: MikhMaster folded before Flop (didn't bet)
Seat 7: pellion folded before Flop (didn't bet)
Seat 8: A.V.LIN folded before Flop (didn't bet)
Seat 9: GalaktionoW folded before Flop



PokerStars Zoom Hand #172852767811:  Hold'em No Limit ($0.01/$0.02) - 2017/07/10 12:21:46 ET
Table 'McNaught' 9-max Seat #1 is the button
Seat 1: SeregaBear ($0.87 in chips) 
Seat 2: jackie.ko ($1.18 in chips) 
Seat 3: DiNiceBoy ($2.67 in chips) 
Seat 4: Redvin33 ($1.50 in chips) 
Seat 5: oghls ($2.69 in chips) 
Seat 6: 7prokhorov ($1.37 in chips) 
Seat 7: Grom662-662 ($2.57 in chips) 
Seat 8: tape ruvicha ($2.35 in chips) 
Seat 9: Oresboroz ($2 in chips) 
jackie.ko: posts small blind $0.01
DiNiceBoy: posts big blind $0.02
*** HOLE CARDS ***
Dealt to Redvin33 [6h 5h]
Redvin33: folds 
oghls: folds 
7prokhorov: folds 
Grom662-662: folds 
tape ruvicha: folds 
Oresboroz: raises $0.02 to $0.04
SeregaBear: folds 
jackie.ko: folds 
DiNiceBoy: folds 
Uncalled bet ($0.02) returned to Oresboroz
Oresboroz collected $0.05 from pot
Oresboroz: doesn't show hand 
*** SUMMARY ***
Total pot $0.05 | Rake $0 
Seat 1: SeregaBear (button) folded before Flop (didn't bet)
Seat 2: jackie.ko (small blind) folded before Flop
Seat 3: DiNiceBoy (big blind) folded before Flop
Seat 4: Redvin33 folded before Flop (didn't bet)
Seat 5: oghls folded before Flop (didn't bet)
Seat 6: 7prokhorov folded before Flop (didn't bet)
Seat 7: Grom662-662 folded before Flop (didn't bet)
Seat 8: tape ruvicha folded before Flop (didn't bet)
Seat 9: Oresboroz collected ($0.05)



PokerStars Zoom Hand #172852773007:  Hold'em No Limit ($0.01/$0.02) - 2017/07/10 12:21:54 ET
Table 'McNaught' 9-max Seat #1 is the button
Seat 1: SilAnd ($1.81 in chips) 
Seat 2: Flleys ($2.11 in chips) 
Seat 3: alexon1967 ($1.73 in chips) 
Seat 4: Redvin33 ($1.50 in chips) 
Seat 5: lexy615 ($4.06 in chips) 
Seat 6: Neptune27 ($2.03 in chips) 
Seat 7: SeregaBear ($0.87 in chips) 
Seat 8: Opashko ($1.33 in chips) 
Seat 9: Vovchello13 ($2.15 in chips) 
Flleys: posts small blind $0.01
alexon1967: posts big blind $0.02
*** HOLE CARDS ***
Dealt to Redvin33 [Kh As]
Redvin33: raises $0.04 to $0.06
lexy615: folds 
Neptune27: folds 
SeregaBear: folds 
Opashko: folds 
Vovchello13: folds 
SilAnd: folds 
Flleys: folds 
alexon1967: folds 
Uncalled bet ($0.04) returned to Redvin33
Redvin33 collected $0.05 from pot
Redvin33: doesn't show hand 
*** SUMMARY ***
Total pot $0.05 | Rake $0 
Seat 1: SilAnd (button) folded before Flop (didn't bet)
Seat 2: Flleys (small blind) folded before Flop
Seat 3: alexon1967 (big blind) folded before Flop
Seat 4: Redvin33 collected ($0.05)
Seat 5: lexy615 folded before Flop (didn't bet)
Seat 6: Neptune27 folded before Flop (didn't bet)
Seat 7: SeregaBear folded before Flop (didn't bet)
Seat 8: Opashko folded before Flop (didn't bet)
Seat 9: Vovchello13 folded before Flop (didn't bet)



PokerStars Zoom Hand #172852762563:  Hold'em No Limit ($0.01/$0.02) - 2017/07/10 12:21:38 ET
Table 'McNaught' 9-max Seat #1 is the button
Seat 1: Hockeyberry ($2 in chips) 
Seat 2: Filonous ($2.18 in chips) 
Seat 3: Scouserslfc ($5.06 in chips) 
Seat 4: DUMSTIK ($2 in chips) 
Seat 5: rrrr1958 ($1.47 in chips) 
Seat 6: 11The11 ($2 in chips) 
Seat 7: lizzard0705 ($1.29 in chips) 
Seat 8: KYU00 ($1.88 in chips) 
Seat 9: Redvin33 ($1.50 in chips) 
Filonous: posts small blind $0.01
Scouserslfc: posts big blind $0.02
*** HOLE CARDS ***
Dealt to Redvin33 [Tc 2c]
DUMSTIK: folds 
rrrr1958: folds 
11The11: raises $0.04 to $0.06
lizzard0705: folds 
KYU00: folds 
Redvin33: folds 
Hockeyberry: calls $0.06
Filonous: folds 
Scouserslfc: folds 
*** FLOP *** [Js 9h 4s]
11The11: bets $0.08
Hockeyberry: calls $0.08
*** TURN *** [Js 9h 4s] [Jc]
11The11: checks 
Hockeyberry: bets $0.20
11The11: folds 
Uncalled bet ($0.20) returned to Hockeyberry
Hockeyberry collected $0.30 from pot
Hockeyberry: doesn't show hand 
*** SUMMARY ***
Total pot $0.31 | Rake $0.01 
Board [Js 9h 4s Jc]
Seat 1: Hockeyberry (button) collected ($0.30)
Seat 2: Filonous (small blind) folded before Flop
Seat 3: Scouserslfc (big blind) folded before Flop
Seat 4: DUMSTIK folded before Flop (didn't bet)
Seat 5: rrrr1958 folded before Flop (didn't bet)
Seat 6: 11The11 folded on the Turn
Seat 7: lizzard0705 folded before Flop (didn't bet)
Seat 8: KYU00 folded before Flop (didn't bet)
Seat 9: Redvin33 folded before Flop (didn't bet)



PokerStars Zoom Hand #172852787948:  Hold'em No Limit ($0.01/$0.02) - 2017/07/10 12:22:17 ET
Table 'McNaught' 9-max Seat #1 is the button
Seat 1: TapaKaH1 ($3.60 in chips) 
Seat 2: garça409 ($2.24 in chips) 
Seat 3: Redvin33 ($1.53 in chips) 
Seat 4: 7prokhorov ($2.80 in chips) 
Seat 5: LoveBadBeat0 ($2.22 in chips) 
Seat 6: DiNiceBoy ($2.12 in chips) 
Seat 7: GRaf872 ($1.82 in chips) 
Seat 8: ClailtonA. ($0.44 in chips) 
Seat 9: RMDvD ($2.06 in chips) 
garça409: posts small blind $0.01
Redvin33: posts big blind $0.02
*** HOLE CARDS ***
Dealt to Redvin33 [Qs 4d]
7prokhorov: folds 
LoveBadBeat0: folds 
DiNiceBoy: folds 
GRaf872: folds 
ClailtonA.: raises $0.04 to $0.06
RMDvD: folds 
TapaKaH1: folds 
garça409: folds 
Redvin33: folds 
Uncalled bet ($0.04) returned to ClailtonA.
ClailtonA. collected $0.05 from pot
ClailtonA.: doesn't show hand 
*** SUMMARY ***
Total pot $0.05 | Rake $0 
Seat 1: TapaKaH1 (button) folded before Flop (didn't bet)
Seat 2: garça409 (small blind) folded before Flop
Seat 3: Redvin33 (big blind) folded before Flop
Seat 4: 7prokhorov folded before Flop (didn't bet)
Seat 5: LoveBadBeat0 folded before Flop (didn't bet)
Seat 6: DiNiceBoy folded before Flop (didn't bet)
Seat 7: GRaf872 folded before Flop (didn't bet)
Seat 8: ClailtonA. collected ($0.05)
Seat 9: RMDvD folded before Flop (didn't bet)



PokerStars Zoom Hand #172852770472:  Hold'em No Limit ($0.01/$0.02) - 2017/07/10 12:21:50 ET
Table 'McNaught' 9-max Seat #1 is the button
Seat 1: juniny0 ($2.06 in chips) 
Seat 2: RMDvD ($2.56 in chips) 
Seat 3: Himik30 ($2.11 in chips) 
Seat 4: pellion ($2 in chips) 
Seat 5: 9basta1 ($2.08 in chips) 
Seat 6: gogapok ($1.82 in chips) 
Seat 7: Olekxsander ($3.09 in chips) 
Seat 8: Redvin33 ($1.50 in chips) 
Seat 9: 7prokhorov ($1.37 in chips) 
RMDvD: posts small blind $0.01
Himik30: posts big blind $0.02
*** HOLE CARDS ***
Dealt to Redvin33 [2d Ks]
pellion: raises $0.06 to $0.08
9basta1: folds 
gogapok: folds 
Olekxsander: raises $0.19 to $0.27
Redvin33: folds 
7prokhorov: folds 
juniny0: folds 
RMDvD: folds 
Himik30: folds 
pellion: calls $0.19
*** FLOP *** [4h Ac 5s]
pellion: checks 
Olekxsander: bets $0.32
pellion: raises $1.41 to $1.73 and is all-in
Olekxsander: calls $1.41
*** TURN *** [4h Ac 5s] [Td]
*** RIVER *** [4h Ac 5s Td] [2c]
*** SHOW DOWN ***
pellion: shows [4c 5c] (two pair, Fives and Fours)
Olekxsander: shows [Kc Ah] (a pair of Aces)
pellion collected $3.89 from pot
*** SUMMARY ***
Total pot $4.03 | Rake $0.14 
Board [4h Ac 5s Td 2c]
Seat 1: juniny0 (button) folded before Flop (didn't bet)
Seat 2: RMDvD (small blind) folded before Flop
Seat 3: Himik30 (big blind) folded before Flop
Seat 4: pellion showed [4c 5c] and won ($3.89) with two pair, Fives and Fours
Seat 5: 9basta1 folded before Flop (didn't bet)
Seat 6: gogapok folded before Flop (didn't bet)
Seat 7: Olekxsander showed [Kc Ah] and lost with a pair of Aces
Seat 8: Redvin33 folded before Flop (didn't bet)
Seat 9: 7prokhorov folded before Flop (didn't bet)



PokerStars Zoom Hand #172852796961:  Hold'em No Limit ($0.01/$0.02) - 2017/07/10 12:22:31 ET
Table 'McNaught' 9-max Seat #1 is the button
Seat 1: 777uliana777 ($4.36 in chips) 
Seat 2: Redvin33 ($1.51 in chips) 
Seat 3: 19ABK64 ($2.67 in chips) 
Seat 4: steisy.bg ($2.25 in chips) 
Seat 5: Katelpiller ($2.44 in chips) 
Seat 6: Flleys ($2.71 in chips) 
Seat 7: solyom217 ($2 in chips) 
Seat 8: alkraf ($2 in chips) 
Seat 9: gogapok ($2.13 in chips) 
Redvin33: posts small blind $0.01
19ABK64: posts big blind $0.02
*** HOLE CARDS ***
Dealt to Redvin33 [3d Qs]
steisy.bg: raises $0.02 to $0.04
Katelpiller: folds 
Flleys: folds 
solyom217: folds 
alkraf: folds 
gogapok: folds 
777uliana777: folds 
Redvin33: folds 
19ABK64: calls $0.02
*** FLOP *** [6d 4c 7c]
19ABK64: checks 
steisy.bg: checks 
*** TURN *** [6d 4c 7c] [Qc]
19ABK64: bets $0.05
steisy.bg: folds 
Uncalled bet ($0.05) returned to 19ABK64
19ABK64 collected $0.09 from pot
19ABK64: doesn't show hand 
*** SUMMARY ***
Total pot $0.09 | Rake $0 
Board [6d 4c 7c Qc]
Seat 1: 777uliana777 (button) folded before Flop (didn't bet)
Seat 2: Redvin33 (small blind) folded before Flop
Seat 3: 19ABK64 (big blind) collected ($0.09)
Seat 4: steisy.bg folded on the Turn
Seat 5: Katelpiller folded before Flop (didn't bet)
Seat 6: Flleys folded before Flop (didn't bet)
Seat 7: solyom217 folded before Flop (didn't bet)
Seat 8: alkraf folded before Flop (didn't bet)
Seat 9: gogapok folded before Flop (didn't bet)



PokerStars Zoom Hand #172852785376:  Hold'em No Limit ($0.01/$0.02) - 2017/07/10 12:22:13 ET
Table 'McNaught' 9-max Seat #1 is the button
Seat 1: MikhMaster ($2.21 in chips) 
Seat 2: PSzpak ($2 in chips) 
Seat 3: Alex250783 ($1.07 in chips) 
Seat 4: Redvin33 ($1.53 in chips) 
Seat 5: 7prokhorov ($2.80 in chips) 
Seat 6: triny9 ($4.29 in chips) 
Seat 7: tamaska01 ($1.12 in chips) 
Seat 8: AgressoRun ($2 in chips) 
Seat 9: flayTilt ($3.82 in chips) 
PSzpak: posts small blind $0.01
Alex250783: posts big blind $0.02
*** HOLE CARDS ***
Dealt to Redvin33 [9d 7h]
Redvin33: folds 
7prokhorov: folds 
triny9: folds 
tamaska01: folds 
AgressoRun: folds 
flayTilt: folds 
MikhMaster: raises $0.04 to $0.06
PSzpak: calls $0.05
Alex250783: calls $0.04
*** FLOP *** [Qd Kh 8s]
PSzpak: checks 
Alex250783: checks 
MikhMaster: bets $0.11
PSzpak: folds 
Alex250783: calls $0.11
*** TURN *** [Qd Kh 8s] [4d]
Alex250783: checks 
MikhMaster: checks 
*** RIVER *** [Qd Kh 8s 4d] [6c]
Alex250783: checks 
MikhMaster: checks 
*** SHOW DOWN ***
Alex250783: shows [Jh Tc] (high card King)
MikhMaster: shows [Ad As] (a pair of Aces)
MikhMaster collected $0.39 from pot
*** SUMMARY ***
Total pot $0.40 | Rake $0.01 
Board [Qd Kh 8s 4d 6c]
Seat 1: MikhMaster (button) showed [Ad As] and won ($0.39) with a pair of Aces
Seat 2: PSzpak (small blind) folded on the Flop
Seat 3: Alex250783 (big blind) showed [Jh Tc] and lost with high card King
Seat 4: Redvin33 folded before Flop (didn't bet)
Seat 5: 7prokhorov folded before Flop (didn't bet)
Seat 6: triny9 folded before Flop (didn't bet)
Seat 7: tamaska01 folded before Flop (didn't bet)
Seat 8: AgressoRun folded before Flop (didn't bet)
Seat 9: flayTilt folded before Flop (didn't bet)



PokerStars Zoom Hand #172852800186:  Hold'em No Limit ($0.01/$0.02) - 2017/07/10 12:22:36 ET
Table 'McNaught' 9-max Seat #1 is the button
Seat 1: Redvin33 ($1.50 in chips) 
Seat 2: Grom662-662 ($2.37 in chips) 
Seat 3: BluffOnTable ($2.08 in chips) 
Seat 4: manowar7771 ($2.07 in chips) 
Seat 5: Himik30 ($2.08 in chips) 
Seat 6: W.L.54 ($1.97 in chips) 
Seat 7: Elchorro2008 ($2.43 in chips) 
Seat 8: rekopocram ($0.89 in chips) 
Seat 9: MOU77Y ($2.20 in chips) 
Grom662-662: posts small blind $0.01
BluffOnTable: posts big blind $0.02
*** HOLE CARDS ***
Dealt to Redvin33 [Jc Ks]
manowar7771: folds 
Himik30: folds 
W.L.54: folds 
Elchorro2008: folds 
rekopocram: folds 
MOU77Y: folds 
Redvin33: raises $0.02 to $0.04
Grom662-662: folds 
BluffOnTable: folds 
Uncalled bet ($0.02) returned to Redvin33
Redvin33 collected $0.05 from pot
Redvin33: doesn't show hand 
*** SUMMARY ***
Total pot $0.05 | Rake $0 
Seat 1: Redvin33 (button) collected ($0.05)
Seat 2: Grom662-662 (small blind) folded before Flop
Seat 3: BluffOnTable (big blind) folded before Flop
Seat 4: manowar7771 folded before Flop (didn't bet)
Seat 5: Himik30 folded before Flop (didn't bet)
Seat 6: W.L.54 folded before Flop (didn't bet)
Seat 7: Elchorro2008 folded before Flop (didn't bet)
Seat 8: rekopocram folded before Flop (didn't bet)
Seat 9: MOU77Y folded before Flop (didn't bet)



PokerStars Zoom Hand #172852812610:  Hold'em No Limit ($0.01/$0.02) - 2017/07/10 12:22:55 ET
Table 'McNaught' 9-max Seat #1 is the button
Seat 1: dimarik_nur1 ($2.47 in chips) 
Seat 2: GaliRah ($2.48 in chips) 
Seat 3: Flikers ($2 in chips) 
Seat 4: YOHONSON ($2.09 in chips) 
Seat 5: dagordin ($3.43 in chips) 
Seat 6: szeged31 ($2.25 in chips) 
Seat 7: Redvin33 ($1.53 in chips) 
Seat 8: horsedos88 ($0.65 in chips) 
Seat 9: Neptune27 ($2 in chips) 
GaliRah: posts small blind $0.01
Flikers: posts big blind $0.02
*** HOLE CARDS ***
Dealt to Redvin33 [As Qh]
YOHONSON: folds 
dagordin: folds 
szeged31: folds 
Redvin33: raises $0.03 to $0.05
horsedos88: folds 
Neptune27: folds 
dimarik_nur1: folds 
GaliRah: folds 
Flikers: folds 
Uncalled bet ($0.03) returned to Redvin33
Redvin33 collected $0.05 from pot
Redvin33: doesn't show hand 
*** SUMMARY ***
Total pot $0.05 | Rake $0 
Seat 1: dimarik_nur1 (button) folded before Flop (didn't bet)
Seat 2: GaliRah (small blind) folded before Flop
Seat 3: Flikers (big blind) folded before Flop
Seat 4: YOHONSON folded before Flop (didn't bet)
Seat 5: dagordin folded before Flop (didn't bet)
Seat 6: szeged31 folded before Flop (didn't bet)
Seat 7: Redvin33 collected ($0.05)
Seat 8: horsedos88 folded before Flop (didn't bet)
Seat 9: Neptune27 folded before Flop (didn't bet)



PokerStars Zoom Hand #172852823650:  Hold'em No Limit ($0.01/$0.02) - 2017/07/10 12:23:12 ET
Table 'McNaught' 9-max Seat #1 is the button
Seat 1: abcastellob ($1.30 in chips) 
Seat 2: Tamuca ($3.78 in chips) 
Seat 3: maxik1309 ($2.20 in chips) 
Seat 4: LoveBadBeat0 ($2.14 in chips) 
Seat 5: valera_9696@ ($3.88 in chips) 
Seat 6: tdjf ($3.68 in chips) 
Seat 7: SanDmitri4 ($3.62 in chips) 
Seat 8: Redvin33 ($1.56 in chips) 
Seat 9: Kolya813 ($4.12 in chips) 
Tamuca: posts small blind $0.01
maxik1309: posts big blind $0.02
*** HOLE CARDS ***
Dealt to Redvin33 [Ah Qs]
LoveBadBeat0: folds 
valera_9696@: folds 
tdjf: folds 
SanDmitri4: folds 
Redvin33: raises $0.03 to $0.05
Kolya813: folds 
abcastellob: calls $0.05
Tamuca: folds 
maxik1309: calls $0.03
*** FLOP *** [9d Tc Jh]
maxik1309: checks 
Redvin33: bets $0.05
abcastellob: folds 
maxik1309: calls $0.05
*** TURN *** [9d Tc Jh] [2s]
maxik1309: checks 
Redvin33: checks 
*** RIVER *** [9d Tc Jh 2s] [Ac]
maxik1309: bets $0.25
Redvin33: calls $0.25
*** SHOW DOWN ***
maxik1309: shows [Kc Js] (a pair of Jacks)
Redvin33: shows [Ah Qs] (a pair of Aces)
Redvin33 collected $0.73 from pot
*** SUMMARY ***
Total pot $0.76 | Rake $0.03 
Board [9d Tc Jh 2s Ac]
Seat 1: abcastellob (button) folded on the Flop
Seat 2: Tamuca (small blind) folded before Flop
Seat 3: maxik1309 (big blind) showed [Kc Js] and lost with a pair of Jacks
Seat 4: LoveBadBeat0 folded before Flop (didn't bet)
Seat 5: valera_9696@ folded before Flop (didn't bet)
Seat 6: tdjf folded before Flop (didn't bet)
Seat 7: SanDmitri4 folded before Flop (didn't bet)
Seat 8: Redvin33 showed [Ah Qs] and won ($0.73) with a pair of Aces
Seat 9: Kolya813 folded before Flop (didn't bet)



PokerStars Zoom Hand #172852852291:  Hold'em No Limit ($0.01/$0.02) - 2017/07/10 12:23:56 ET
Table 'McNaught' 9-max Seat #1 is the button
Seat 1: somsomm ($2.03 in chips) 
Seat 2: maxik1309 ($1.85 in chips) 
Seat 3: levikeeeLOL ($3.14 in chips) 
Seat 4: tollik101 ($1.27 in chips) 
Seat 5: Opashko ($1.09 in chips) 
Seat 6: KVK1960 ($2.05 in chips) 
Seat 7: baik1211 ($1.94 in chips) 
Seat 8: Flleys ($3.27 in chips) 
Seat 9: Redvin33 ($1.94 in chips) 
maxik1309: posts small blind $0.01
levikeeeLOL: posts big blind $0.02
*** HOLE CARDS ***
Dealt to Redvin33 [Kh Ad]
tollik101: folds 
Opashko: raises $0.02 to $0.04
KVK1960: folds 
baik1211: folds 
Flleys: folds 
Redvin33: raises $0.04 to $0.08
somsomm: folds 
maxik1309: calls $0.07
levikeeeLOL: folds 
Opashko: calls $0.04
*** FLOP *** [4d Jh 9c]
maxik1309: bets $0.25
Opashko: calls $0.25
Redvin33: folds 
*** TURN *** [4d Jh 9c] [2s]
maxik1309: bets $0.73
Opashko: raises $0.03 to $0.76 and is all-in
maxik1309: calls $0.03
*** RIVER *** [4d Jh 9c 2s] [7c]
*** SHOW DOWN ***
maxik1309: shows [Td Jd] (a pair of Jacks)
Opashko: shows [9h Js] (two pair, Jacks and Nines)
Opashko collected $2.20 from pot
*** SUMMARY ***
Total pot $2.28 | Rake $0.08 
Board [4d Jh 9c 2s 7c]
Seat 1: somsomm (button) folded before Flop (didn't bet)
Seat 2: maxik1309 (small blind) showed [Td Jd] and lost with a pair of Jacks
Seat 3: levikeeeLOL (big blind) folded before Flop
Seat 4: tollik101 folded before Flop (didn't bet)
Seat 5: Opashko showed [9h Js] and won ($2.20) with two pair, Jacks and Nines
Seat 6: KVK1960 folded before Flop (didn't bet)
Seat 7: baik1211 folded before Flop (didn't bet)
Seat 8: Flleys folded before Flop (didn't bet)
Seat 9: Redvin33 folded on the Flop



PokerStars Zoom Hand #172852871176:  Hold'em No Limit ($0.01/$0.02) - 2017/07/10 12:24:25 ET
Table 'McNaught' 9-max Seat #1 is the button
Seat 1: 19Vladimir83 ($3.03 in chips) 
Seat 2: QuadrupleKo ($3.05 in chips) 
Seat 3: nsigi ($2.70 in chips) 
Seat 4: AgressoRun ($3.16 in chips) 
Seat 5: frans312 ($2.03 in chips) 
Seat 6: Redvin33 ($1.86 in chips) 
Seat 7: RiversideG ($2.22 in chips) 
Seat 8: beluci1 ($2.02 in chips) 
Seat 9: rrrr1958 ($1.34 in chips) 
QuadrupleKo: posts small blind $0.01
nsigi: posts big blind $0.02
*** HOLE CARDS ***
Dealt to Redvin33 [Kh Kc]
AgressoRun: calls $0.02
frans312: folds 
Redvin33: raises $0.04 to $0.06
RiversideG: folds 
beluci1: raises $0.14 to $0.20
rrrr1958: folds 
19Vladimir83: folds 
QuadrupleKo: folds 
nsigi: folds 
AgressoRun: folds 
Redvin33: raises $0.20 to $0.40
beluci1: folds 
Uncalled bet ($0.20) returned to Redvin33
Redvin33 collected $0.45 from pot
Redvin33: doesn't show hand 
*** SUMMARY ***
Total pot $0.45 | Rake $0 
Seat 1: 19Vladimir83 (button) folded before Flop (didn't bet)
Seat 2: QuadrupleKo (small blind) folded before Flop
Seat 3: nsigi (big blind) folded before Flop
Seat 4: AgressoRun folded before Flop
Seat 5: frans312 folded before Flop (didn't bet)
Seat 6: Redvin33 collected ($0.45)
Seat 7: RiversideG folded before Flop (didn't bet)
Seat 8: beluci1 folded before Flop
Seat 9: rrrr1958 folded before Flop (didn't bet)



PokerStars Zoom Hand #172852891051:  Hold'em No Limit ($0.01/$0.02) - 2017/07/10 12:24:55 ET
Table 'McNaught' 9-max Seat #1 is the button
Seat 1: coke977 ($4 in chips) 
Seat 2: SERGEY 26RUS ($1.41 in chips) 
Seat 3: DUMSTIK ($2 in chips) 
Seat 4: Redvin33 ($2.11 in chips) 
Seat 5: Bear4943 ($2.18 in chips) 
Seat 6: LoveBadBeat0 ($2.05 in chips) 
Seat 7: 7prokhorov ($1.37 in chips) 
Seat 8: Scouserslfc ($2.05 in chips) 
Seat 9: somsomm ($2 in chips) 
SERGEY 26RUS: posts small blind $0.01
DUMSTIK: posts big blind $0.02
*** HOLE CARDS ***
Dealt to Redvin33 [Kd Jd]
Redvin33: raises $0.02 to $0.04
Bear4943: folds 
LoveBadBeat0: folds 
7prokhorov: folds 
Scouserslfc: folds 
somsomm: folds 
coke977: folds 
SERGEY 26RUS: folds 
DUMSTIK: folds 
Uncalled bet ($0.02) returned to Redvin33
Redvin33 collected $0.05 from pot
Redvin33: doesn't show hand 
*** SUMMARY ***
Total pot $0.05 | Rake $0 
Seat 1: coke977 (button) folded before Flop (didn't bet)
Seat 2: SERGEY 26RUS (small blind) folded before Flop
Seat 3: DUMSTIK (big blind) folded before Flop
Seat 4: Redvin33 collected ($0.05)
Seat 5: Bear4943 folded before Flop (didn't bet)
Seat 6: LoveBadBeat0 folded before Flop (didn't bet)
Seat 7: 7prokhorov folded before Flop (didn't bet)
Seat 8: Scouserslfc folded before Flop (didn't bet)
Seat 9: somsomm folded before Flop (didn't bet)



PokerStars Zoom Hand #172852903510:  Hold'em No Limit ($0.01/$0.02) - 2017/07/10 12:25:14 ET
Table 'McNaught' 9-max Seat #1 is the button
Seat 1: KidBananan ($2.37 in chips) 
Seat 2: MOU77Y ($2.27 in chips) 
Seat 3: RiversideG ($2.21 in chips) 
Seat 4: DUMSTIK ($2 in chips) 
Seat 5: horsedos88 ($2.16 in chips) 
Seat 6: LoveBadBeat0 ($5.94 in chips) 
Seat 7: stiklius ($1.82 in chips) 
Seat 8: 19Vladimir83 ($3.02 in chips) 
Seat 9: Redvin33 ($2.14 in chips) 
MOU77Y: posts small blind $0.01
RiversideG: posts big blind $0.02
*** HOLE CARDS ***
Dealt to Redvin33 [Qs 6d]
DUMSTIK: folds 
horsedos88: folds 
LoveBadBeat0: folds 
stiklius: raises $0.04 to $0.06
19Vladimir83: folds 
Redvin33: folds 
KidBananan: calls $0.06
MOU77Y: folds 
RiversideG: folds 
*** FLOP *** [8d 6s 5s]
stiklius: bets $0.14
KidBananan: folds 
Uncalled bet ($0.14) returned to stiklius
stiklius collected $0.14 from pot
stiklius: doesn't show hand 
*** SUMMARY ***
Total pot $0.15 | Rake $0.01 
Board [8d 6s 5s]
Seat 1: KidBananan (button) folded on the Flop
Seat 2: MOU77Y (small blind) folded before Flop
Seat 3: RiversideG (big blind) folded before Flop
Seat 4: DUMSTIK folded before Flop (didn't bet)
Seat 5: horsedos88 folded before Flop (didn't bet)
Seat 6: LoveBadBeat0 folded before Flop (didn't bet)
Seat 7: stiklius collected ($0.14)
Seat 8: 19Vladimir83 folded before Flop (didn't bet)
Seat 9: Redvin33 folded before Flop (didn't bet)



PokerStars Zoom Hand #172852906187:  Hold'em No Limit ($0.01/$0.02) - 2017/07/10 12:25:18 ET
Table 'McNaught' 9-max Seat #1 is the button
Seat 1: rudie001 ($1.78 in chips) 
Seat 2: Fostal_by ($2 in chips) 
Seat 3: Redvin33 ($2.14 in chips) 
Seat 4: Bear4943 ($4.49 in chips) 
Seat 5: LoveBadBeat0 ($2.03 in chips) 
Seat 6: ostrograd ($2.06 in chips) 
Seat 7: szeged31 ($2.22 in chips) 
Seat 8: macfly5555 ($1.74 in chips) 
Seat 9: h1_tech_1mba ($3.54 in chips) 
Fostal_by: posts small blind $0.01
Redvin33: posts big blind $0.02
*** HOLE CARDS ***
Dealt to Redvin33 [5h 9c]
Bear4943: folds 
LoveBadBeat0: folds 
ostrograd: folds 
szeged31: calls $0.02
macfly5555: raises $0.07 to $0.09
h1_tech_1mba: folds 
rudie001: folds 
Fostal_by: folds 
Redvin33: folds 
szeged31: folds 
Uncalled bet ($0.07) returned to macfly5555
macfly5555 collected $0.07 from pot
macfly5555: doesn't show hand 
*** SUMMARY ***
Total pot $0.07 | Rake $0 
Seat 1: rudie001 (button) folded before Flop (didn't bet)
Seat 2: Fostal_by (small blind) folded before Flop
Seat 3: Redvin33 (big blind) folded before Flop
Seat 4: Bear4943 folded before Flop (didn't bet)
Seat 5: LoveBadBeat0 folded before Flop (didn't bet)
Seat 6: ostrograd folded before Flop (didn't bet)
Seat 7: szeged31 folded before Flop
Seat 8: macfly5555 collected ($0.07)
Seat 9: h1_tech_1mba folded before Flop (didn't bet)



PokerStars Zoom Hand #172852914850:  Hold'em No Limit ($0.01/$0.02) - 2017/07/10 12:25:31 ET
Table 'McNaught' 9-max Seat #1 is the button
Seat 1: Poker in DNA ($6.20 in chips) 
Seat 2: Redvin33 ($2.12 in chips) 
Seat 3: Tamuca ($2.06 in chips) 
Seat 4: GalaktionoW ($9.29 in chips) 
Seat 5: AgressoRun ($3.14 in chips) 
Seat 6: Bursis ($2.59 in chips) 
Seat 7: svetik_bbbb ($2.18 in chips) 
Seat 8: laguna-38 ($0.83 in chips) 
Seat 9: Kirya2790 ($2 in chips) 
Redvin33: posts small blind $0.01
Tamuca: posts big blind $0.02
*** HOLE CARDS ***
Dealt to Redvin33 [5d Td]
GalaktionoW: folds 
AgressoRun: folds 
Bursis: folds 
svetik_bbbb: folds 
laguna-38: folds 
Kirya2790: folds 
Poker in DNA: folds 
Redvin33: folds 
Uncalled bet ($0.01) returned to Tamuca
Tamuca collected $0.02 from pot
Tamuca: doesn't show hand 
*** SUMMARY ***
Total pot $0.02 | Rake $0 
Seat 1: Poker in DNA (button) folded before Flop (didn't bet)
Seat 2: Redvin33 (small blind) folded before Flop
Seat 3: Tamuca (big blind) collected ($0.02)
Seat 4: GalaktionoW folded before Flop (didn't bet)
Seat 5: AgressoRun folded before Flop (didn't bet)
Seat 6: Bursis folded before Flop (didn't bet)
Seat 7: svetik_bbbb folded before Flop (didn't bet)
Seat 8: laguna-38 folded before Flop (didn't bet)
Seat 9: Kirya2790 folded before Flop (didn't bet)



PokerStars Zoom Hand #172852917477:  Hold'em No Limit ($0.01/$0.02) - 2017/07/10 12:25:35 ET
Table 'McNaught' 9-max Seat #1 is the button
Seat 1: Redvin33 ($2.11 in chips) 
Seat 2: Hoochie49 ($1.98 in chips) 
Seat 3: KidBananan ($2.17 in chips) 
Seat 4: 19Vladimir83 ($3.02 in chips) 
Seat 5: Flikers ($2 in chips) 
Seat 6: DARKLORRRD ($2.41 in chips) 
Seat 7: bondo74rus ($2.07 in chips) 
Seat 8: coke977 ($3.99 in chips) 
Seat 9: Himik30 ($2.35 in chips) 
Hoochie49: posts small blind $0.01
KidBananan: posts big blind $0.02
*** HOLE CARDS ***
Dealt to Redvin33 [6s Js]
19Vladimir83: raises $0.06 to $0.08
Flikers: folds 
DARKLORRRD: folds 
bondo74rus: folds 
coke977: folds 
Himik30: folds 
Redvin33: folds 
Hoochie49: folds 
KidBananan: folds 
Uncalled bet ($0.06) returned to 19Vladimir83
19Vladimir83 collected $0.05 from pot
19Vladimir83: doesn't show hand 
*** SUMMARY ***
Total pot $0.05 | Rake $0 
Seat 1: Redvin33 (button) folded before Flop (didn't bet)
Seat 2: Hoochie49 (small blind) folded before Flop
Seat 3: KidBananan (big blind) folded before Flop
Seat 4: 19Vladimir83 collected ($0.05)
Seat 5: Flikers folded before Flop (didn't bet)
Seat 6: DARKLORRRD folded before Flop (didn't bet)
Seat 7: bondo74rus folded before Flop (didn't bet)
Seat 8: coke977 folded before Flop (didn't bet)
Seat 9: Himik30 folded before Flop (didn't bet)



PokerStars Zoom Hand #172852920078:  Hold'em No Limit ($0.01/$0.02) - 2017/07/10 12:25:39 ET
Table 'McNaught' 9-max Seat #1 is the button
Seat 1: Kolya813 ($2.02 in chips) 
Seat 2: dakama_po ($2.01 in chips) 
Seat 3: whotrust?mee ($2.56 in chips) 
Seat 4: MOU77Y ($2.24 in chips) 
Seat 5: Bursis ($2.59 in chips) 
Seat 6: guderian41 ($2.60 in chips) 
Seat 7: Redvin33 ($2.11 in chips) 
Seat 8: DARKLORRRD ($2.41 in chips) 
Seat 9: solyom217 ($2.07 in chips) 
dakama_po: posts small blind $0.01
whotrust?mee: posts big blind $0.02
*** HOLE CARDS ***
Dealt to Redvin33 [4h 8d]
MOU77Y: folds 
Bursis: folds 
guderian41 has timed out
guderian41: folds 
Redvin33: folds 
DARKLORRRD: folds 
solyom217: folds 
Kolya813: folds 
dakama_po: folds 
Uncalled bet ($0.01) returned to whotrust?mee
whotrust?mee collected $0.02 from pot
whotrust?mee: doesn't show hand 
*** SUMMARY ***
Total pot $0.02 | Rake $0 
Seat 1: Kolya813 (button) folded before Flop (didn't bet)
Seat 2: dakama_po (small blind) folded before Flop
Seat 3: whotrust?mee (big blind) collected ($0.02)
Seat 4: MOU77Y folded before Flop (didn't bet)
Seat 5: Bursis folded before Flop (didn't bet)
Seat 6: guderian41 folded before Flop (didn't bet)
Seat 7: Redvin33 folded before Flop (didn't bet)
Seat 8: DARKLORRRD folded before Flop (didn't bet)
Seat 9: solyom217 folded before Flop (didn't bet)



PokerStars Zoom Hand #172852927980:  Hold'em No Limit ($0.01/$0.02) - 2017/07/10 12:25:51 ET
Table 'McNaught' 9-max Seat #1 is the button
Seat 1: rekopocram ($2.49 in chips) 
Seat 2: theoakbanker ($1.90 in chips) 
Seat 3: wolf_dima ($0.99 in chips) 
Seat 4: CantStumpDis ($2 in chips) 
Seat 5: AJIEKC ($1.61 in chips) 
Seat 6: Redvin33 ($2.11 in chips) 
Seat 7: GalaktionoW ($6.62 in chips) 
Seat 8: pellion ($1.92 in chips) 
Seat 9: Fostal_by ($2 in chips) 
theoakbanker: posts small blind $0.01
wolf_dima: posts big blind $0.02
*** HOLE CARDS ***
Dealt to Redvin33 [3c 7c]
CantStumpDis: folds 
AJIEKC: folds 
Redvin33: folds 
GalaktionoW: folds 
pellion: raises $0.06 to $0.08
Fostal_by: folds 
rekopocram: folds 
theoakbanker: folds 
wolf_dima: folds 
Uncalled bet ($0.06) returned to pellion
pellion collected $0.05 from pot
pellion: doesn't show hand 
*** SUMMARY ***
Total pot $0.05 | Rake $0 
Seat 1: rekopocram (button) folded before Flop (didn't bet)
Seat 2: theoakbanker (small blind) folded before Flop
Seat 3: wolf_dima (big blind) folded before Flop
Seat 4: CantStumpDis folded before Flop (didn't bet)
Seat 5: AJIEKC folded before Flop (didn't bet)
Seat 6: Redvin33 folded before Flop (didn't bet)
Seat 7: GalaktionoW folded before Flop (didn't bet)
Seat 8: pellion collected ($0.05)
Seat 9: Fostal_by folded before Flop (didn't bet)



PokerStars Zoom Hand #172852922707:  Hold'em No Limit ($0.01/$0.02) - 2017/07/10 12:25:43 ET
Table 'McNaught' 9-max Seat #1 is the button
Seat 1: qpsq ($2 in chips) 
Seat 2: TATS1983 ($0.65 in chips) 
Seat 3: Bursis ($2.59 in chips) 
Seat 4: marchela441 ($2.10 in chips) 
Seat 5: GalaktionoW ($6.62 in chips) 
Seat 6: golddrakon ($2.46 in chips) 
Seat 7: KingOgiii ($2.03 in chips) 
Seat 8: Redvin33 ($2.11 in chips) 
Seat 9: Flikers ($2.95 in chips) 
TATS1983: posts small blind $0.01
Bursis: posts big blind $0.02
*** HOLE CARDS ***
Dealt to Redvin33 [9d Js]
marchela441: raises $0.04 to $0.06
GalaktionoW: folds 
golddrakon: folds 
KingOgiii: folds 
Redvin33: folds 
Flikers: folds 
qpsq: folds 
TATS1983: folds 
Bursis: folds 
Uncalled bet ($0.04) returned to marchela441
marchela441 collected $0.05 from pot
marchela441: doesn't show hand 
*** SUMMARY ***
Total pot $0.05 | Rake $0 
Seat 1: qpsq (button) folded before Flop (didn't bet)
Seat 2: TATS1983 (small blind) folded before Flop
Seat 3: Bursis (big blind) folded before Flop
Seat 4: marchela441 collected ($0.05)
Seat 5: GalaktionoW folded before Flop (didn't bet)
Seat 6: golddrakon folded before Flop (didn't bet)
Seat 7: KingOgiii folded before Flop (didn't bet)
Seat 8: Redvin33 folded before Flop (didn't bet)
Seat 9: Flikers folded before Flop (didn't bet)



PokerStars Zoom Hand #172852930702:  Hold'em No Limit ($0.01/$0.02) - 2017/07/10 12:25:55 ET
Table 'McNaught' 9-max Seat #1 is the button
Seat 1: spIeeNy ($2.52 in chips) 
Seat 2: myrat05 ($5.33 in chips) 
Seat 3: GalaktionoW ($6.62 in chips) 
Seat 4: Redvin33 ($2.11 in chips) 
Seat 5: moyasyndrome ($3.95 in chips) 
Seat 6: flayTilt ($3.83 in chips) 
Seat 7: bondo74rus ($1.98 in chips) 
Seat 8: evgennn1410 ($2 in chips) 
Seat 9: taenzer64 ($2.32 in chips) 
myrat05: posts small blind $0.01
GalaktionoW: posts big blind $0.02
*** HOLE CARDS ***
Dealt to Redvin33 [4s 8s]
Redvin33: folds 
moyasyndrome: folds 
flayTilt: folds 
bondo74rus: folds 
evgennn1410: folds 
taenzer64: folds 
spIeeNy: folds 
myrat05: folds 
Uncalled bet ($0.01) returned to GalaktionoW
GalaktionoW collected $0.02 from pot
GalaktionoW: doesn't show hand 
*** SUMMARY ***
Total pot $0.02 | Rake $0 
Seat 1: spIeeNy (button) folded before Flop (didn't bet)
Seat 2: myrat05 (small blind) folded before Flop
Seat 3: GalaktionoW (big blind) collected ($0.02)
Seat 4: Redvin33 folded before Flop (didn't bet)
Seat 5: moyasyndrome folded before Flop (didn't bet)
Seat 6: flayTilt folded before Flop (didn't bet)
Seat 7: bondo74rus folded before Flop (didn't bet)
Seat 8: evgennn1410 folded before Flop (didn't bet)
Seat 9: taenzer64 folded before Flop (didn't bet)



PokerStars Zoom Hand #172852933948:  Hold'em No Limit ($0.01/$0.02) - 2017/07/10 12:26:00 ET
Table 'McNaught' 9-max Seat #1 is the button
Seat 1: valera_9696@ ($2.82 in chips) 
Seat 2: ocrimus ($2.04 in chips) 
Seat 3: mag8574 ($1 in chips) 
Seat 4: KikiDB ($2.92 in chips) 
Seat 5: Redvin33 ($2.11 in chips) 
Seat 6: FoldCase ($5 in chips) 
Seat 7: seshAD ($1.55 in chips) 
Seat 8: Diamond_1882 ($4.70 in chips) 
Seat 9: DiNiceBoy ($2.01 in chips) 
ocrimus: posts small blind $0.01
mag8574: posts big blind $0.02
*** HOLE CARDS ***
Dealt to Redvin33 [Qc 2h]
KikiDB: folds 
Redvin33: folds 
FoldCase: folds 
seshAD: folds 
Diamond_1882: folds 
DiNiceBoy: raises $0.03 to $0.05
valera_9696@: raises $0.07 to $0.12
ocrimus: folds 
mag8574: folds 
DiNiceBoy: folds 
Uncalled bet ($0.07) returned to valera_9696@
valera_9696@ collected $0.13 from pot
valera_9696@: doesn't show hand 
*** SUMMARY ***
Total pot $0.13 | Rake $0 
Seat 1: valera_9696@ (button) collected ($0.13)
Seat 2: ocrimus (small blind) folded before Flop
Seat 3: mag8574 (big blind) folded before Flop
Seat 4: KikiDB folded before Flop (didn't bet)
Seat 5: Redvin33 folded before Flop (didn't bet)
Seat 6: FoldCase folded before Flop (didn't bet)
Seat 7: seshAD folded before Flop (didn't bet)
Seat 8: Diamond_1882 folded before Flop (didn't bet)
Seat 9: DiNiceBoy folded before Flop



PokerStars Zoom Hand #172852925405:  Hold'em No Limit ($0.01/$0.02) - 2017/07/10 12:25:47 ET
Table 'McNaught' 9-max Seat #1 is the button
Seat 1: Vovchello13 ($2.13 in chips) 
Seat 2: ocrimus ($2.25 in chips) 
Seat 3: RiversideG ($2.51 in chips) 
Seat 4: BlackChinee1 ($1.72 in chips) 
Seat 5: Redvin33 ($2.11 in chips) 
Seat 6: laguna-38 ($0.82 in chips) 
Seat 7: Alex250783 ($0.70 in chips) 
Seat 8: moyasyndrome ($3.95 in chips) 
Seat 9: stiklius ($1.90 in chips) 
ocrimus: posts small blind $0.01
RiversideG: posts big blind $0.02
*** HOLE CARDS ***
Dealt to Redvin33 [3h Jc]
BlackChinee1: folds 
Redvin33: folds 
laguna-38: folds 
Alex250783: raises $0.02 to $0.04
moyasyndrome: folds 
stiklius: raises $0.04 to $0.08
Vovchello13: folds 
ocrimus: folds 
RiversideG: folds 
Alex250783: calls $0.04
*** FLOP *** [Jd 9h 6c]
Alex250783: checks 
stiklius: bets $0.18
Alex250783: calls $0.18
*** TURN *** [Jd 9h 6c] [Td]
Alex250783: bets $0.26
stiklius: folds 
Uncalled bet ($0.26) returned to Alex250783
Alex250783 collected $0.53 from pot
Alex250783: doesn't show hand 
*** SUMMARY ***
Total pot $0.55 | Rake $0.02 
Board [Jd 9h 6c Td]
Seat 1: Vovchello13 (button) folded before Flop (didn't bet)
Seat 2: ocrimus (small blind) folded before Flop
Seat 3: RiversideG (big blind) folded before Flop
Seat 4: BlackChinee1 folded before Flop (didn't bet)
Seat 5: Redvin33 folded before Flop (didn't bet)
Seat 6: laguna-38 folded before Flop (didn't bet)
Seat 7: Alex250783 collected ($0.53)
Seat 8: moyasyndrome folded before Flop (didn't bet)
Seat 9: stiklius folded on the Turn



PokerStars Zoom Hand #172852939220:  Hold'em No Limit ($0.01/$0.02) - 2017/07/10 12:26:08 ET
Table 'McNaught' 9-max Seat #1 is the button
Seat 1: Mepo12th ($2.19 in chips) 
Seat 2: rekopocram ($2.49 in chips) 
Seat 3: lma321 ($3.99 in chips) 
Seat 4: Flikers ($2.95 in chips) 
Seat 5: NAHALUGA ($2.26 in chips) 
Seat 6: valera_9696@ ($4.42 in chips) 
Seat 7: Redvin33 ($2.10 in chips) 
Seat 8: KidBananan ($2 in chips) 
Seat 9: susa009 ($2.02 in chips) 
rekopocram: posts small blind $0.01
lma321: posts big blind $0.02
*** HOLE CARDS ***
Dealt to Redvin33 [7d 2h]
Flikers: folds 
NAHALUGA: folds 
valera_9696@: folds 
Redvin33: folds 
KidBananan: folds 
susa009: folds 
Mepo12th: raises $0.04 to $0.06
rekopocram: folds 
lma321: folds 
Uncalled bet ($0.04) returned to Mepo12th
Mepo12th collected $0.05 from pot
Mepo12th: doesn't show hand 
*** SUMMARY ***
Total pot $0.05 | Rake $0 
Seat 1: Mepo12th (button) collected ($0.05)
Seat 2: rekopocram (small blind) folded before Flop
Seat 3: lma321 (big blind) folded before Flop
Seat 4: Flikers folded before Flop (didn't bet)
Seat 5: NAHALUGA folded before Flop (didn't bet)
Seat 6: valera_9696@ folded before Flop (didn't bet)
Seat 7: Redvin33 folded before Flop (didn't bet)
Seat 8: KidBananan folded before Flop (didn't bet)
Seat 9: susa009 folded before Flop (didn't bet)



PokerStars Zoom Hand #172852936606:  Hold'em No Limit ($0.01/$0.02) - 2017/07/10 12:26:04 ET
Table 'McNaught' 9-max Seat #1 is the button
Seat 1: DUMSTIK ($4.08 in chips) 
Seat 2: Redvin33 ($2.11 in chips) 
Seat 3: rrrr1958 ($1.28 in chips) 
Seat 4: FoldCase ($5 in chips) 
Seat 5: 9th Kind ($1.86 in chips) 
Seat 6: Poker in DNA ($2.65 in chips) 
Seat 7: solyom217 ($2.07 in chips) 
Seat 8: dakama_po ($2 in chips) 
Seat 9: yuu0914 ($3.84 in chips) 
Redvin33: posts small blind $0.01
rrrr1958: posts big blind $0.02
*** HOLE CARDS ***
Dealt to Redvin33 [Kc 5s]
FoldCase: raises $0.04 to $0.06
9th Kind: folds 
Poker in DNA: folds 
solyom217: folds 
dakama_po: folds 
yuu0914: folds 
DUMSTIK: calls $0.06
Redvin33: folds 
rrrr1958: calls $0.04
*** FLOP *** [Ad 9s As]
rrrr1958: checks 
FoldCase: checks 
DUMSTIK: checks 
*** TURN *** [Ad 9s As] [5d]
rrrr1958: bets $0.02
FoldCase: calls $0.02
DUMSTIK: calls $0.02
*** RIVER *** [Ad 9s As 5d] [8d]
rrrr1958: bets $0.04
FoldCase: folds 
DUMSTIK: calls $0.04
*** SHOW DOWN ***
rrrr1958: shows [7h Ah] (three of a kind, Aces)
DUMSTIK: shows [2c Ac] (three of a kind, Aces)
rrrr1958 collected $0.16 from pot
DUMSTIK collected $0.16 from pot
*** SUMMARY ***
Total pot $0.33 | Rake $0.01 
Board [Ad 9s As 5d 8d]
Seat 1: DUMSTIK (button) showed [2c Ac] and won ($0.16) with three of a kind, Aces
Seat 2: Redvin33 (small blind) folded before Flop
Seat 3: rrrr1958 (big blind) showed [7h Ah] and won ($0.16) with three of a kind, Aces
Seat 4: FoldCase folded on the River
Seat 5: 9th Kind folded before Flop (didn't bet)
Seat 6: Poker in DNA folded before Flop (didn't bet)
Seat 7: solyom217 folded before Flop (didn't bet)
Seat 8: dakama_po folded before Flop (didn't bet)
Seat 9: yuu0914 folded before Flop (didn't bet)



PokerStars Zoom Hand #172852941849:  Hold'em No Limit ($0.01/$0.02) - 2017/07/10 12:26:12 ET
Table 'McNaught' 9-max Seat #1 is the button
Seat 1: DeoDamiD ($2 in chips) 
Seat 2: whotrust?mee ($2.21 in chips) 
Seat 3: Redvin33 ($2.10 in chips) 
Seat 4: RiversideG ($2.49 in chips) 
Seat 5: tina86722 ($1.04 in chips) 
Seat 6: LoveBadBeat0 ($2 in chips) 
Seat 7: Wkite ($2.04 in chips) 
Seat 8: jkl278 ($2.65 in chips) 
Seat 9: 19Vladimir83 ($3.03 in chips) 
whotrust?mee: posts small blind $0.01
Redvin33: posts big blind $0.02
*** HOLE CARDS ***
Dealt to Redvin33 [Ks 2s]
RiversideG: folds 
tina86722: raises $0.04 to $0.06
LoveBadBeat0: folds 
Wkite: folds 
jkl278: folds 
19Vladimir83: calls $0.06
DeoDamiD: folds 
whotrust?mee: folds 
Redvin33: folds 
*** FLOP *** [Qc Qh 7h]
tina86722: checks 
19Vladimir83: checks 
*** TURN *** [Qc Qh 7h] [8d]
tina86722: checks 
19Vladimir83: checks 
*** RIVER *** [Qc Qh 7h 8d] [8c]
tina86722: checks 
19Vladimir83: checks 
*** SHOW DOWN ***
tina86722: shows [2d 2h] (two pair, Queens and Eights)
19Vladimir83: shows [Tc Ad] (two pair, Queens and Eights - Ace kicker)
19Vladimir83 collected $0.14 from pot
*** SUMMARY ***
Total pot $0.15 | Rake $0.01 
Board [Qc Qh 7h 8d 8c]
Seat 1: DeoDamiD (button) folded before Flop (didn't bet)
Seat 2: whotrust?mee (small blind) folded before Flop
Seat 3: Redvin33 (big blind) folded before Flop
Seat 4: RiversideG folded before Flop (didn't bet)
Seat 5: tina86722 showed [2d 2h] and lost with two pair, Queens and Eights
Seat 6: LoveBadBeat0 folded before Flop (didn't bet)
Seat 7: Wkite folded before Flop (didn't bet)
Seat 8: jkl278 folded before Flop (didn't bet)
Seat 9: 19Vladimir83 showed [Tc Ad] and won ($0.14) with two pair, Queens and Eights



PokerStars Zoom Hand #172852946487:  Hold'em No Limit ($0.01/$0.02) - 2017/07/10 12:26:19 ET
Table 'McNaught' 9-max Seat #1 is the button
Seat 1: Redvin33 ($2.08 in chips) 
Seat 2: garça409 ($2.75 in chips) 
Seat 3: rus_31_saf ($1.11 in chips) 
Seat 4: qpsq ($2.08 in chips) 
Seat 5: vsegda_olin ($3.04 in chips) 
Seat 6: Poker in DNA ($2.16 in chips) 
Seat 7: valera_9696@ ($2.11 in chips) 
Seat 8: LoveBadBeat0 ($2 in chips) 
Seat 9: moyasyndrome ($3.95 in chips) 
garça409: posts small blind $0.01
rus_31_saf: posts big blind $0.02
*** HOLE CARDS ***
Dealt to Redvin33 [7h Ad]
qpsq: folds 
vsegda_olin: folds 
Poker in DNA: folds 
valera_9696@: folds 
LoveBadBeat0: raises $0.04 to $0.06
moyasyndrome: folds 
Redvin33: calls $0.06
garça409: calls $0.05
rus_31_saf: folds 
*** FLOP *** [2h Kh 6d]
garça409: checks 
LoveBadBeat0: checks 
Redvin33: checks 
*** TURN *** [2h Kh 6d] [6s]
garça409: checks 
LoveBadBeat0: checks 
Redvin33: checks 
*** RIVER *** [2h Kh 6d 6s] [2s]
garça409: checks 
LoveBadBeat0: checks 
Redvin33: bets $0.06
garça409: raises $0.31 to $0.37
LoveBadBeat0: folds 
Redvin33: folds 
Uncalled bet ($0.31) returned to garça409
garça409 collected $0.31 from pot
garça409: doesn't show hand 
*** SUMMARY ***
Total pot $0.32 | Rake $0.01 
Board [2h Kh 6d 6s 2s]
Seat 1: Redvin33 (button) folded on the River
Seat 2: garça409 (small blind) collected ($0.31)
Seat 3: rus_31_saf (big blind) folded before Flop
Seat 4: qpsq folded before Flop (didn't bet)
Seat 5: vsegda_olin folded before Flop (didn't bet)
Seat 6: Poker in DNA folded before Flop (didn't bet)
Seat 7: valera_9696@ folded before Flop (didn't bet)
Seat 8: LoveBadBeat0 folded on the River
Seat 9: moyasyndrome folded before Flop (didn't bet)



PokerStars Zoom Hand #172852981228:  Hold'em No Limit ($0.01/$0.02) - 2017/07/10 12:27:11 ET
Table 'McNaught' 9-max Seat #1 is the button
Seat 1: DiNiceBoy ($2.17 in chips) 
Seat 2: PSzpak ($4.75 in chips) 
Seat 3: moyasyndrome ($2.35 in chips) 
Seat 4: BearVodka314 ($2.01 in chips) 
Seat 5: 08600 ($1.03 in chips) 
Seat 6: nikmir34 ($4.20 in chips) 
Seat 7: Kolya813 ($2 in chips) 
Seat 8: wat-steel ($2.43 in chips) 
Seat 9: Redvin33 ($1.96 in chips) 
PSzpak: posts small blind $0.01
moyasyndrome: posts big blind $0.02
*** HOLE CARDS ***
Dealt to Redvin33 [4h 2h]
BearVodka314: folds 
08600: folds 
nikmir34: folds 
Kolya813: folds 
wat-steel: folds 
Redvin33: folds 
DiNiceBoy: folds 
PSzpak: folds 
Uncalled bet ($0.01) returned to moyasyndrome
moyasyndrome collected $0.02 from pot
moyasyndrome: doesn't show hand 
*** SUMMARY ***
Total pot $0.02 | Rake $0 
Seat 1: DiNiceBoy (button) folded before Flop (didn't bet)
Seat 2: PSzpak (small blind) folded before Flop
Seat 3: moyasyndrome (big blind) collected ($0.02)
Seat 4: BearVodka314 folded before Flop (didn't bet)
Seat 5: 08600 folded before Flop (didn't bet)
Seat 6: nikmir34 folded before Flop (didn't bet)
Seat 7: Kolya813 folded before Flop (didn't bet)
Seat 8: wat-steel folded before Flop (didn't bet)
Seat 9: Redvin33 folded before Flop (didn't bet)



PokerStars Zoom Hand #172852983843:  Hold'em No Limit ($0.01/$0.02) - 2017/07/10 12:27:15 ET
Table 'McNaught' 9-max Seat #1 is the button
Seat 1: patriot557 ($3.03 in chips) 
Seat 2: h1_tech_1mba ($2.28 in chips) 
Seat 3: evgennn1410 ($2.03 in chips) 
Seat 4: seshAD ($2.90 in chips) 
Seat 5: yuu0914 ($2 in chips) 
Seat 6: RiversideG ($2.23 in chips) 
Seat 7: rus_31_saf ($1.08 in chips) 
Seat 8: Redvin33 ($1.96 in chips) 
Seat 9: babohe1991 ($3.37 in chips) 
h1_tech_1mba: posts small blind $0.01
evgennn1410: posts big blind $0.02
*** HOLE CARDS ***
Dealt to Redvin33 [Ad Tc]
seshAD: folds 
yuu0914: folds 
RiversideG: raises $0.04 to $0.06
rus_31_saf: folds 
Redvin33: calls $0.06
babohe1991: folds 
patriot557: folds 
h1_tech_1mba: folds 
evgennn1410: folds 
*** FLOP *** [4c Ks Kh]
RiversideG: bets $0.06
Redvin33: calls $0.06
*** TURN *** [4c Ks Kh] [5h]
RiversideG: bets $0.08
Redvin33: folds 
Uncalled bet ($0.08) returned to RiversideG
RiversideG collected $0.26 from pot
RiversideG: doesn't show hand 
*** SUMMARY ***
Total pot $0.27 | Rake $0.01 
Board [4c Ks Kh 5h]
Seat 1: patriot557 (button) folded before Flop (didn't bet)
Seat 2: h1_tech_1mba (small blind) folded before Flop
Seat 3: evgennn1410 (big blind) folded before Flop
Seat 4: seshAD folded before Flop (didn't bet)
Seat 5: yuu0914 folded before Flop (didn't bet)
Seat 6: RiversideG collected ($0.26)
Seat 7: rus_31_saf folded before Flop (didn't bet)
Seat 8: Redvin33 folded on the Turn
Seat 9: babohe1991 folded before Flop (didn't bet)



PokerStars Zoom Hand #172853006491:  Hold'em No Limit ($0.01/$0.02) - 2017/07/10 12:27:49 ET
Table 'McNaught' 9-max Seat #1 is the button
Seat 1: Fedor Sheen ($2.85 in chips) 
Seat 2: NAHALUGA ($2.62 in chips) 
Seat 3: Hockeyberry ($2.08 in chips) 
Seat 4: laguna-38 ($0.74 in chips) 
Seat 5: solyom217 ($2.04 in chips) 
Seat 6: Redvin33 ($1.84 in chips) 
Seat 7: hdjd6743 ($2 in chips) 
Seat 8: rus_31_saf ($0.62 in chips) 
Seat 9: KikiDB ($2.52 in chips) 
NAHALUGA: posts small blind $0.01
Hockeyberry: posts big blind $0.02
*** HOLE CARDS ***
Dealt to Redvin33 [Jd 5d]
laguna-38: folds 
solyom217: folds 
Redvin33: folds 
hdjd6743: folds 
rus_31_saf: folds 
KikiDB: folds 
Fedor Sheen: folds 
NAHALUGA: folds 
Uncalled bet ($0.01) returned to Hockeyberry
Hockeyberry collected $0.02 from pot
Hockeyberry: doesn't show hand 
*** SUMMARY ***
Total pot $0.02 | Rake $0 
Seat 1: Fedor Sheen (button) folded before Flop (didn't bet)
Seat 2: NAHALUGA (small blind) folded before Flop
Seat 3: Hockeyberry (big blind) collected ($0.02)
Seat 4: laguna-38 folded before Flop (didn't bet)
Seat 5: solyom217 folded before Flop (didn't bet)
Seat 6: Redvin33 folded before Flop (didn't bet)
Seat 7: hdjd6743 folded before Flop (didn't bet)
Seat 8: rus_31_saf folded before Flop (didn't bet)
Seat 9: KikiDB folded before Flop (didn't bet)



PokerStars Zoom Hand #172853012582:  Hold'em No Limit ($0.01/$0.02) - 2017/07/10 12:27:58 ET
Table 'McNaught' 9-max Seat #1 is the button
Seat 1: shortis_14 ($3.03 in chips) 
Seat 2: ArchFish ($2.26 in chips) 
Seat 3: Redvin33 ($1.84 in chips) 
Seat 4: LoveBadBeat0 ($2.01 in chips) 
Seat 5: pellion ($2.09 in chips) 
Seat 6: KidBananan ($2.21 in chips) 
Seat 7: Bear4943 ($4.48 in chips) 
Seat 8: alkraf ($2.10 in chips) 
Seat 9: RiversideG ($2.92 in chips) 
ArchFish: posts small blind $0.01
Redvin33: posts big blind $0.02
*** HOLE CARDS ***
Dealt to Redvin33 [Qc 9c]
LoveBadBeat0: folds 
pellion: folds 
KidBananan: folds 
Bear4943: folds 
alkraf: raises $0.04 to $0.06
RiversideG: folds 
shortis_14: calls $0.06
ArchFish: folds 
Redvin33: calls $0.04
*** FLOP *** [2h 4c 9s]
Redvin33: checks 
alkraf: checks 
shortis_14: bets $0.10
Redvin33: calls $0.10
alkraf: folds 
*** TURN *** [2h 4c 9s] [Kh]
Redvin33: bets $0.14
shortis_14: raises $0.14 to $0.28
Redvin33: calls $0.14
*** RIVER *** [2h 4c 9s Kh] [Ah]
Redvin33: bets $0.46
shortis_14: folds 
Uncalled bet ($0.46) returned to Redvin33
Redvin33 collected $0.92 from pot
Redvin33: doesn't show hand 
*** SUMMARY ***
Total pot $0.95 | Rake $0.03 
Board [2h 4c 9s Kh Ah]
Seat 1: shortis_14 (button) folded on the River
Seat 2: ArchFish (small blind) folded before Flop
Seat 3: Redvin33 (big blind) collected ($0.92)
Seat 4: LoveBadBeat0 folded before Flop (didn't bet)
Seat 5: pellion folded before Flop (didn't bet)
Seat 6: KidBananan folded before Flop (didn't bet)
Seat 7: Bear4943 folded before Flop (didn't bet)
Seat 8: alkraf folded on the Flop
Seat 9: RiversideG folded before Flop (didn't bet)



PokerStars Zoom Hand #172853009184:  Hold'em No Limit ($0.01/$0.02) - 2017/07/10 12:27:53 ET
Table 'McNaught' 9-max Seat #1 is the button
Seat 1: baik1211 ($3.43 in chips) 
Seat 2: myrat05 ($5.99 in chips) 
Seat 3: AgressoRun ($2.27 in chips) 
Seat 4: Scouserslfc ($4.33 in chips) 
Seat 5: Redvin33 ($1.84 in chips) 
Seat 6: Wkite ($2.17 in chips) 
Seat 7: FoldCase ($2.42 in chips) 
Seat 8: urso90 ($4.31 in chips) 
Seat 9: Nikolaj1976 ($1.30 in chips) 
myrat05: posts small blind $0.01
AgressoRun: posts big blind $0.02
*** HOLE CARDS ***
Dealt to Redvin33 [9d 2d]
Scouserslfc: folds 
Redvin33: folds 
Wkite: folds 
FoldCase: raises $0.04 to $0.06
urso90: folds 
Nikolaj1976: folds 
baik1211: raises $0.15 to $0.21
myrat05: folds 
AgressoRun: folds 
FoldCase: calls $0.15
*** FLOP *** [3h 5h 6c]
FoldCase: checks 
baik1211: bets $0.43
FoldCase: calls $0.43
*** TURN *** [3h 5h 6c] [8d]
FoldCase: checks 
baik1211: checks 
*** RIVER *** [3h 5h 6c 8d] [3c]
FoldCase: bets $1.76
baik1211: folds 
Uncalled bet ($1.76) returned to FoldCase
FoldCase collected $1.26 from pot
FoldCase: doesn't show hand 
*** SUMMARY ***
Total pot $1.31 | Rake $0.05 
Board [3h 5h 6c 8d 3c]
Seat 1: baik1211 (button) folded on the River
Seat 2: myrat05 (small blind) folded before Flop
Seat 3: AgressoRun (big blind) folded before Flop
Seat 4: Scouserslfc folded before Flop (didn't bet)
Seat 5: Redvin33 folded before Flop (didn't bet)
Seat 6: Wkite folded before Flop (didn't bet)
Seat 7: FoldCase collected ($1.26)
Seat 8: urso90 folded before Flop (didn't bet)
Seat 9: Nikolaj1976 folded before Flop (didn't bet)



PokerStars Zoom Hand #172853040313:  Hold'em No Limit ($0.01/$0.02) - 2017/07/10 12:28:40 ET
Table 'McNaught' 9-max Seat #1 is the button
Seat 1: SanDmitri4 ($5.42 in chips) 
Seat 2: SERGEY 26RUS ($1.32 in chips) 
Seat 3: Pandaruo ($4.68 in chips) 
Seat 4: Redvin33 ($2.32 in chips) 
Seat 5: baik1211 ($1.84 in chips) 
Seat 6: Kirya2790 ($1.97 in chips) 
Seat 7: MCFI ($2.34 in chips) 
Seat 8: wat-steel ($2.34 in chips) 
Seat 9: h1_tech_1mba ($2.28 in chips) 
SERGEY 26RUS: posts small blind $0.01
Pandaruo: posts big blind $0.02
*** HOLE CARDS ***
Dealt to Redvin33 [Jc Kd]
Redvin33: raises $0.02 to $0.04
baik1211: folds 
Kirya2790: folds 
MCFI: folds 
wat-steel: folds 
h1_tech_1mba: folds 
SanDmitri4: folds 
SERGEY 26RUS: folds 
Pandaruo: folds 
Uncalled bet ($0.02) returned to Redvin33
Redvin33 collected $0.05 from pot
Redvin33: doesn't show hand 
*** SUMMARY ***
Total pot $0.05 | Rake $0 
Seat 1: SanDmitri4 (button) folded before Flop (didn't bet)
Seat 2: SERGEY 26RUS (small blind) folded before Flop
Seat 3: Pandaruo (big blind) folded before Flop
Seat 4: Redvin33 collected ($0.05)
Seat 5: baik1211 folded before Flop (didn't bet)
Seat 6: Kirya2790 folded before Flop (didn't bet)
Seat 7: MCFI folded before Flop (didn't bet)
Seat 8: wat-steel folded before Flop (didn't bet)
Seat 9: h1_tech_1mba folded before Flop (didn't bet)



